id,time,description,mcc,originalMcc,amount,operationAmount,currencyCode,commissionRate,cashbackAmount,balance,hold,receiptId
d5qj_0jYOJaVXQ,1522436289,Uber,4121,4121,-12735,-12735,980,0,0,70413,False,KC87-70A1-7460-65B5
SVLWLY_PctPDhw,1522430698,–ê–¢–ë,5499,5499,-24850,-24850,980,0,994,83148,False,9AE8-P7M5-8B8P-TP56
5--xv8ldDfL14w,1522428488,–ö–∏—ó–≤—Å—å–∫–∏–π –º–µ—Ç—Ä–æ–ø–æ–ªi—Ç–µ–Ω,4111,4111,-500,-500,980,0,0,107998,False,PEKC-C0E5-7P2K-0ACH
17_sRZtJeq_s4w,1522393723,–ö–∏—ó–≤—Å—å–∫–∏–π –º–µ—Ç—Ä–æ–ø–æ–ªi—Ç–µ–Ω,4111,4111,-500,-500,980,0,0,108498,False,0990-5803-H38K-T7T4
j8LyUh7K5v_wIA,1522305145,Novus,5411,5411,-17745,-17745,980,0,709,108998,False,A97A-625C-X74E-A8B2
jHLSCsEnIZfz4A,1522268770,Uber,4121,4121,-15616,-15616,980,0,0,126743,False,1E24-A8EE-K22K-C4AB
--AOxr-NOzGARA,1522255374,Uber,4121,4121,-12607,-12607,980,0,0,142359,False,3CE7-XTCB-4T8E-M8TH
v4zBBvoH71banQ,1522254877,–ö–∏—ó–≤—Å—å–∫–∏–π –º–µ—Ç—Ä–æ–ø–æ–ªi—Ç–µ–Ω,4111,4111,-500,-500,980,0,0,154966,False,CM3H-E2EX-CMAE-27MA
wPWFVhTMT2ICBA,1522233738,Lesya,–Ω–∞ –æ–±–µ–¥ –¥–ª—è –¥–µ—Ç–∫–∏,4829,4829,-20800,-20800,980,800,0,155466,True,M96E-M623-M33A-8197
dQgtQ5xyLpWmQg,1522227899,McDonald's,5814,5814,-8200,-8200,980,0,328,176266,False,7109-E934-6T12-EB8C
aRDGsanRaQUJ5g,1522227050,–ö–∏—ó–≤—Å—å–∫–∏–π –º–µ—Ç—Ä–æ–ø–æ–ªi—Ç–µ–Ω,4111,4111,-500,-500,980,0,0,184466,False,7H4P-PB4T-M1E9-M797
oZaMP2cSyNlMuQ,1522226678,FOP BABIN AP,5812,5812,-16000,-16000,980,0,640,184966,False,KKEC-5C2X-A512-EXE3
2Zd9K-e9Z0mEag,1522176168,Uber,4121,4121,-10200,-10200,980,0,0,200966,False,964P-7368-8HB0-4ME6
B1uuFByeJK0muQ,1522168109,Uber,4121,4121,-21827,-21827,980,0,0,211166,False,5M89-3947-2C3B-CTKC
guUASksKAwgTZg,1522142183,McDonald's,5814,5814,-8600,-8600,980,0,344,232993,False,3897-7EC2-AC01-4135
WOAnnSy9u0CE5A,1522093010,Uber,4121,4121,-24755,-24755,980,0,0,241593,False,E0P3-XMP9-AM84-A8HA
qcN9CEKgFd6OcA,1522091326,–ê–¢–ë,5411,5411,-20260,-20260,980,0,810,266348,False,4T18-X867-7EPM-6580
xfkSDZ1PruqsdQ,1522088957,–ö–∏—ó–≤—Å—å–∫–∏–π –º–µ—Ç—Ä–æ–ø–æ–ªi—Ç–µ–Ω,4111,4111,-500,-500,980,0,0,286608,False,XXX6-8P90-2238-C69K
uhPiBNYToBxFew,1522065591,Uber,4121,4121,-4522,-4522,980,0,0,287108,False,KH3C-AKEC-32K0-5HA9
t50cO83DPM2EzA,1522053233,–ö–∏—ó–≤—Å—å–∫–∏–π –º–µ—Ç—Ä–æ–ø–æ–ªi—Ç–µ–Ω,4111,4111,-500,-500,980,0,0,291630,False,45A6-C6H2-9BA1-KK0A
_zKts7M6yPx8CQ,1521917212,Uber,4121,4121,-12649,-12649,980,0,0,292130,False,30B0-41C2-B19X-H9X6
GiKwOxn7J8-T1g,1521915669,Uber,4121,4121,-1000,-1000,980,0,0,304779,False,CBM3-X12P-93AM-X3CX
Tj1JZu055yx3QA,1521904461,Uber,4121,4121,-11395,-11395,980,0,0,305779,False,1AEK-B943-K4AM-0CH7
EpxPgurQfiAX4A,1521889126,magazinPRODUKTI,5499,5499,-13440,-13440,980,0,537,317174,False,1XTB-364T-12HX-753A
VaxuRmtcs9Wdjw,1521878992,Uber,4121,4121,-7099,-7099,980,0,0,330614,False,KMEM-56KA-9XC7-XE4K
0Oy4MBiWePwzSQ,1521829626,–ê–¢–ë,5411,5411,-16680,-16680,980,0,667,337713,False,E2EM-MKTA-3EPM-9287
WnhEYp8O2Y3DHg,1521827085,THE BLUE CAP,5812,5812,-11700,-11700,980,0,468,354393,False,80X5-1BA9-B79P-9TP8
u3nf0WLOf-VZWg,1521745552,Uber,4121,4121,-2000,-2000,980,0,0,366093,False,9MPP-P5PM-2082-3MEX
tQhvN3pEqwPuhg,1521744888,Uber,4121,4121,-13315,-13315,980,0,0,368093,False,0EAP-P6BT-8BK9-7396
ZvwxmQtx0MxgTg,1521655154,Novus,5499,5499,-81429,-81429,980,0,3257,381408,False,B5M9-B130-H9C7-4294
8_G7-Gq8b-doNQ,1521652796,–ö–∏—ó–≤—Å—å–∫–∏–π –º–µ—Ç—Ä–æ–ø–æ–ªi—Ç–µ–Ω,4111,4111,-500,-500,980,0,0,462837,False,X55T-C5CB-TA8M-TCKH
qm0knf39rL6usw,1521556718,Sanatrelo75N4F3Y8N4SHC,5812,5812,-91400,-91400,980,0,3656,463337,False,0H89-C72C-T22C-T5HA
mIruvFeq8rLEMQ,1521556678,Sanatrelo75N4F3Y8N4SHC,5812,5812,-5500,-5500,980,0,220,554737,False,4XT3-M7KM-B14C-7MCK
nq2rRKApUJTqEA,1521480011,–ö–∏—ó–≤—Å—å–∫–∏–π –º–µ—Ç—Ä–æ–ø–æ–ªi—Ç–µ–Ω,4111,4111,-500,-500,980,0,0,560237,False,KA2H-68E4-8TP0-H9E2
W3drO0HlyQD9wg,1521465579,RESTORAN KHMILNYY KNYA,5812,5812,-1000,-1000,980,0,40,560737,False,THTK-5557-B43A-8333
_8Tx2G9CHrLq5g,1521465555,RESTAURANT KHMILNYY KN,5812,5812,-68000,-68000,980,0,2720,561737,False,C0CT-2H1M-2BAM-5026
5HzZtX2PwP6CTg,1521394473,–ö–∏—ó–≤—Å—å–∫–∏–π –º–µ—Ç—Ä–æ–ø–æ–ªi—Ç–µ–Ω,4111,4111,-500,-500,980,0,0,629737,False,4EP3-K55K-49P0-3PTH
M8bIxLPrgrbqhw,1521374299,–§–æ—Ä–∞,5499,5499,-12268,-12268,980,0,490,630237,False,1CA0-T8K5-4T3B-0T7E
-88GKitLik4P7w,1521300687,–ê–¢–ë,5411,5411,-29170,-29170,980,0,1166,642505,False,HBC2-5P1B-0H26-C2H0
RSY2QJT_P3RqsA,1521159713,Uber,4121,4121,-2500,-2500,980,0,0,671675,False,17A5-7687-13T8-K854
4vY9He3BuiFwIQ,1521158821,VETERENARNYY GOSPITAL,742,742,-136500,-136500,980,0,0,674175,False,17A7-KT7B-9T21-CATX
eeXhvXjLiQtdhg,1521149146,Uber,4121,4121,-12292,-12292,980,0,0,810675,False,6HX8-9K86-0X0B-M8XX
D7UkNKoFSmIM6A,1521146389,Uber,4121,4121,-4863,-4863,980,0,0,822967,False,09E4-X9HP-21C6-MPK0
6Dga5lDFpQdz6g,1521137872,Novus,5499,5499,-119622,-119622,980,0,4784,827830,False,PAXM-BHX4-2722-X4B8
ugNafkdxSpQnRg,1521134386,–ö–∏—ó–≤—Å—å–∫–∏–π –º–µ—Ç—Ä–æ–ø–æ–ªi—Ç–µ–Ω,4111,4111,-500,-500,980,0,0,947452,False,B1K4-P6MH-38AA-H2PK
iM8PPIztrEHaHw,1521101542,–ö–∏—ó–≤—Å—å–∫–∏–π –º–µ—Ç—Ä–æ–ø–æ–ªi—Ç–µ–Ω,4111,4111,-500,-500,980,0,0,947952,False,A4KC-6ACC-CECX-8H5B
z72ORcevkBgZsw,1521098436,"–ö–∏—ó–≤—Å—Ç–∞—Ä
+380978495150",4812,4812,-6000,-6000,980,0,0,948452,True,HCTM-2173-XKM5-2AP4
-88GLSdMj04L7g,1521098165,–ö–∏—ó–≤—Å—å–∫–∏–π –º–µ—Ç—Ä–æ–ø–æ–ªi—Ç–µ–Ω,4111,4111,-500,-500,980,0,0,954452,False,14E1-6XKB-4664-960E
AVhfMY-J38j4XA,1521055959,Uber,4121,4121,-18188,-17787,980,0,0,954952,False,57PP-0E4H-0A2E-M83B
kiTYj2ttfh_-qg,1521050261,–ö–∏—ó–≤—Å—å–∫–∏–π –º–µ—Ç—Ä–æ–ø–æ–ªi—Ç–µ–Ω,4111,4111,-500,-500,980,0,0,973140,False,AH3C-1A6K-CM3T-KP2T
BD6K6T6Pt1KW1w,1521029622,–í—ñ–¥: –°–∞—á–µ–Ω–∫–æ –û–ª–µ—Å—è –°–µ—Ä–≥—ñ—ó–≤–Ω–∞,–º–æ–∏,4829,4829,7817,7817,980,0,0,973640,True
L6zgBdNjitYkNg,1521012014,–ö–∏—ó–≤—Å—å–∫–∏–π –º–µ—Ç—Ä–æ–ø–æ–ªi—Ç–µ–Ω,4111,4111,-500,-500,980,0,0,965823,False,B306-B91K-62M7-2ME5
-F0dRNuWzk6snw,1521010882,–í—ñ–¥: –°–∞—á–µ–Ω–∫–æ –û–ª–µ—Å—è –°–µ—Ä–≥—ñ—ó–≤–Ω–∞,—Ç–≤–æ–∏,4829,4829,154616,154616,980,0,0,966323,True
gvOPW8ga2Z7mGw,1520977161,–ê–¢–ë,5499,5499,-8350,-8350,980,0,334,811707,False,55PB-MAPB-MA45-407B
EVda5vqZ0eZcOg,1520976975,Uber,4121,4121,-24922,-24483,980,0,0,820057,False,56TB-6676-A2T7-7320
caZ-imdDAB9mYA,1520974031,RESTORAN KHMILNYY KNYA,5812,5812,-105600,-105600,980,0,4224,844979,False,5H5C-9K2X-673M-HE81
sfI4O39PhkRTVg,1520973989,RESTAURANT KHMILNYY KN,5812,5812,-35500,-35500,980,0,1420,950579,False,31XB-6AKT-B252-C875
Zv8pS1_dRxVOkw,1520970931,Uber,4121,4121,-13921,-13677,980,0,0,986079,False,HA70-C88X-8812-2AT5
OXzfzQRlyxCJ1g,1520968511,Lesya,4829,4829,-154616,-154616,980,0,0,1000000,True,X536-50T2-4589-K66B
bNw6oZXzVKcKeQ,1520968449,Lesya,—Ç–≤–æ–∏,4829,4829,-107817,-107817,980,0,0,1154616,True,8K6H-41BK-B28E-5101
3zBqQ0wLzdAjfQ,1520966471,–í—ñ–¥: –°–∞—á–µ–Ω–∫–æ –û–ª–µ—Å—è –°–µ—Ä–≥—ñ—ó–≤–Ω–∞,–º–æ–∏,4829,4829,107817,107817,980,0,0,1262433,True
2BO_OocMCQaHNA,1520966410,–í—ñ–¥: –°–∞—á–µ–Ω–∫–æ –û–ª–µ—Å—è –°–µ—Ä–≥—ñ—ó–≤–Ω–∞,—Ç–≤–æ–∏,4829,4829,188716,188716,980,0,0,1154616,True
rTISGWNQFyTrQg,1520940689,P24 CR MD UA,6536,6536,8500,8500,980,0,0,965900,False
qPEGF_WS00uM8Q,1520939699,McDonald's,5814,5814,-42600,-42600,980,0,1704,957400,False,6AXM-A3BB-4HB0-MKTH
kgGe3RlgUMquBA,1520939457,Lesya,–º–æ–∏,4829,4829,-188716,-188716,980,0,0,1000000,True,XXKX-6XE1-9MHE-H1EK
hVIDOb_dqdmv8g,1520939351,Lesya,—Ç–≤–æ–∏,4829,4829,-8000,-8000,980,0,0,1188716,True,403K-8M6C-0ET8-HP19
n6Rp2_Kgfvm1Tg,1520938322,–ö–∏—ó–≤—Å—å–∫–∏–π –º–µ—Ç—Ä–æ–ø–æ–ªi—Ç–µ–Ω,4111,4111,-500,-500,980,0,0,1196716,False,KE9H-1243-PBM3-P433
p7oa8Uqbdba0SA,1520924925,–í—ñ–¥: –°–∞—á–µ–Ω–∫–æ –û–ª–µ—Å—è –°–µ—Ä–≥—ñ—ó–≤–Ω–∞,üòô,4829,4829,233056,233056,980,0,0,1197216,True
iimFUn61j2ivaA,1520880118,–ê–¢–ë,5499,5499,-35840,-35840,980,0,1433,964160,False,5X6P-H7AH-1C25-6125
iPmieU_0j6XSbg,1520879908,Lesya,4829,4829,-350063,-350063,980,0,0,1000000,True,C70X-E4KX-16KB-2CAE
kQ_8mjTJbCCLMQ,1520877654,–ö–∏—ó–≤—Å—å–∫–∏–π –º–µ—Ç—Ä–æ–ø–æ–ªi—Ç–µ–Ω,4111,4111,-500,-500,980,0,0,1350063,False,ATHA-1M4P-1059-PE2X
8VGRsKxwp0Td0Q,1520874354,–í—ñ–¥: –°–∞—á–µ–Ω–∫–æ –û–ª–µ—Å—è –°–µ—Ä–≥—ñ—ó–≤–Ω–∞,–º–æ–∏,4829,4829,125007,125007,980,0,0,1350563,True
A3cJXKuzQZ8vWg,1520874326,–í—ñ–¥: –°–∞—á–µ–Ω–∫–æ –û–ª–µ—Å—è –°–µ—Ä–≥—ñ—ó–≤–Ω–∞,—Ç–≤–æ–∏,4829,4829,306156,306156,980,0,0,1225556,True
24GA579QOa6GsQ,1520858455,Sanatrelo75N4F3Y8N4SHC,5812,5812,-80600,-80600,980,0,3224,919400,False,MPKK-10P9-0T54-0365
asbnaTml1hgOfQ,1520856031,Lesya,–º—É—Ç–∫–∏,4829,4829,-306156,-306156,980,0,0,1000000,True,7X0X-A5H5-1P04-93B4
lENgcE6x9C2oWg,1520838983,–ö–∏—ó–≤—Å—å–∫–∏–π –º–µ—Ç—Ä–æ–ø–æ–ªi—Ç–µ–Ω,4111,4111,-500,-500,980,0,0,1306156,False,ETHE-9BM9-50X0-MTH5
W_38oJyUf2cWig,1520785961,–ö–∏—ó–≤—Å—å–∫–∏–π –º–µ—Ç—Ä–æ–ø–æ–ªi—Ç–µ–Ω,4111,4111,-500,-500,980,0,0,306656,False,ACB8-K6K4-BT8M-KT95
YBFwJ3YNPSxqhw,1520765101,–§–æ—Ä–∞,5499,5499,-2989,-2989,980,0,59,307156,False,HAEE-H1M8-6K6K-PH91
nEaGjjZUhGy4kg,1520764967,–§–æ—Ä–∞,5499,5499,-16839,-16839,980,0,336,310145,False,5418-T4E6-98K7-APXC
QZFIbq__zwh5SQ,1520763515,–°—ñ–ª—å–ø–æ,5411,5411,-27677,-27677,980,0,553,326984,False,45MK-775P-ECB2-20TP
KzkNJ7TTCxJGVg,1520691997,LE KOMORA,5921,5921,-15000,-15000,980,0,300,354661,False,6P42-8CEP-KP51-9371
SF1lyO5ehVaV8g,1520691944,FOP LOKHA D.O.,5814,5814,-47000,-47000,980,0,940,369661,False,8218-5HT3-P6BK-PE0H
DRchT7_joJs_7w,1520681840,McDonald's,5814,5814,-10000,-10000,980,0,200,416661,False,10A3-M0A4-MAP5-2ETA
pQmfq_c4un06gw,1520680493,–ö–∏—ó–≤—Å—å–∫–∏–π –º–µ—Ç—Ä–æ–ø–æ–ªi—Ç–µ–Ω,4111,4111,-500,-500,980,0,0,426661,False,79C3-B65K-AC87-818E
7qI9RcvbB9_qRg,1520630534,Uber,4121,4121,-18515,-18266,980,0,0,427161,False,9P24-2070-PT1T-10HE
Nkxtm7-Zskrp5w,1520622964,–ö–∏—ó–≤—Å—å–∫–∏–π –º–µ—Ç—Ä–æ–ø–æ–ªi—Ç–µ–Ω,4111,4111,-500,-500,980,0,0,445676,False,231K-3K20-4BK8-53P2
Co9wPgyX4EJ3Og,1520620474,FOPPobedinskayaNV,5812,5812,-58000,-58000,980,0,1160,446176,False,MA9E-T6MH-65C4-TP75
m536oo8uG_gS3g,1520620425,BOTTEGA,5813,5813,-47500,-47500,980,0,950,504176,False,CH37-16XE-1MH1-A39X
1iuvnK5EfXQqaA,1520593145,McDonald's,5814,5814,-8200,-8200,980,0,164,551676,False,244H-CEX3-9C1P-966X
4leuucLTrwnA6g,1520497130,–û–ª–µ—Å—è –°–∞—á–µ–Ω–∫–æ,4829,4829,-260000,-260000,980,0,0,559876,True,BBBB-6HPB-H8B6-T27H
E1-Kvk4vaUYeyA,1520490103,–ê–¢–ë,5411,5411,-37210,-37210,980,0,744,819876,False,EX54-002T-C50P-C35M
3gfDwkS84GwCRA,1520448285,Uber,4121,4121,-7102,-7046,980,0,0,857086,False,7XME-X59E-P71P-1429
zvXykFW_VRYHVw,1520447379,Uber,4121,4121,-4044,-4000,980,0,0,864188,False,2275-T5M0-A3TB-2K08
SIeXD2Q2Ba7XBw,1520445879,–ö–∏—ó–≤—Å—å–∫–∏–π –º–µ—Ç—Ä–æ–ø–æ–ªi—Ç–µ–Ω,4111,4111,-500,-500,980,0,0,868232,False,XM6B-94P7-2790-50X2
UgXhhNfsk-DRuw,1520445436,Florrum25DVTOFNWXM000,5992,5992,-95000,-95000,980,0,0,868732,False,C9C9-EPX9-T7XC-A6T5
kinsCM6VcXJZ6w,1520442703,Uber,4121,4121,-25944,-25670,980,0,0,963732,False,4M8H-427A-MCEK-B6AH
8QteM4kdibmgyg,1520430585,Lesya,–Ω–∞ —Ü–≤–µ—Ç–æ—á–∫–∏ üå∑,4829,4829,-150000,-150000,980,0,0,989676,True,5M64-7C33-E8M9-EM60
3ogPl2vlrxkQiA,1520409752,McDonald's,5814,5814,-8200,-8200,980,0,164,1139676,False,B847-K009-95XX-1A67
i3hcUyIC9sXrbA,1520408166,–ö–∏—ó–≤—Å—å–∫–∏–π –º–µ—Ç—Ä–æ–ø–æ–ªi—Ç–µ–Ω,4111,4111,-500,-500,980,0,0,1147876,False,14CM-1H46-MA0B-KBM2
Eg-X0toPV6L3mg,1520361829,Novus,5499,5499,-119905,-119905,980,0,2398,1148376,False,1K3M-1CT4-H15T-H2X4
dwHwy0PPSrowxw,1520358415,–ö–∏—ó–≤—Å—å–∫–∏–π –º–µ—Ç—Ä–æ–ø–æ–ªi—Ç–µ–Ω,4111,4111,-500,-500,980,0,0,1268281,False,BK11-2M74-CHPM-XTE9
1sfPnoFEI_bnnA,1520323562,McDonald's,5814,5814,-9000,-9000,980,0,180,1268781,False,HAKB-MAP2-5MEB-4ACA
RWrgZLNDNnm8rg,1520321281,–ö–∏—ó–≤—Å—å–∫–∏–π –º–µ—Ç—Ä–æ–ø–æ–ªi—Ç–µ–Ω,4111,4111,-500,-500,980,0,0,1277781,False,TBBM-894X-PEMB-47EK
r-4HztxcXaIruQ,1520275330,–ö–∏—ó–≤—Å—å–∫–∏–π –º–µ—Ç—Ä–æ–ø–æ–ªi—Ç–µ–Ω,4111,4111,-500,-500,980,0,0,1278281,False,7M2P-032T-8E5T-EKM1
wGzWtZjh_6H5rw,1520272812,Uber,4121,4121,-25503,-25282,980,0,0,1278781,False,8T1T-5391-A2HK-9385
h7m0kVlv2nM8PA,1520248455,–û–ª–µ–∫—Å—ñ–π –í–∏–∫–∞–ª—é–∫,4829,4829,-500,-500,980,0,0,1304284,True,H64H-BA84-EC9M-7K0A
JZ_l0QmSej-NAg,1520248417,–í—ñ–¥: –í–∏–∫–∞–ª—é–∫ –û–ª–µ–∫—Å—ñ–π –°–µ—Ä–≥—ñ–π–æ–≤–∏—á,–ø—ñ—É –ø—ñ—É,4829,4829,500,500,980,0,0,1304784,True
gulRncotBWdlCw,1520237289,–ö–∏—ó–≤—Å—å–∫–∏–π –º–µ—Ç—Ä–æ–ø–æ–ªi—Ç–µ–Ω,4111,4111,-500,-500,980,0,0,1304284,False,4PE4-C5B9-2PH4-3C27
X4pBtRZZP4pAaw,1520182591,magazin,5621,5621,-9900,-9900,980,0,0,1304784,False,3CBA-C837-53HE-AK85
NGrUuHMQj9oxLQ,1520182337,–°—ñ–ª—å–ø–æ,5411,5411,-7980,-7980,980,0,159,1314684,False,T9TA-2H7P-B4P7-PEXT
y6vi7hTeO2ZN_A,1520181342,Stradivarius,5651,5651,-59900,-59900,980,0,0,1322664,False,8K32-CECM-HCX2-X88C
rBrMO9bDnqS2PQ,1520164274,"–ö–∏—ó–≤—Å—Ç–∞—Ä
+380962159945",4812,4812,-10000,-10000,980,0,0,1382564,True,831K-BP26-6T4M-PMH2
DspxVV3mpWrSSw,1520164194,"–ö–∏—ó–≤—Å—Ç–∞—Ä
+380679948904",4812,4812,-10000,-10000,980,0,0,1392564,True,8EK2-EX24-8E2T-0T6E
urFFHPyJU1kv7Q,1520157356,Uber,4121,4121,-16694,-16565,980,0,0,1402564,False,H095-A3T0-763E-B7BP
CpFWno5ANdgTdA,1520154977,–ê–ª–ª–æ,5732,5732,-54800,-54800,980,0,0,1419258,False,T4AK-0CA4-CBBX-EX87
utSpRQkF-vzmOQ,1520108862,–ê–¢–ë,5411,5411,-28590,-28590,980,0,571,1474058,False,94PC-CMMB-EAAC-H71T
-xNRcb-SnKMCfg,1520012536,–ê–¢–ë,5499,5499,-12680,-12680,980,0,253,1502648,False,BB4K-58M3-T57B-MMT1
fHQVLIaD8UQERQ,1519997869,Novus,5499,5499,-27730,-27730,980,0,554,1515328,False,EATA-9XXE-P97C-2PXB
EMVj30xZZpnrJQ,1519995502,–ö–∏—ó–≤—Å—å–∫–∏–π –º–µ—Ç—Ä–æ–ø–æ–ªi—Ç–µ–Ω,4111,4111,-500,-500,980,0,0,1543058,False,P8M2-2BXH-12X8-001X
HXvgZwGDvzq7AA,1519992791,PIROGOVAYANIKOLAY3,5811,5811,-5500,-5500,980,0,110,1543558,False,K833-MT44-18MK-EH26
NDgqRQdy6bgj_A,1519992135,PIROGOVAYANIKOLAY3,5811,5811,-25500,-25500,980,0,510,1549058,False,K740-4PM4-9B0T-0BK5
rGx8YjmIydxHfQ,1519990815,–ö–∏—ó–≤—Å—å–∫–∏–π –º–µ—Ç—Ä–æ–ø–æ–ªi—Ç–µ–Ω,4111,4111,-500,-500,980,0,0,1574558,False,6M8P-1KAP-E8M2-H1P1
ujp2KzLrHLCMfA,1519928311,–ê–¢–ë,5411,5411,-3760,-3760,980,0,75,1575058,False,K560-PC50-CT96-E25X
_F0pBvBJUsayOw,1519925403,–ö–∏—ó–≤—Å—å–∫–∏–π –º–µ—Ç—Ä–æ–ø–æ–ªi—Ç–µ–Ω,4111,4111,-500,-500,980,0,0,1578818,False,C9AH-3ET8-MB7E-65TK
409JihOLdDoEUg,1519914311,–í—ñ–¥—Å–æ—Ç–∫–∏ –∑–∞ –ª—é—Ç–∏–π,4829,4829,3430,3430,980,0,0,1579318,True
Jt0IBQXxc-r2WQ,1519908806,Sanatrelo75N4F3Y8N4SHC,5812,5812,-34900,-34900,980,0,698,1575888,False,H5T8-X248-MAMT-9K9X
gT471-rBlxIUIg,1519908765,Sanatrelo75N4F3Y8N4SHC,5812,5812,-7500,-7500,980,0,150,1610788,False,M8A4-59H7-8C5X-XC91
97Iroq4XN02eCw,1519889563,–ö–∏—ó–≤—Å—å–∫–∏–π –º–µ—Ç—Ä–æ–ø–æ–ªi—Ç–µ–Ω,4111,4111,-500,-500,980,0,0,1618288,False,X647-4T8E-XH4P-KHH2
pTaOL1EBl_EzPQ,1525013626,–ê–¢–ë,5411,5411,-5140,-5140,980,0,0,301815,False,BX1B-59T3-4PEA-PB8P
DX4Jqlb8Nr5Z2Q,1525008420,–ê–ø—Ç–µ–∫–∞ –ù–∏–∑—å–∫–∏—Ö –¶—ñ–Ω,5912,5912,-15400,-15400,980,0,0,306955,False,55BM-6P9E-MK9X-A253
y-aHGFwfszAMyA,1525006402,–ö–∏—ó–≤—Å—å–∫–∏–π –º–µ—Ç—Ä–æ–ø–æ–ªi—Ç–µ–Ω,4111,4111,-500,-500,980,0,0,322355,False,X51E-H552-X4M3-X4PP
CJBagoMbQJUBMg,1525004179,Uber,4121,4121,-12433,-12433,980,0,0,322855,False,C3B6-9MC9-E2C6-C349
0xzGOYonFmLA1Q,1524995356,Uber,4121,4121,-6881,-6881,980,0,0,335288,False,1BK2-X57C-7929-8MHB
WJQ2BWNBMQ9EDA,1524990772,–ö–∏—ó–≤—Å—å–∫–∏–π –º–µ—Ç—Ä–æ–ø–æ–ªi—Ç–µ–Ω,4111,4111,-500,-500,980,0,0,342169,False,06TE-PCCH-HK91-XMHK
Ykre22WtnVYGOw,1524931298,Noodle Doodle,5812,5812,-40700,-40700,980,0,0,342669,False,A87B-58BK-2P5M-C8XC
rYgllxEPEJtmZg,1524912185,VETERENARNYY GOSPITAL,742,742,-80000,-80000,980,0,0,383369,False,X724-6HCT-B9KM-8MP0
r0ALd0rTJ6RZCw,1524908223,McDonald's,5814,5814,-24400,-24400,980,0,0,463369,False,M7K3-8X19-AK4P-1MX7
uzcqhjvCsJu3fw,1524855868,Uber,4121,4121,-16412,-16412,980,0,0,487769,False,EB2B-1058-5PT2-1ABE
76A2WEom2xqfvg,1524828894,THE BLUE CUP,5812,5812,-7800,-7800,980,0,0,504181,False,13B8-BA14-BK14-6K3T
EdJnHzLYPs6tIg,1524828060,IQOSSPACE8M12IA1F6P8YP,5812,5812,-189900,-189900,980,0,0,511981,False,C2AM-P3TP-KK70-0325
7gk-jmlvJgby-A,1524814860,–ö–∏—ó–≤—Å—å–∫–∏–π –º–µ—Ç—Ä–æ–ø–æ–ªi—Ç–µ–Ω,4111,4111,-500,-500,980,0,0,701881,False,39BA-MH42-99B9-K135
FJdraEWhY7Z-fQ,1524761689,–ê–¢–ë,5411,5411,-40910,-40910,980,0,0,702381,False,BM2H-5HBC-9BEM-6007
JhjYiCiRRtmiww,1524743382,FOP YGHNATJEVA DA,5812,5812,-35100,-35100,980,0,0,743291,False,CTCK-EP9X-A5X7-08BE
P6N5IYaot72DUg,1524733372,MagazinRomashka62O7SY4,5441,5441,-2500,-2500,980,0,0,778391,False,19KH-3T6C-M5EC-08HH
xvTwtuTByinBmQ,1524733184,–§–∞–∫—É–ª—å—Ç–µ—Ç-–§–∞—Ä–º,5912,5912,-37470,-37470,980,0,0,780891,False,E6XM-CPTC-3B15-B712
cxcs3Sx5CvzVGA,1524726409,magazinPRODUKTI,5499,5499,-2750,-2750,980,0,0,818361,False,PB21-1H3C-EP60-5P4P
7Tc0xC73prGASA,1524726164,–§–∞–∫—É–ª—å—Ç–µ—Ç-–§–∞—Ä–º,5912,5912,-3100,-3100,980,0,0,821111,False,39P7-1M3C-1MT7-0E6P
W4WMEq4C0RgeZQ,1524681240,Uber,4121,4121,-8282,-8282,980,0,0,824211,False,619P-4HCH-0C4X-173P
l3bZPnTGmw3h3A,1524673587,SHOP KINOMARKET,5499,5499,-20400,-20400,980,0,0,832493,False,HME2-3HB4-E81B-TEB1
qQoeaFMTqBk_9w,1524672409,BEERPOINTBLOCK,5812,5812,-5300,-5300,980,0,0,852893,False,32B7-4P31-KMP0-565M
gb7LZ_pt6ohgcw,1524669856,Uber,4121,4121,-9179,-9179,980,0,0,858193,False,BM8H-A2AX-CC1K-1MHM
PqP6EQk-ldtuqw,1524669299,–ö–∏—ó–≤—Å—å–∫–∏–π –º–µ—Ç—Ä–æ–ø–æ–ªi—Ç–µ–Ω,4111,4111,-500,-500,980,0,0,867372,False,0BX9-2TX5-TTM2-0751
LhPeqsxSeQqtKw,1524669050,Zara,5651,5651,-99900,-99900,980,0,0,867872,False,2720-H5EX-AAAP-PPTE
ke7EbPj508aTAA,1524639332,–ö–∏—ó–≤—Å—å–∫–∏–π –º–µ—Ç—Ä–æ–ø–æ–ªi—Ç–µ–Ω,4111,4111,-500,-500,980,0,0,967772,False,5B4A-PC0C-A6CH-312B
vgedWoFTpU1RwQ,1524589401,–ù–æ–≤–∞ –ø–æ—à—Ç–∞,4214,4214,-3700,-3700,980,0,0,2468272,False,P77C-T7HB-B7B6-T0C4
fyWg1LRP9pP-3w,1524589359,–ù–æ–≤–∞ –ø–æ—à—Ç–∞,6538,6538,-38678,-38678,980,1078,0,2471972,False,89HC-020M-7PAT-K418
2nnGLkzpXPvElg,1524586753,–ö–∏—ó–≤—Å—å–∫–∏–π –º–µ—Ç—Ä–æ–ø–æ–ªi—Ç–µ–Ω,4111,4111,-500,-500,980,0,0,2510650,False,C136-HHXC-1404-C1ME
6F467IupbJszNA,1524557280,THE BLUE CUP,5812,5812,-3900,-3900,980,0,0,2511150,False,5T7K-P436-HC78-P4XX
YisTl1htkYzcYw,1524555902,–ö–∏—ó–≤—Å—å–∫–∏–π –º–µ—Ç—Ä–æ–ø–æ–ªi—Ç–µ–Ω,4111,4111,-500,-500,980,0,0,2515050,False,293H-EE0A-0KK6-8AC7
lBzIsrbsJlB8QQ,1524482380,"–ö–∏—ó–≤—Å—Ç–∞—Ä
+380978495150",4812,4812,-5500,-5500,980,0,0,2515550,True,A9PA-9A5C-0K9A-H7AA
O8RBgOzHUWHgRw,1524383374,Lesya,—Ç–∞–∫—Å–∏,4829,4829,-17800,-17800,980,0,0,2521050,True,KAHH-26MH-MAP6-6210
Ox-W-kJDe2XL1A,1524376149,–§–∞–∫—É–ª—å—Ç–µ—Ç-–§–∞—Ä–º,5912,5912,-23560,-23560,980,0,0,2538850,False,4AEM-XXEK-604H-724A
05jS8Mh5w8EAQg,1524332074,–ê–¢–ë,5499,5499,-27410,-27410,980,0,0,2562410,False,CC1E-4920-7A86-8AEE
tDFBOPr2UulSzg,1524319273,–ö–∏—ó–≤—Å—å–∫–∏–π –º–µ—Ç—Ä–æ–ø–æ–ªi—Ç–µ–Ω,4111,4111,-500,-500,980,0,0,2589820,False,H24M-1MHT-X98P-2K8C
EfGJSB1L5gGmjw,1524319268,–ö–∏—ó–≤—Å—å–∫–∏–π –º–µ—Ç—Ä–æ–ø–æ–ªi—Ç–µ–Ω,4111,4111,-500,-500,980,0,0,2590320,False,H62M-98H2-6KTM-6673
xmB-Ds3BEknmsA,1524318126,LAGERATERIA,5814,5814,-6000,-6000,980,0,0,2590820,False,2XH2-HPMH-05PA-B3AA
phaoCVzJKyLZ7w,1524316895,MAGAZIN31539,5912,5912,-19990,-19990,980,0,0,2596820,False,7HK9-5B47-CKXC-C622
bZbHGipxPT3Qkg,1524315863,Sanatrelo75N4F3Y8N4SHC,5812,5812,-9500,-9500,980,0,0,2616810,False,91HX-T59E-36BC-715E
_aSGC1ttgX0S4w,1524315830,Sanatrelo75N4F3Y8N4SHC,5812,5812,-39700,-39700,980,0,0,2626310,False,1P41-4KCK-31PH-C3MH
5VlqFjJJLp84yw,1524289295,–°–∫–∞—Å—É–≤–∞–Ω–Ω—è. Uber,4121,4121,11899,11899,980,0,0,2666010,True
gAv3Tcrs8hcjJw,1524289250,Uber,4121,4121,-12138,-12138,980,0,0,2654111,False,1E0X-EB98-34E8-95CA
MxsPw_A1OsHAuQ,1524287314,Uber,4121,4121,-11899,-11899,980,0,0,2666249,True
yqwFrAzLVpQ97w,1524244075,Novus,5499,5499,-59083,-59083,980,0,0,2678148,False,K494-3H17-TXT4-M03T
RccWBmQMvLVGyg,1524241016,–ö–∏—ó–≤—Å—å–∫–∏–π –º–µ—Ç—Ä–æ–ø–æ–ªi—Ç–µ–Ω,4111,4111,-500,-500,980,0,0,2737231,False,0836-168A-4XM3-781E
PePbGdUvoN5c-A,1524211362,THE BLUE CUP,5812,5812,-3900,-3900,980,0,0,2737731,False,7TKA-811X-36TA-EC5E
Asc61yaNBnSfOA,1524209826,–ö–∏—ó–≤—Å—å–∫–∏–π –º–µ—Ç—Ä–æ–ø–æ–ªi—Ç–µ–Ω,4111,4111,-500,-500,980,0,0,2741631,False,49AP-2TAE-039K-PT5X
S4mSNLG37-6dlg,1524168954,Uber,4121,4121,-18873,-18873,980,0,0,2742131,False,TEBK-090C-6X7X-M9E9
7-gnOVLULLVhBw,1524160065,–ö–∏—ó–≤—Å—å–∫–∏–π –º–µ—Ç—Ä–æ–ø–æ–ªi—Ç–µ–Ω,4111,4111,-500,-500,980,0,0,2761004,False,3E04-8X1C-3T84-7EP7
CMhUEOmnWorchw,1524123564,–í—ñ–¥: 51****8598,4829,4829,1200000,1200000,980,0,0,2761504,True
zCVcxXfwa4lyhA,1524122371,THE BLUE CUP,5812,5812,-11700,-11700,980,0,0,1561504,False,7A9B-245E-10A2-HTXC
d7cug6-M2gMG-w,1524121913,–í–∏–≤–µ–¥–µ–Ω–Ω—è –∫–µ—à–±–µ–∫—É 506.00‚Ç¥,4829,4829,40733,40733,980,0,0,1573204,True
tEnzgXSRkDv9dA,1524119163,–ö–∏—ó–≤—Å—å–∫–∏–π –º–µ—Ç—Ä–æ–ø–æ–ªi—Ç–µ–Ω,4111,4111,-500,-500,980,0,0,32471,False,7K1H-0TA6-65P5-E5BK
J4i0ar9fSHNlFQ,1524119158,–ö–∏—ó–≤—Å—å–∫–∏–π –º–µ—Ç—Ä–æ–ø–æ–ªi—Ç–µ–Ω,4111,4111,-500,-500,980,0,0,32971,False,EHCX-76HK-57XB-6E9M
23zEIi0ZI8kgaQ,1524069754,–ö–∏—ó–≤—Å—å–∫–∏–π –º–µ—Ç—Ä–æ–ø–æ–ªi—Ç–µ–Ω,4111,4111,-500,-500,980,0,0,33471,False,PEAH-PEX8-EHM6-C2PE
Wg4ph8J-2fUrRg,1524034916,McDonald's,5814,5814,-8400,-8400,980,0,0,33971,False,8CE2-PAPM-627T-3A9H
_1FACHfNaTyePA,1524033015,–ö–∏—ó–≤—Å—å–∫–∏–π –º–µ—Ç—Ä–æ–ø–æ–ªi—Ç–µ–Ω,4111,4111,-500,-500,980,0,0,42371,False,024E-5MX1-7K8T-7TPE
WpFsqkiM8u2mDA,1524033011,–ö–∏—ó–≤—Å—å–∫–∏–π –º–µ—Ç—Ä–æ–ø–æ–ªi—Ç–µ–Ω,4111,4111,-500,-500,980,0,0,42871,False,T0MB-18T1-96M6-10M6
gZM_OBgsONaDOg,1523987268,Uber,4121,4121,-16563,-16563,980,0,1955,43371,False,2B0P-ETA6-78HB-6748
NwYqxv-lChkA2w,1523948140,THE BLUE CUP,5812,5812,-7800,-7800,980,0,0,59934,False,64KM-4M54-TE9T-0E2X
imepweDqvg23Wg,1523946356,–ö–∏—ó–≤—Å—å–∫–∏–π –º–µ—Ç—Ä–æ–ø–æ–ªi—Ç–µ–Ω,4111,4111,-500,-500,980,0,0,67734,False,6K07-BK35-1598-6P1M
GOZXJD4begLeBQ,1523946351,–ö–∏—ó–≤—Å—å–∫–∏–π –º–µ—Ç—Ä–æ–ø–æ–ªi—Ç–µ–Ω,4111,4111,-500,-500,980,0,0,68234,False,1146-AP3H-A7H6-X7KX
OwQS0pjrSdIpZQ,1523903145,Uber,4121,4121,-18243,-18243,980,0,2554,68734,False,KE8H-BMCM-HAH2-K612
S-ynkpDCTdWqDQ,1523901654,Uber,4121,4121,-19031,-19031,980,0,2664,86977,False,AEX2-9MCM-1X16-A6H4
hcMRK-KCaN61mQ,1523859920,–ö–∏—ó–≤—Å—å–∫–∏–π –º–µ—Ç—Ä–æ–ø–æ–ªi—Ç–µ–Ω,4111,4111,-500,-500,980,0,0,106008,False,K070-KEKP-84A4-T272
d7NJ1a2hPOuwUg,1523859898,–ö–∏—ó–≤—Å—å–∫–∏–π –º–µ—Ç—Ä–æ–ø–æ–ªi—Ç–µ–Ω,4111,4111,-500,-500,980,0,0,106508,False,P43E-B101-XA42-3B5P
qiUT2zxNeS7VIg,1523802231,Uber,4121,4121,-14670,-14670,980,0,2053,107008,False,505X-TX4T-TC9M-M96C
pR_KRifB7iAupQ,1523779858,–ö–∏—ó–≤—Å—å–∫–∏–π –º–µ—Ç—Ä–æ–ø–æ–ªi—Ç–µ–Ω,4111,4111,-500,-500,980,0,0,121678,False,4KE7-60K2-T3T1-B29X
vZlH1p2LthoZmQ,1523739827,–ê–¢–ë,5411,5411,-11610,-11610,980,0,464,122178,False,8EXA-8585-697M-1075
VRBmd3IS5F9FUQ,1523732838,VUSOSITE,6300,6300,-40596,-40596,980,0,0,133788,False,C577-64AT-90C4-9996
2q9KsOagqPIw3A,1523709516,PHOPMarchukLI13WCNFOB4,4215,4215,-34800,-34800,980,0,0,174384,False,5C7X-4HMX-HEXK-629E
qpGGU6lGwSAxEg,1523643979,Uber,4121,4121,-15019,-15019,980,0,2102,209184,False,6PEX-XPA9-HP3M-HXTK
Qi2cwroI7JkgDw,1523632545,magazinPRODUKTI,5499,5499,-10570,-10570,980,0,422,224203,False,3AKT-TC6T-5TM0-0K0T
26FG2BDgx7Z54g,1523562010,Uber,4121,4121,-18968,-18968,980,0,2655,234773,False,3K9A-BCB8-MMPC-MMT9
Y33OBiwr2VCMiQ,1523557804,Uber,4121,4121,-17209,-17209,980,0,2409,253741,False,37P1-XB2K-MAX4-8H01
WQiary_36bWAvw,1523514713,–ö–∏—ó–≤—Å—å–∫–∏–π –º–µ—Ç—Ä–æ–ø–æ–ªi—Ç–µ–Ω,4111,4111,-500,-500,980,0,0,270950,False,XT3X-T63B-HKXC-TH4K
ycoGL2EjkDmAaQ,1523514708,–ö–∏—ó–≤—Å—å–∫–∏–π –º–µ—Ç—Ä–æ–ø–æ–ªi—Ç–µ–Ω,4111,4111,-500,-500,980,0,0,271450,False,90H4-8A96-76BX-X725
iVdCKCO4R8mOXA,1523466730,–í—ñ–¥: –°–∞—á–µ–Ω–∫–æ –û–ª–µ—Å—è –°–µ—Ä–≥—ñ—ó–≤–Ω–∞,mine mine,4829,4829,51118,51118,980,0,0,271950,True
gp8wQcfzrLDTpw,1523427819,–ö–∏—ó–≤—Å—å–∫–∏–π –º–µ—Ç—Ä–æ–ø–æ–ªi—Ç–µ–Ω,4111,4111,-500,-500,980,0,0,220832,False,74EA-6K4H-A56A-EPCB
g0AmUy5bfhYHDA,1523382787,–ö–∏—ó–≤—Å—å–∫–∏–π –º–µ—Ç—Ä–æ–ø–æ–ªi—Ç–µ–Ω,4111,4111,-500,-500,980,0,0,221332,False,7C53-X3AB-H49T-8B0H
UqbVwAdNR6MQFg,1523359605,McDonald's,5814,5814,-8400,-8400,980,0,0,221832,False,MA3K-9HMA-C1TP-86HX
rN6t0JVyw2gblg,1523358429,–ö–∏—ó–≤—Å—å–∫–∏–π –º–µ—Ç—Ä–æ–ø–æ–ªi—Ç–µ–Ω,4111,4111,-500,-500,980,0,0,230232,False,4H26-BBM4-1605-17T7
nBckNNts2jy0EiHFNdk,1523315108,"–°–∫–∞—Å—É–≤–∞–Ω–Ω—è. Uber BV, Hamminkweg 5, Vorden, NL",4121,4121,2680,2680,980,0,0,230732,True
yrSoGBK6qO1JeQ,1523305171,Uber,4121,4121,-21349,-21349,980,0,2988,228052,False,H6HA-4K1E-MC3A-78P5
LXF2uqhBEM3sPg,1523303594,ZeOldar28C60SRE4GL000,5812,5812,-53500,-53500,980,0,0,249401,False,K8M1-CB9B-H138-6025
7Xal7gdCXK-bJw,1523303548,ZeOldBar28C60SRE4GL000,5812,5812,-9000,-9000,980,0,0,302901,False,CM19-T8K1-43EA-BX12
i8ls7iLrKbmXcg,1523297095,RESTORAN NAM,5812,5812,-95200,-95200,980,0,0,311901,False,22A2-TK0A-9T85-HA69
_R7cl1HwZ8_Uog,1523297042,RESTORAN NAM,5812,5812,-82000,-82000,980,0,0,407101,False,TTCP-4X80-6T6T-PM05
lMXOXSiidoPSiQ,1523285450,–ö–∏—ó–≤—Å—å–∫–∏–π –º–µ—Ç—Ä–æ–ø–æ–ªi—Ç–µ–Ω,4111,4111,-500,-500,980,0,0,489101,False,MH0M-311H-HCX4-C31C
I2oVzTehOIb9UA,1523282169,Uber,4121,4121,-11061,-11061,980,0,1548,489601,False,H99E-P3A9-K2C7-38T9
vv-MAEtvLUQQSg,1523201366,CINNABON TEC GLOBUS,5812,5812,-11000,-11000,980,0,0,500662,False,7EC3-8089-T2P3-E5TA
kFMZjqEs9dengw,1523195141,Uber,4121,4121,-9267,-9267,980,0,1297,511662,False,9315-4B8E-62B2-467A
oJRWRT8fWp87gg,1523188005,–ê–¢–ë,5411,5411,-4040,-4040,980,0,161,520929,False,C0M6-MX37-AP53-H6XM
STnThqe93w9MmA,1523106486,Uber,4121,4121,-11146,-11146,980,0,1560,524969,False,5HPA-0X5C-HC6K-5139
QlwZj-Np5GHjHw,1523090974,Uber,4121,4121,-5289,-5289,980,0,740,536115,False,3X1K-1CK1-578M-9CA1
fgMdnumk_ByCHA,1523088327,Uber,4121,4121,-11931,-11931,980,0,1670,541404,False,HTEE-5K73-E967-8C34
q0LkpK_Ljd0n6w,1523040347,Uber,4121,4121,-14680,-14680,980,0,2055,553335,False,2PB2-T5AM-B1BP-8T1C
fZ6QpB3EeyxBrQ,1522998596,McDonald's,5814,5814,-12600,-12600,980,0,0,568015,False,H5K1-A392-X502-XCTC
TLmeAvqwtqHfyQ,1522996415,Lesya,–±–∞–∫—Å—ã,4829,4829,-220792,-220792,980,8492,0,580615,True,0XC8-09M4-C8E8-6ETK
jNsCoeErWmbogg,1522955988,Uber,4121,4121,-15516,-15516,980,0,2172,801407,False,3XX1-2367-3T21-9XB9
1RVM0enZCW8LlA,1522945380,Uber,4121,4121,-18444,-18444,980,0,2582,816923,False,E8EC-41A5-K934-BK24
k3_8kXkq1hGBDQ,1522912296,–ö–∏—ó–≤—Å—å–∫–∏–π –º–µ—Ç—Ä–æ–ø–æ–ªi—Ç–µ–Ω,4111,4111,-500,-500,980,0,0,835367,False,4CE4-HMK9-31M4-0381
2nDmqpHgWg73TqI4Lw,1522881425,"–°–∫–∞—Å—É–≤–∞–Ω–Ω—è. McDonald's 053, 27,BROVARSKYI AVE., KYIV, UA",5814,5814,12000,12000,980,0,0,835867,True
X-Ud2W2jBJNcHw,1522863914,–ê–¢–ë,5411,5411,-30280,-30280,980,0,1211,823867,False,KH34-EK4T-AKP0-HB6E
wKdrx6JReDOwAg,1522861280,Uber,4121,4121,-13426,-13426,980,0,1879,854147,False,T71X-B2AT-7KX3-4PC4
vM5Adls6x9f7aQ,1522830864,"Lifecell
+380631692598",4812,4812,-1000,-1000,980,0,0,867573,True,A7A8-M772-X7EH-M1E3
Ja6FOi-LA3cdXg,1522830643,"Lifecell
+380631692598",4812,4812,-13000,-13000,980,0,0,868573,True,06BM-H817-95X3-2E0X
hMktjGsV-J3hkQ,1522823373,–ö–∏—ó–≤—Å—å–∫–∏–π –º–µ—Ç—Ä–æ–ø–æ–ªi—Ç–µ–Ω,4111,4111,-500,-500,980,0,0,881573,False,EHM4-T48E-T7MA-T5HE
1wE1eBS44MFwsw,1522749429,–ö–∏—ó–≤—Å—å–∫–∏–π –º–µ—Ç—Ä–æ–ø–æ–ªi—Ç–µ–Ω,4111,4111,-500,-500,980,0,0,882073,False,4XXP-5EXA-HCMX-0HEP
7YMfEtGIv66xKA,1522741964,"–ö–∏—ó–≤—Å—Ç–∞—Ä
+380960149625",4812,4812,-7000,-7000,980,0,0,882573,True,1E05-4BB4-8TXH-7X13
EvAds2p-zCa6rQ,1522739520,Uber,4121,4121,-15668,-15668,980,0,2193,889573,False,ME04-P6X7-XPCM-1K8B
0_DlyYeeCRcqtQ,1522714099,Uber,4121,4121,-23647,-23647,980,0,3310,905241,False,7HCM-XT34-36P2-5X9C
jzSZDVcDatk2GQ,1522711474,Uber,4121,4121,-25473,-25473,980,0,3566,928888,False,CC83-HK4A-17XH-TPAP
uRyXPQMers-_c9-F,1522709584,"–°–∫–∞—Å—É–≤–∞–Ω–Ω—è. UBER BV, Vijzelstraat 68, 800-592-8996, NL",4121,4121,405,405,980,0,0,954361,True
oS8lYLhHL5rZsg,1522691130,Uber,4121,4121,-2000,-2000,980,0,280,953956,False,785C-HK97-K1M0-04AP
Ovkqc0K3DVyJuA,1522690912,Uber,4121,4121,-7215,-7215,980,0,1010,955956,False,M0B8-9ECA-K2E6-1APK
bpGxb5aMNEi_vg,1522687500,McDonald's,5814,5814,-11500,-11500,980,0,0,963171,False,4B9T-00HK-0C4M-2KE9
ugNafU91TJgjQg,1522687332,McDonald's,5814,5814,-25300,-25300,980,0,0,974671,False,HKX1-M2B4-90P0-6CX3
_yydvXchrDUUtQ,1522686295,–ö–∏—ó–≤—Å—å–∫–∏–π –º–µ—Ç—Ä–æ–ø–æ–ªi—Ç–µ–Ω,4111,4111,-500,-500,980,0,0,999971,False,A313-188A-6A9T-8X64
HJ_dMhiBKL-iwg,1522665220,–ü—Ä–∏–≤–∞—Ç24,6536,6536,973000,973000,980,0,0,1000471,False
m8y4x0_DT7KAag,1522649913,–ö–∏—ó–≤—Å—å–∫–∏–π –º–µ—Ç—Ä–æ–ø–æ–ªi—Ç–µ–Ω,4111,4111,-500,-500,980,0,0,27471,False,2AKH-AK0E-7314-BK11
IrKIlIxpojnF7w,1522609029,Uber,4121,4121,-17862,-17862,980,0,2500,27971,False,ME2K-B95X-C2ME-34E2
t85xZPdgFEoAGA,1522588859,–í—ñ–¥—Å–æ—Ç–∫–∏ –∑–∞ –±–µ—Ä–µ–∑–µ–Ω—å,4829,4829,2378,2378,980,0,0,45833,True
8QfB70kk1bCjpg,1522581563,–ö–∏—ó–≤—Å—å–∫–∏–π –º–µ—Ç—Ä–æ–ø–æ–ªi—Ç–µ–Ω,4111,4111,-500,-500,980,0,0,43455,False,216K-64T6-9404-3055
UoOs774dLhGwGA,1522573735,–í–∏–≤–µ–¥–µ–Ω–Ω—è –∫–µ—à–±–µ–∫—É 466.46‚Ç¥,4829,4829,37549,37549,980,0,0,43955,True
P_fbfHiQO_HNuQ,1527697932,–ö–∏—ó–≤—Å—å–∫–∏–π –º–µ—Ç—Ä–æ–ø–æ–ªi—Ç–µ–Ω,4111,4111,-500,-500,980,0,0,477326,False,3HKX-A247-02X4-9PE3
HstPBNvKSmQJ_Q,1527660622,–ö–∏—ó–≤—Å—å–∫–∏–π –º–µ—Ç—Ä–æ–ø–æ–ªi—Ç–µ–Ω,4111,4111,-500,-500,980,0,0,477826,False,HM54-0MM0-4X36-H999
v0sygpeE1S1y8Q,1527660617,–ö–∏—ó–≤—Å—å–∫–∏–π –º–µ—Ç—Ä–æ–ø–æ–ªi—Ç–µ–Ω,4111,4111,-500,-500,980,0,0,478326,False,E3E7-T6KB-7035-09K6
Qh9sCDTNnqhJR152SLpaQms,1527636704,–°–∫–∞—Å—É–≤–∞–Ω–Ω—è. Uber,4121,4121,11075,11075,980,0,0,478826,True
0P6vU7FMQ7_KOWGbp_8aZ8M,1527636704,–°–∫–∞—Å—É–≤–∞–Ω–Ω—è. Uber,4121,4121,9067,9067,980,0,0,467751,True
P2S4idFtcJtIpXJE2uxS,1527636704,–°–∫–∞—Å—É–≤–∞–Ω–Ω—è. Uber,4121,4121,4000,4000,980,0,0,458684,True
Y2-Lo22WkbObpTSH7lL7,1527636704,Uber,4121,4121,-4000,-4000,980,0,0,454684,True
6USEhqU7S-r1Vg,1527616576,–ö–∏—ó–≤—Å—å–∫–∏–π –º–µ—Ç—Ä–æ–ø–æ–ªi—Ç–µ–Ω,4111,4111,-500,-500,980,0,0,458684,False,7B1C-58PK-67EH-PEA9
LfP2YWQ_1Eo4Kg,1527616569,–ö–∏—ó–≤—Å—å–∫–∏–π –º–µ—Ç—Ä–æ–ø–æ–ªi—Ç–µ–Ω,4111,4111,-500,-500,980,0,0,459184,False,E30M-259K-28MT-3E05
_yyfuXwirDkWtg,1527611294,Uber BV,4121,4121,-6809,-6809,980,0,0,459684,False
bC6wg-5R2eWeQA,1527611289,UBER   *6G6IG,4121,4121,-6809,-6809,980,0,0,466493,False,M95M-T8E0-A030-2H15
JKibl7dJYp19hQ,1527599483,McDonald's,5814,5814,-12400,-12400,980,0,0,473302,False,1644-8TX5-6C7K-1B6M
fr9txClpbVDG5g,1527576528,THE BLUE CUP,5812,5812,-6300,-6300,980,0,0,485702,False,7X99-B1C1-K93M-BM7P
BhOLkDOKgg2B8w,1527574637,–ö–∏—ó–≤—Å—å–∫–∏–π –º–µ—Ç—Ä–æ–ø–æ–ªi—Ç–µ–Ω,4111,4111,-500,-500,980,0,0,492002,False,45BB-3EK3-98XE-K32B
ryu_jNUCuIJHCg,1527520022,LIQPAY*TOV MPS Ukrayi,5812,5812,-12400,-12400,980,0,0,492502,False,07HT-4292-M159-BM9A
5CkJ08jJnJzUJg,1527518688,–ê–¢–ë,5411,5411,-9590,-9590,980,0,0,504902,False,8ACA-90EA-T41T-CTC6
33QaartliRGGTA,1527516606,Uber BV,4121,4121,-11075,-11075,980,0,0,514492,False
NPsPnOsQ2DUFDg,1527355463,Uber BV,4121,4121,-5867,-5867,980,0,0,525567,False,KAP7-1C67-6E15-734P
m6hf3Baa6uuwrQ,1527337938,Uber BV,4121,4121,-6560,-6560,980,0,0,531434,False,4PMB-570X-A767-BHEK
rBQzQ6tGj57aUQ,1527264242,–ö–∏—ó–≤—Å—å–∫–∏–π –º–µ—Ç—Ä–æ–ø–æ–ªi—Ç–µ–Ω,4111,4111,-500,-500,980,0,0,537994,False,TTCX-1136-PK0K-1574
SyFH3MYQWEJFwA,1527231129,THE BLUE CUP,5812,5812,-6300,-6300,980,0,0,538494,False,T4B6-T4XM-2EPK-272M
JIjHNkVbe0i4_Q,1527229476,–ö–∏—ó–≤—Å—å–∫–∏–π –º–µ—Ç—Ä–æ–ø–æ–ªi—Ç–µ–Ω,4111,4111,-500,-500,980,0,0,544794,False,XH4K-MXC1-E83X-EBMP
EnrCml9_ZiElXA,1527229471,–ö–∏—ó–≤—Å—å–∫–∏–π –º–µ—Ç—Ä–æ–ø–æ–ªi—Ç–µ–Ω,4111,4111,-500,-500,980,0,0,545294,False,X0H5-7T3E-6ABM-BHM4
xvMNBw2-MMHuOg,1527182490,–ö–∏—ó–≤—Å—å–∫–∏–π –º–µ—Ç—Ä–æ–ø–æ–ªi—Ç–µ–Ω,4111,4111,-500,-500,980,0,0,545794,False,9P26-P96A-56P9-3M6B
zaPMFYRuMv0NGQ,1527182486,–ö–∏—ó–≤—Å—å–∫–∏–π –º–µ—Ç—Ä–æ–ø–æ–ªi—Ç–µ–Ω,4111,4111,-500,-500,980,0,0,546294,False,MEHX-3TKT-TKH7-TCBE
9NGiCq2NQ_4hxA,1527177676,–ö–∏—ó–≤—Å—å–∫–∏–π –º–µ—Ç—Ä–æ–ø–æ–ªi—Ç–µ–Ω,4111,4111,-500,-500,980,0,0,546794,False,A711-7KT6-1863-8XKT
2cQ-6stH3H4oLg,1527146156,–ö–∏—ó–≤—Å—å–∫–∏–π –º–µ—Ç—Ä–æ–ø–æ–ªi—Ç–µ–Ω,4111,4111,-500,-500,980,0,0,547294,False,XC5M-42CB-M083-484X
J7m-bTFNTLmX9A,1527145033,"–ö–∏—ó–≤—Å—Ç–∞—Ä
+380978495150",4812,4812,-10000,-10000,980,0,0,547794,True,780K-8MCA-A0B7-X474
bny9pDodA43LPg,1527143085,KL_KYIV_Vatutina_11,5541,5541,-3800,-3800,980,0,0,557794,False,AA88-E8H3-29X8-P7AX
YDi72_MUrJkdTQ,1527143043,KL_KYIV_Vatutina_11,5541,5541,-29976,-29976,980,0,0,561594,False,0EKC-4C6B-XK49-T5X9
5ZTuWPgnaSIsnQ,1527136843,–°–∫–∞—Å—É–≤–∞–Ω–Ω—è. Uber,4121,4121,12030,12030,980,0,0,591570,True
hLZITZ4Wh20EUw,1527136724,Uber,4121,4121,-12030,-12030,980,0,0,579540,True
D429fP4i5_0atg,1527102260,–ê–¢–ë,5411,5411,-12840,-12840,980,0,0,591570,False,HM5X-2BCA-EAB4-M3B0
z2h8LJADaz7dTg,1527100080,–ö–∏—ó–≤—Å—å–∫–∏–π –º–µ—Ç—Ä–æ–ø–æ–ªi—Ç–µ–Ω,4111,4111,-500,-500,980,0,0,604410,False,969P-806P-E9C3-PATH
eRyV2-IL8BFf9w,1527058088,THE BLUE CUP,5812,5812,-6300,-6300,980,0,0,604910,False,M3C2-XHXC-A2PB-EMBP
bhAyH6Mls8Osow,1527056412,–ö–∏—ó–≤—Å—å–∫–∏–π –º–µ—Ç—Ä–æ–ø–æ–ªi—Ç–µ–Ω,4111,4111,-500,-500,980,0,0,611210,False,X23T-46MT-C0K8-5PKX
wJ7nPV5gWhnlIg,1527008420,Novus,5499,5499,-62870,-62870,980,0,0,611710,False,PMP6-HX82-H2P7-PEK3
i4cZGIC_xt90QA,1527005603,–ö–∏—ó–≤—Å—å–∫–∏–π –º–µ—Ç—Ä–æ–ø–æ–ªi—Ç–µ–Ω,4111,4111,-500,-500,980,0,0,674580,False,61XK-106E-PCTC-44XH
Qdkk-09YIwDzwQ,1526982469,McDonald's,5814,5814,-12500,-12500,980,0,0,675080,False,1B11-P014-XPC3-35CK
ZswETX6oOtDJyw,1526981035,–ö–∏—ó–≤—Å—å–∫–∏–π –º–µ—Ç—Ä–æ–ø–æ–ªi—Ç–µ–Ω,4111,4111,-500,-500,980,0,0,687580,False,0K25-X21A-269A-AA02
X45OGCg8WnmFew,1526929956,Uber,4121,4121,-8174,-8174,980,0,0,688080,False,A44B-X8P1-CE7H-1131
3JCndEd4SDStWg,1526921089,SHOP KINOMARKET,5499,5499,-9500,-9500,980,0,0,696254,False,50K9-XE16-0MK1-8B5A
FRHlqKjIkY66Zg,1526918651,–ö–∏—ó–≤—Å—å–∫–∏–π –º–µ—Ç—Ä–æ–ø–æ–ªi—Ç–µ–Ω,4111,4111,-500,-500,980,0,0,705754,False,357E-4PK0-12AE-9PK1
IzMH42VNa05Q0A,1526886942,–ö–∏—ó–≤—Å—å–∫–∏–π –º–µ—Ç—Ä–æ–ø–æ–ªi—Ç–µ–Ω,4111,4111,-500,-500,980,0,0,706254,False,4C7C-X3P7-1C2M-7BHX
4_R3svj-b3_STg,1526886865,Watsons,5977,2842,-475,-475,980,0,0,706754,False,C054-2761-CP6K-MMH2
0tO_L-LV7keW0Q,1526747186,Steam,7994,7994,-6500,-6500,980,0,0,707229,False,871T-8M7T-XEHK-C3XT
5fKELp6w1bm_sQ,1526740628,–°–∫–∞—Å—É–≤–∞–Ω–Ω—è. Uber,4121,4121,9576,9576,980,0,0,713729,True
stG3notrlNAf7A,1526740492,Uber,4121,4121,-9576,-9576,980,0,0,704153,True
hStDuUXM9fTAkg,1526732579,–°–∫–∞—Å—É–≤–∞–Ω–Ω—è. Uber,4121,4121,9065,9065,980,0,0,713729,True
hzjX6q90cwnNQA,1526732533,Uber,4121,4121,-9654,-9654,980,0,0,704664,False,AEEP-K698-H942-CEMX
bAndI342zGFfFw,1526732181,–§–æ—Ä–∞,5499,5499,-26858,-26858,980,0,0,714318,False,0XXX-9015-2213-47P8
j1itogoFtXbkwg,1526731025,Uber,4121,4121,-9067,-9067,980,0,0,741176,False
iljcAdyWSI_-BA,1526731023,Uber,4121,4121,-9065,-9065,980,0,0,750243,True
YaBiTmoepyIxFw,1526728773,–§–æ—Ä–∞,5499,5499,-13757,-13757,980,0,0,759308,False,5MA0-K361-1K06-H9K3
uDRs70_GYIJ2Ig,1526727378,–°–∫–∞—Å—É–≤–∞–Ω–Ω—è. Uber,4121,4121,9260,9260,980,0,0,773065,True
uwT3Fu4nHLDIqw,1526727324,Uber,4121,4121,-9415,-9415,980,0,0,763805,False,CP10-3M8T-85C7-K3AA
2_k3dxv2f3LNMw,1526724591,Uber,4121,4121,-9260,-9260,980,0,0,773220,True
9xuGzwuVxJaMbg,1526713519,–í–∏–ø–ª–∞—Ç–∞ –ø—Ä–æ—Ü–µ–Ω—Ç—ñ–≤,4829,4829,993,993,980,0,0,782480,True
wFotkvAQd6ZuxQ,1526711318,Uber,4121,4121,-16511,-16511,980,0,0,781487,False,70K7-AE3K-3KCT-B88T
g17ObPSxb5T8GA,1526660532,–ö–∏—ó–≤—Å—å–∫–∏–π –º–µ—Ç—Ä–æ–ø–æ–ªi—Ç–µ–Ω,4111,4111,-500,-500,980,0,0,797998,False,EH08-52K4-95K2-06BH
7_fWGiuhbEJGhw,1526660184,THE BLUE CUP,5812,5812,-34300,-34300,980,0,0,798498,False,EPP3-0KB6-955H-6105
ljI7kHcrWxztvw,1526628229,–ö–∏—ó–≤—Å—å–∫–∏–π –º–µ—Ç—Ä–æ–ø–æ–ªi—Ç–µ–Ω,4111,4111,-500,-500,980,0,0,832798,False,0B82-TB0M-4PT6-MT5A
-KfUFS2Bt-MuhA,1526577265,–ö–∏—ó–≤—Å—å–∫–∏–π –º–µ—Ç—Ä–æ–ø–æ–ªi—Ç–µ–Ω,4111,4111,-500,-500,980,0,0,833298,False,E102-3BXX-26TM-4TT9
5EgT-dC5s5Z2EQ,1526540029,THE BLUE CUP,5812,5812,-3900,-3900,980,0,0,833798,False,MEKB-KK35-6X44-B36K
B--DzZExiHjhbg,1526538341,–ö–∏—ó–≤—Å—å–∫–∏–π –º–µ—Ç—Ä–æ–ø–æ–ªi—Ç–µ–Ω,4111,4111,-500,-500,980,0,0,837698,False,69KE-HE9H-9BAP-8T49
cVNJN0tDG1J-Dg,1526477896,Apteka51314CFJMG3UFQ0,5912,5912,-16900,-16900,980,0,0,838198,False,CP43-K62P-93A4-4350
9AVS9mInKiwjtw,1526476640,PHOPMarchukLI13WCNFOB4,4215,4215,-16800,-16800,980,0,0,855098,False,P6CT-TMA4-5P13-BHP3
1vojRnNSv0F61zNRfZ_XPWE,1526425856,–°–∫–∞—Å—É–≤–∞–Ω–Ω—è. ChauffeurPrive,4121,4121,156078,4950,978,0,0,871898,True
M_S3-iKfUJl6zQ,1526388099,Apteka51314CFJMG3UFQ0,5912,5912,-50702,-50702,980,0,0,715820,False,4H97-62CC-P2KC-9KP8
oI1L5IwjY4BMWQ,1526229393,–í–∏–≤–µ–¥–µ–Ω–Ω—è –∫–µ—à–±–µ–∫—É 562.60‚Ç¥,4829,4829,45289,45289,980,0,0,766522,True
iIGMbpDPvLQMgQ,1526227876,SELECTA AIRPORTC,5499,5499,-6621,-210,978,0,0,721233,False,P1H8-55AC-A898-7APT
SQBcoOMmdIWUSQ,1526227795,SELECTA AIRPORTC,5499,5499,-8513,-270,978,0,0,727854,False,B717-T7MB-97A9-3828
vrDUJyZgwnvmVQ,1526218741,SHOP 4723/ CONFECT. L,5499,5499,-48557,-1540,978,0,708,736367,False,81KA-89KM-3MAK-P649
RqKll_7woyfyjQ,1526218505,WORLD OF DELIGHTS,5499,5499,-144916,-4596,978,0,4347,784924,False,BA5T-BC0E-139M-7X0H
m4VrkQervB7V-A,1526213620,EYE BAR RESTAURANT,5812,5812,-33265,-1055,978,0,665,929840,False,9732-3035-2A9T-PK86
_1O0esZ4Y488jw,1526137145,Albert Heijn 1407,5411,5411,-36513,-1158,978,0,1095,963105,False,4626-P5H5-0PE7-K292
njyuARM8PRid5Q,1526131827,–ü—Ä–∏–≤–∞—Ç24,6536,6536,590000,590000,980,0,0,999618,False
FuQNy7A4AmjwtA,1526128350,BROUWERIJ T IJ B V,5921,5921,-37837,-1200,978,0,1135,409618,False,K2B8-P17P-MT74-7KAP
1glKbhSqKdbqsg,1526121099,VOF BAKERS EN ROASTERS,5812,5812,-204950,-6500,978,0,4099,447455,False,HXX1-48CP-3MX9-9A93
Aolkuva3ZGDvMQ,1526116305,JACKS,5812,5812,-23648,-750,978,0,472,652405,False,TTT1-X33A-82M1-9KAX
HnUmF_GgD2dBLw,1526059010,MANNEKEN PIS BV,5812,5812,-15608,-495,978,0,312,676053,False,4MX5-34HC-P3C1-0CAC
TwDVzmghpugtSg,1526058224,WORLD WIDE SUPERMARKT,5411,5411,-36891,-1170,978,0,1106,691661,False,87HX-451T-656C-5X60
rLNgjIxGoGdaiQ,1526050812,PEEJAYS DOUGHNUTS,5462,5462,-23963,-760,978,0,718,728552,False,HKA5-233C-94BA-B914
8f09LJHP9W-A5w,1526048897,DIM SUM NOW,5812,5812,-59909,-1900,978,0,1198,752515,False,KTT7-P76T-T87C-ATEC
ug-lgwxnRmPw8A,1526034558,AH TO GO 5870,5977,5977,-18745,-600,978,0,0,812424,False,9TH9-3165-9X3B-4THH
71GlfGrBVTXoVA,1525983662,MANNEKEN PIS BV,5812,5812,-22560,-720,978,0,451,831169,False,XX1E-9297-B964-E70P
wv6LS7lNX7NzHQ,1525948191,AMSTERDAM CHEESE MUSEU,5499,5499,-23625,-754,978,0,708,853729,False,59P5-XBB8-H1KH-P2E0
nFp-27Nn3AjwTQ,1525942002,PANCAKES,5812,5812,-84192,-2687,978,0,1683,877354,False,AE34-6ME4-T7M2-TTA2
5H22AM6yo5wThA,1525936831,–ü—Ä–∏–≤–∞—Ç24,6536,6536,720000,720000,980,0,0,961546,False
3YLWzJ_mPzNzwA,1525896893,AH TO GO 5870,5977,5977,-10655,-339,978,0,0,241546,False,KTA6-0C10-B6HK-851X
yHAsCY1AYQmCjQ,1525888928,CHEESE AND MORE 1STE V,5499,5499,-9272,-295,978,0,278,252201,False,M0E0-M2AC-M1PK-B79C
0JYnuS74cLoBmg,1525885622,April Feesten,7929,7929,-34574,-1100,978,0,0,261473,False,6A3C-18HX-HX5E-2AXP
WKyRK6c7Yuo1oQ,1525884815,MOSSEL EN GIN BV,5812,5812,-227873,-7250,978,0,4557,296047,False,13T5-22M8-3BP1-K47C
ZK7UV091WEyXYg,1525864362,VINCENT VAN GOGH MUSEU,5811,5811,-10215,-325,978,0,204,523920,False,681P-ACTT-K9AX-77H6
2S73pU-9A0TKQA,1525807295,JAMIN,5441,5441,-77634,-2470,978,0,2329,534135,False,BB6X-9H9A-2X3A-EH8A
hbUYReEVwb4OkA,1525806079,SANIFAIR CENTRAAL IJHA,5499,5499,-2200,-70,978,0,66,611769,False,AK6H-C03M-4B3K-03B8
rDt-GMYxm_G3sQ,1525796093,Albert Heijn 1647,5411,5411,-19613,-624,978,0,588,613969,False,5XT8-XH69-1BX9-PX97
dvqAkDJPwCsD6g,1525785114,STICHTING NEMO HORECA,7991,7991,-13358,-425,978,0,0,633582,False,TX58-E552-PCH4-MBPP
BD1qQ9jv20mRSQ,1525780525,Albert Heijn 5617,5411,5411,-40074,-1275,978,0,1202,646940,False,TKHP-9TM5-B7MA-M24X
bKNL5hBjarMqEg,1525741251,ChauffeurPrive,4121,4121,-126123,-4000,978,0,0,687014,False,A9A3-K697-KHMC-66CT
TpLwmrq2Esg0EQ,1525727531,BROUWERIJ DE BEKEERDE,5812,5812,-46350,-1470,978,0,927,813137,False,457P-PAM5-6EKT-41T5
7-thF166z6mpAQ,1525724243,Little Saigon ZDIJK,5812,5812,-107205,-3400,978,0,2144,859487,False,K415-0B6H-1BCA-7EM3
ZNGXMmtIBNfuIw,1525711640,–ü—Ä–∏–≤–∞—Ç24,6536,6536,300000,300000,980,0,0,966692,False
N_afhfGL4mDegA,1525708163,LIDL 135 AMSTERDAM,5411,5411,-12581,-399,978,0,377,666692,False,54K8-482P-H5TK-T112
beERJf_yPLVpzA,1525688650,Starbucks,5812,5812,-24988,-790,978,0,499,679273,False,95PC-1734-7B8A-H9MK
qZN-cefQnQLb-Q,1525681179,The Breakfast Club Wib,5814,5814,-72750,-2300,978,0,1455,704261,False,K0HH-P85P-5XC8-7BMA
-PRHfrHataGxIg,1525641126,H.Murray's Amsterdam B,5813,5813,-18918,-600,978,0,378,777011,False,M7K9-9C2K-1818-0HKX
5zHvAR0N9B10HQ,1525636584,ICE BAKERY 6,5812,5812,-28378,-900,978,0,567,795929,False,HPHB-7CEH-EM64-95PK
N1Ps2OHCeTzbHQ,1525608208,CAF DE PIJP,5812,5812,-145042,-4600,978,0,2900,824307,False,8KBM-6T38-P442-PK9P
f7rXz13yAHqwcA,1525602956,–ü—Ä–∏–≤–∞—Ç24,6536,6536,500000,500000,980,0,0,969349,False
y5jWN5yTWAhxZw,1525584047,PAUL 2F1 025526,5812,5812,-22702,-720,978,0,454,469349,False,TE00-XKT4-X82M-CAHC
Z1pXzdZqQrTEFA,1525582610,LADUREE D92      77 LE,5462,5462,-26486,-840,978,0,794,492051,False,E8MB-449T-M278-19PB
w_K7C6jWi94imQ,1525555086,ChauffeurPrive,4121,4121,-156078,-4950,978,0,0,518537,False
QvT1duIok3qzkA,1525531678,LE PRINCE RACINE,5812,5812,-126123,-4000,978,0,2522,674615,False,KC38-63E2-P9A7-002H
WoWnfLw0VNTM0w,1525447073,FOP BABIN AP,5812,5812,-9600,-9600,980,0,192,800738,False,1T71-A28B-A3C0-2XBM
K1AoCTNvXSul6w,1525445826,–ö–∏—ó–≤—Å—å–∫–∏–π –º–µ—Ç—Ä–æ–ø–æ–ªi—Ç–µ–Ω,4111,4111,-500,-500,980,0,0,810338,False,8KB4-P4K8-PCX8-H5PM
86NTf_eBnosefQ,1525424088,"Lifecell
+380631692598",4812,4812,-8000,-8000,980,0,0,810838,True,9550-X3BA-PX43-XXK0
7ul9fPNWUdmZPw,1525419884,"Vodafone
+380503818655",4812,4812,-8000,-8000,980,0,0,818838,True,2433-HEM5-EKX8-52K4
8xGy5g4fI2NCDw,1525417309,MAGAZYN PRODUKTY 3,5411,5411,-7000,-7000,980,0,210,826838,False,AE53-3XKB-MKK2-59KM
V-bEt6IhGaDNZg,1525417034,THE BLUE CUP,5812,5812,-7800,-7800,980,0,156,833838,False,80X2-2BTX-H6X5-37TT
t5NlqQlErKfazA,1525415160,–ö–∏—ó–≤—Å—å–∫–∏–π –º–µ—Ç—Ä–æ–ø–æ–ªi—Ç–µ–Ω,4111,4111,-500,-500,980,0,0,841638,False,BE1K-CKB4-EHAE-4TH9
gaEdf4oGB2FttA,1525415143,–ö–∏—ó–≤—Å—å–∫–∏–π –º–µ—Ç—Ä–æ–ø–æ–ªi—Ç–µ–Ω,4111,4111,-500,-500,980,0,0,842138,False,AME1-0B38-KEHX-A973
T0Q1iKEq2kiFDQ,1525377713,BOTTEGA,5813,5813,-129700,-129700,980,0,2594,842638,False,P7H3-1E7M-MK1C-CHPB
cm_Ci-EnSW3Cfg,1525370623,PRAVDA REST-1 KYIV,5812,5812,-28000,-28000,980,0,556,972338,False,16B8-9X35-T883-E74X
ROoEUdrljzbQ1Q,1525343433,Lesya,ü§ë,4829,4829,-450000,-450000,980,0,0,1000338,True,740M-TK4B-PH69-66E6
TbduG_xjSJCVIw,1525343309,–í—ñ–¥: 51****8598,4829,4829,1178000,1178000,980,0,0,1450338,True
VzSXaAl3RSBlXA,1525330994,–ö–∏—ó–≤—Å—å–∫–∏–π –º–µ—Ç—Ä–æ–ø–æ–ªi—Ç–µ–Ω,4111,4111,-500,-500,980,0,0,272338,False,988K-HT5B-0PX0-5XHH
Q_e4PspQUhxMIw,1525293568,Uber,4121,4121,-17080,-17080,980,0,0,272838,False,987B-EEB4-46M0-4A62
uuEWTS_XbmjV8Q,1525291315,RESTAURANT KHMILNYY KN,5812,5812,-42000,-42000,980,0,840,289918,False,323H-PEMA-BX0P-B98H
ihM1Rd7jttx5QA,1525291286,RESTORAN KHMILNYY KNYA,5812,5812,-53500,-53500,980,0,1070,331918,False,CE4C-C030-P7KT-89T9
9DGosNtz61sD7w,1525279768,Uber,4121,4121,-12757,-12757,980,0,0,385418,False,13PX-6TCC-082A-XAA1
fdxDrwwlTxNiag,1525264665,Sanatrelo75N4F3Y8N4SHC,5812,5812,-80700,-80700,980,0,1614,398175,False,BX7B-4PE2-C984-7K8H
jOiceB3feI6_6g,1525252524,TRUMAN25C7NALNWRWG00,5399,5399,-61000,-61000,980,0,1830,478875,False,8KC3-BX0K-A4M3-3C0H
o5EL5N85mNAYSA,1525251951,FOTOVRAMKE,5999,5999,-61000,-61000,980,0,0,539875,False,3AE3-4763-909E-6K8T
ycEh7lcpxCUcSA,1525250725,–ö–∏—ó–≤—Å—å–∫–∏–π –º–µ—Ç—Ä–æ–ø–æ–ªi—Ç–µ–Ω,4111,4111,-500,-500,980,0,0,600875,False,4E2K-H042-T4X0-H2M3
wePJFpp8SAvqxg,1525242558,–ö–∏—ó–≤—Å—å–∫–∏–π –º–µ—Ç—Ä–æ–ø–æ–ªi—Ç–µ–Ω,4111,4111,-500,-500,980,0,0,601375,False,3XK0-1X4H-PAHX-A38P
XX0QM8RFYiXA1A,1525184581,–í—ñ–¥—Å–æ—Ç–∫–∏ –∑–∞ –∫–≤—ñ—Ç–µ–Ω—å,4829,4829,60,60,980,0,0,601875,True
tQKG3IDcSm6f7g,1530285450,Uber,4121,4121,-4979,-4979,980,0,0,438036,False,90MA-7074-C71X-PCMP
u3zIbAb5Ne1T4w,1530282935,–í–∏–≤–µ–¥–µ–Ω–Ω—è –∫–µ—à–±–µ–∫—É 523.88‚Ç¥,4829,4829,42172,42172,980,0,0,443015,True
6V-ahWxGauZO3Q,1530282905,–°–∫–∞—Å—É–≤–∞–Ω–Ω—è. Uber,4121,4121,14074,14074,980,0,0,400843,True
UmIwV4ReORTZ1Q,1530282851,Uber,4121,4121,-14189,-14189,980,0,0,386769,False,KBXX-4EH9-89H3-PT5T
qbPLK4F7Efu-mw,1530281382,Uber,4121,4121,-14074,-14074,980,0,0,400958,True
jOpTveLwR1NNSA,1530278616,Uber,4121,4121,-12261,-12261,980,0,0,415032,False,653B-CX7M-7ACA-9PPE
C1BMrEOPqMEy4g,1530276141,MAGAZYN PRODUKTY 4,5411,5411,-2100,-2100,980,0,0,427293,False,E70A-24PM-HC11-CHH2
TMMGBio2kfXwqQ,1530275964,Mirra Cafe,5812,5812,-7900,-7900,980,0,0,429393,False,E4B5-K67A-BT79-12KC
UB1-adydrlYZ1w,1530255958,–í–∏–ø–ª–∞—Ç–∞ –ø—Ä–æ—Ü–µ–Ω—Ç—ñ–≤,4829,4829,4356,4356,980,0,0,437293,True
YVzzlqAHc4-4jA,1530254955,APTEKA 9,5912,5912,-8180,-8180,980,0,0,432937,False,3977-KT04-8TT3-9A4E
PQ4NDQi7wSqWAg,1530254192,LyaFabrik57S3PAY36CBX2,5812,5812,-24000,-24000,980,0,0,441117,False,KA38-79PM-AA84-BX56
QWvqF-UBgT8Mcw,1530176071,"Lifecell
+380631692598",4812,4812,-1000,-1000,980,0,0,465117,True,TE06-KPXK-E0H0-E08T
eGmYtxwQRzk95g,1530128358,Billa,5411,5411,-2999,-2999,980,0,0,466117,False,1A16-HH11-C999-85B4
1UsOA32Pk1PYEA,1530128105,Billa,5411,5411,-65438,-65438,980,0,0,469116,False,0PM2-P4BH-95XK-MTT7
OCTKAa2obESJYw,1530103289,ProduktovaLavka13224L1,5499,5499,-4400,-4400,980,0,0,534554,False,561K-7739-XEAM-A45C
jBSpCjVFoI7F_A,1530103040,Sanatrelo75N4F3Y8N4SHC,5812,5812,-104500,-104500,980,0,3082,538954,False,1B5C-P5BA-880E-E0PK
M9f6qVDMD52MFw,1530084438,–ö–∏—ó–≤—Å—å–∫–∏–π –º–µ—Ç—Ä–æ–ø–æ–ªi—Ç–µ–Ω,4111,4111,-500,-500,980,0,0,643454,False,07K8-BHCT-0MPA-C967
eJr7x0v_96yrtw,1530040658,Kiwi.com s.r.o.,4722,4722,-30670,-882,826,0,0,643954,False,0XP8-KMME-27BA-P0M4
u9xn_oI4k0zLog,1530038647,Uber,4121,4121,-14083,-14083,980,0,1689,674624,False,5PT3-9K92-3KPP-54K8
bPp2ECoj0sQfWQ,1530035081,Diskultura67,5331,5331,-217000,-217000,980,0,0,688707,False,4MA0-12T9-3PHT-PEC1
qJw8KHSLPK5fVg,1530030245,Steam,5816,5816,-4200,-4200,980,0,0,905707,False,PT7H-7H0C-821C-5225
KJPqinTpHEWmEA,1530009501,Steam,5816,5816,-9100,-9100,980,0,0,909907,False,K7KA-05TP-HK0E-E2P3
mEzpWeUG219sYg,1529996194,Produkti13OULVKB2MUV00,5499,5499,-6900,-6900,980,0,0,919007,False,33X7-K6MC-6K7K-M5M0
qZrG3FcncBLuQw,1529948581,Epicenter,5211,5211,-6270,-6270,980,0,0,925907,False,06P7-TH0K-7BAP-A126
8moQOZHlnkEBZg,1529944378,Uber,4121,4121,-1000,-1000,980,0,120,932177,False,X8XC-C6TP-T8MC-4E76
Z6hAKQdmB-jL6A,1529943915,Uber,4121,4121,-24350,-24350,980,0,2922,933177,False,86H6-X9X7-TE47-C270
i6O4CCMiT4iNXA,1529924173,MIRA KAFE,5814,5814,-17300,-17300,980,0,692,957527,False,6PP5-KAXA-14K8-EX3T
Pf4oGnbf-_rI1w,1529912686,–ö–∏—ó–≤—Å—å–∫–∏–π –º–µ—Ç—Ä–æ–ø–æ–ªi—Ç–µ–Ω,4111,4111,-500,-500,980,0,0,974827,False,H57T-M4A4-5979-3E85
pCMBmX4wVgHfKA,1529909611,–õ—å–≤—ñ–≤—Å—å–∫—ñ –ü–ª—è—Ü–∫–∏,5812,5812,-35685,-35685,980,0,1207,975327,False,CHCH-176B-A2BB-CHA6
TAnKzur9xqNACQ,1529867097,PHOPKikotOL13WCNFOB4Q8,4215,4215,-17910,-17910,980,0,0,1011012,False,044K-7T13-H27M-1C4H
npl_zdFTsI_7Dg,1529834412,–ê–¢–ë,5499,5499,-19150,-19150,980,0,0,1028922,False,MC5P-5425-25CX-50KM
rNrEnNROO4ZAuA,1529830109,Steam,5816,5816,-7200,-7200,980,0,0,1048072,False,KETK-H843-B47B-P6E4
PEeomRIDNqGeHw,1529785588,–ê–¢–ë,5411,5411,-6910,-6910,980,0,0,1055272,False,E8HK-HHX2-70A8-TBM2
TwUxNATmeQM28w,1529744225,Lesya,–±–∏–ª–µ—Ç—ã,4829,4829,-155000,-155000,980,0,0,1062182,True,0BKE-PTBH-55H9-798T
lEUTxCFUKvF51A,1529690806,MASHA CAKE KOCHETKOVA,5814,5814,-24600,-24600,980,0,492,1217182,False,A848-T048-8TP1-T60A
A86dQmLRwy-mvg,1529678268,–íi–¥: –ü–†–ò–•–û–î–¨–ö–û –ï.–í. –§–û–ü,4829,4829,300000,300000,980,0,0,1241782,True
wK5rOc9SLWP3dA,1529665084,–û–ª–µ–∫—Å—ñ–π –í–∏–∫–∞–ª—é–∫,–ª–æ—Å–æ—Å—å,4829,4829,-9776,-9776,980,376,0,941782,True,2TBP-X069-PK0E-0B5P
8jfhWZVKQnUufg,1529661445,–°–∫–∞—Å—É–≤–∞–Ω–Ω—è. Uber,4121,4121,5860,5860,980,0,-703,951558,True
_ZBLmEbjy2SxaA,1529661396,Uber,4121,4121,-5986,-5986,980,0,718,945698,False,4HCT-MKBA-61C0-H89T
DZmKlwjmZ_p-_A,1529660511,Uber,4121,4121,-5860,-5860,980,0,703,951684,True
T5OYHvQyqFvFHg,1529653473,ProduktovaLavka13224L1,5499,5499,-2300,-2300,980,0,0,957544,False,PP44-TX90-0253-49MH
7Gl2ovPhiF4XPw,1529651648,–ö–∏—ó–≤—Å—å–∫–∏–π –º–µ—Ç—Ä–æ–ø–æ–ªi—Ç–µ–Ω,4111,4111,-500,-500,980,0,0,959844,False,PX3B-9ECK-3EM1-3573
cMQ5lSTzV7l4bw,1529605806,Apteka51314CFJMG3UFQ0,5912,5912,-15150,-15150,980,0,0,960344,False,C9M9-M210-6P1B-KX1T
TCyF3DrZ2TEW4w,1529603615,Taxi Bond,4121,4121,-11200,-11200,980,0,1344,975494,False,KTKE-9XTT-E8T5-H0M5
WaHhvbKXGhFMeA,1529564184,Produkti13OULVKB2MUV00,5499,5499,-2400,-2400,980,0,0,986694,False,88M1-63C5-TAH2-9AT5
1JJuPUDdK7qm7Q,1529563902,KAFE BLUE CUP,5812,5812,-10200,-10200,980,0,408,989094,False,79C1-83PE-804A-48B8
cKbPyuv0Jgy3IQ,1529561926,–ö–∏—ó–≤—Å—å–∫–∏–π –º–µ—Ç—Ä–æ–ø–æ–ªi—Ç–µ–Ω,4111,4111,-500,-500,980,0,0,999294,False,B6EP-5AKT-K7P5-T816
oQJNHPD8O7gVRg,1529511414,–ö–∏—ó–≤—Å—å–∫–∏–π –º–µ—Ç—Ä–æ–ø–æ–ªi—Ç–µ–Ω,4111,4111,-500,-500,980,0,0,999794,False,H12P-P330-5T82-H8P9
pxi5xbjYLuVDqA,1529486886,–ü—Ä–∏–≤–∞—Ç24,6536,6536,795500,795500,980,0,0,1000294,False
hSkQXRpfwDT2eQ,1529478113,–ö–∏—ó–≤—Å—å–∫–∏–π –º–µ—Ç—Ä–æ–ø–æ–ªi—Ç–µ–Ω,4111,4111,-500,-500,980,0,0,204794,False,6T4E-9ATC-4KX1-78X1
wdlNqrKPidLmcA,1529477996,91TAS,5912,5912,-1618,-1618,980,0,0,205294,False,M6MB-H251-X1X4-31BX
XiZxn8fRrsmMYg,1529391947,–í–∏–ø–ª–∞—Ç–∞ –ø—Ä–æ—Ü–µ–Ω—Ç—ñ–≤,4829,4829,1026,1026,980,0,0,206912,True
Rtep6SMuSptxKg,1529391532,THE BLUE CAP,5812,5812,-15600,-15600,980,0,624,205886,False,KTH1-588P-HEX0-EB4A
6jsfmhOyvii4NQ,1529349039,–í—ñ–¥: –û–ª–µ–∫—Å—ñ–π –í–∏–∫–∞–ª—é–∫,–∑–¥–∞—á–∞ –∑ –∫–Ω—è–∑—è,4829,4829,3000,3000,980,0,0,221486,True
hC4AAOlm4HzUvQ,1529347568,FONDYUA*TAXI_M_PAYMENT,4121,4121,-12100,-12100,980,0,1452,218486,False,B3M7-114C-589M-C27M
AEYQIRq-CI2rRQ,1529303074,–ö–∏—ó–≤—Å—å–∫–∏–π –º–µ—Ç—Ä–æ–ø–æ–ªi—Ç–µ–Ω,4111,4111,-500,-500,980,0,0,230586,False,T40T-K4ET-K4KT-83HA
mWA6qibknxfkHw,1529234055,–°–∫–∞—Å—É–≤–∞–Ω–Ω—è. Uber,4121,4121,15341,15341,980,0,-1840,231086,True
TcQmDNMd_F1akw,1529233995,Uber,4121,4121,-15454,-15454,980,0,1854,215745,False,6MBT-1938-B4PE-K0M4
6G33BMI_bI3-oQ,1529231711,Uber,4121,4121,-15341,-15341,980,0,1840,231199,True
KKwteo5X52bmUw,1529231711,–°–∫–∞—Å—É–≤–∞–Ω–Ω—è. FONDYUA*TAXI_M_PAYMENT,4121,4121,100,100,980,0,-12,246540,True
Prn50LzqjqXLcw,1529231552,FONDYUA*TAXI_M_PAYMENT,4121,4121,-100,-100,980,0,12,246440,True
IisQkI3xxnJd-Q,1529174210,Lesya,–Ω–∞ –Ω–µ—Ç—Ñ–ª–∏–∫—Å,4829,4829,-8840,-8840,980,340,0,246540,True,4K67-88MK-49H6-2116
6wP5Q_M7dCUwgA,1529170506,–ê–¢–ë,5411,5411,-15690,-15690,980,0,0,255380,False,0X9E-285A-M5AP-7064
y6rkPPJUGvx5ww,1529167679,–ö–∏—ó–≤—Å—å–∫–∏–π –º–µ—Ç—Ä–æ–ø–æ–ªi—Ç–µ–Ω,4111,4111,-500,-500,980,0,0,271070,False,EM6X-5TBH-C4E6-3KPT
P9m3Jv50oFJRug,1529167673,–ö–∏—ó–≤—Å—å–∫–∏–π –º–µ—Ç—Ä–æ–ø–æ–ªi—Ç–µ–Ω,4111,4111,-500,-500,980,0,0,271570,False,T85C-CM2M-1C7K-TMA7
7pzlXBpXieV-TA,1529166122,–°—ñ–ª—å–ø–æ,5411,5411,-41298,-41298,980,0,0,272070,False,A48C-CHMP-6P46-P6E8
9gFDIV_x5w86sg,1529154215,FOPRudenkoG,4215,4215,-5000,-5000,980,0,0,313368,False,60P4-20H7-5CHA-XEAB
K3hlSCiObvaWvQ,1529097599,Uber,4121,4121,-28720,-28720,980,0,3446,318368,False,348A-XB1T-5PE0-976E
GJ16sv78vmKOzw,1529093818,Varvarbar64M2V1DPEUKM0,5812,5812,-11000,-11000,980,0,440,347088,False,TC8A-0A10-B67P-EE6E
MrFZ5e8wLlesNw,1529091137,Varvarbar64M2V1DPEUKM0,5812,5812,-219500,-219500,980,0,8780,358088,False,C07H-HTBE-2X81-57MH
Z2evAW63Jm4Cww,1529062615,Borshchkafe74,5814,5814,-77580,-77580,980,0,3103,577588,False,409M-6054-PA88-T7X7
XTLd8kHcBAlDnQ,1529043268,–§–∞–∫—É–ª—å—Ç–µ—Ç-–§–∞—Ä–º,5912,5912,-15250,-15250,980,0,0,655168,False,8XMK-410C-PME2-TC42
pWu861J12fMTDw,1529006515,magazinPRODUKTI,5499,5499,-2000,-2000,980,0,0,670418,False,B86E-5X56-518E-XPA5
yzBGBDFmTp0kgQ,1528996880,–ö–∏—ó–≤—Å—å–∫–∏–π –º–µ—Ç—Ä–æ–ø–æ–ªi—Ç–µ–Ω,4111,4111,-500,-500,980,0,0,672418,False,HC68-BCEB-9B7P-T1EE
5xLtIiqGxfEl8g,1528978760,Sanatrelo75N4F3Y8N4SHC,5812,5812,-66300,-66300,980,0,2652,672918,False,MK4A-7200-T9PM-2AX0
5sKvfdm8ViZTEQ,1528978745,Sanatrelo75N4F3Y8N4SHC,5812,5812,-15000,-15000,980,0,600,739218,False,9E08-CKMB-PX18-1M2X
bWyZdiYmt4TInA,1528958961,THE BLUE CAP,5812,5812,-11700,-11700,980,0,468,754218,False,73C4-B3M2-90HB-0EMP
byAS4K_0v2RtOA,1528956977,–ö–∏—ó–≤—Å—å–∫–∏–π –º–µ—Ç—Ä–æ–ø–æ–ªi—Ç–µ–Ω,4111,4111,-500,-500,980,0,0,765918,False,XAT5-3EX3-10X1-T043
nCOfUwaSM-E-pA,1528956964,–ö–∏—ó–≤—Å—å–∫–∏–π –º–µ—Ç—Ä–æ–ø–æ–ªi—Ç–µ–Ω,4111,4111,-500,-500,980,0,0,766418,False,H6P1-6161-PT94-32AE
5Cw1_rjoy-rySQ,1528871967,–ö–∏—ó–≤—Å—å–∫–∏–π –º–µ—Ç—Ä–æ–ø–æ–ªi—Ç–µ–Ω,4111,4111,-500,-500,980,0,0,766918,False,7032-2A6H-7P2K-K6AP
5de-I4U8Xlh3gQ,1528804256,Sanatrelo75N4F3Y8N4SHC,5812,5812,-94100,-94100,980,0,3764,767418,False,K3KH-M920-9PX1-A368
VJDsz-y3kOUqIg,1528787401,–ö–∏—ó–≤—Å—å–∫–∏–π –º–µ—Ç—Ä–æ–ø–æ–ªi—Ç–µ–Ω,4111,4111,-500,-500,980,0,0,861518,False,TA86-MMPC-5748-4CAP
Oz0nQtEFtZUJtA,1528742749,–ê–¢–ë,5499,5499,-6420,-6420,980,0,0,862018,False,AC81-4B96-8HKH-4K0B
a-Y5L7cax2HNsw,1528740010,McDonald's,5814,5814,-15200,-15200,980,0,608,868438,False,C1PE-B936-C44P-KP86
6lJsgNvhqkSzXw,1528701811,"Lifecell
+380631692598",4812,4812,-6500,-6500,980,0,0,883638,True,00H7-7166-9P52-M366
Qdx5YaHlvq40NA,1528550340,–ö–∏—ó–≤—Å—å–∫–∏–π –º–µ—Ç—Ä–æ–ø–æ–ªi—Ç–µ–Ω,4111,4111,-500,-500,980,0,0,890138,False,BCX5-C311-57HP-97EC
v16IPOGbQO0byw,1528544967,–§–æ—Ä–∞,5499,5499,-12053,-12053,980,0,0,890638,False,148H-K71M-KM84-P3A9
A4V9zdPQXr6ltg,1528531475,Uber,4121,4121,-13239,-13239,980,0,1588,902691,False,X4X8-6EA1-K30M-P7M5
58F2q5_Pyw0q012xKjBjJ1E,1528500362,–°–∫–∞—Å—É–≤–∞–Ω–Ω—è. Uber,4121,4121,6809,6809,980,0,0,915930,True
3yEgw7MIqmcWaA,1528396445,–ê–¢–ë,5411,5411,-8830,-8830,980,0,0,909121,False,3164-B246-PA4H-BBA1
EV4p48-TKY___A,1528393979,–ö–∏—ó–≤—Å—å–∫–∏–π –º–µ—Ç—Ä–æ–ø–æ–ªi—Ç–µ–Ω,4111,4111,-500,-500,980,0,0,917951,False,621H-A1X0-514M-641H
Yvix6Z9Is2IG1w,1528353513,–ö–∏—ó–≤—Å—å–∫–∏–π –º–µ—Ç—Ä–æ–ø–æ–ªi—Ç–µ–Ω,4111,4111,-500,-500,980,0,0,918451,False,ACTX-XACX-H5KH-8E0B
NrtR38jon2TNxA,1528353502,–ö–∏—ó–≤—Å—å–∫–∏–π –º–µ—Ç—Ä–æ–ø–æ–ªi—Ç–µ–Ω,4111,4111,-500,-500,980,0,0,918951,False,E15T-8643-0EM4-K6B6
MvuHS2kylClQew,1528352838,Apteka51314CFJMG3UFQ0,5912,5912,-7400,-7400,980,0,0,919451,False,K5MH-8M70-K6E7-500C
9FoxoR78Nt3oJg,1528305551,–ö–∏—ó–≤—Å—å–∫–∏–π –º–µ—Ç—Ä–æ–ø–æ–ªi—Ç–µ–Ω,4111,4111,-500,-500,980,0,0,926851,False,KT1A-1AB3-BAHB-K047
kwkP0EWX8W7-cg,1528285337,Sanatrelo75N4F3Y8N4SHC,5812,5812,-7000,-7000,980,0,280,927351,False,9A90-C77P-PT95-P31A
Ub7YwawuhJHx5Q,1528285306,Sanatrelo75N4F3Y8N4SHC,5812,5812,-65700,-65700,980,0,2626,934351,False,1CBA-P37A-M5K5-H651
uHe6h72YAryHrQ,1528283189,–ü—Ä–∏–≤–∞—Ç24,6536,6536,641100,641100,980,0,0,1000051,False
u2w4S1A5OXYpHw,1528269293,–ö–∏—ó–≤—Å—å–∫–∏–π –º–µ—Ç—Ä–æ–ø–æ–ªi—Ç–µ–Ω,4111,4111,-500,-500,980,0,0,358951,False,XTHM-A609-9X5B-B240
NaGh_uIu6elHRQ,1528230248,Uber,4121,4121,-20571,-20571,980,0,2468,359451,False,27TM-E86C-ACTX-14C3
Ns4gjhZ3WFPqlA,1528228433,RESTAURANT KHMILNYY KN,5812,5812,-11000,-11000,980,0,440,380022,False,1A6H-AK71-4205-6CKX
ZV5jMpEWoKLncQ,1528228396,RESTORAN KHMILNYY KNYA,5812,5812,-39000,-39000,980,0,1560,391022,False,8HB1-1P8C-7C32-T5EP
EESNgJeLjYgVbQ,1528181719,MAGAZYN PRODUKTY 3,5411,5411,-3000,-3000,980,0,0,430022,False,P289-PK2H-613B-9990
WufITEIY3uoZng,1528095931,–í–∏–ø–ª–∞—Ç–∞ –ø—Ä–æ—Ü–µ–Ω—Ç—ñ–≤,4829,4829,2297,2297,980,0,0,433022,True
VZLy_eEtRsNjpA,1528037236,Cosmo,5977,5977,-3160,-3160,980,0,0,430725,False,4461-H9T0-0C34-4K6H
hgGmAWKcP9SG-g,1528026143,–ö–∏—ó–≤—Å—å–∫–∏–π –º–µ—Ç—Ä–æ–ø–æ–ªi—Ç–µ–Ω,4111,4111,-500,-500,980,0,0,433885,False,7442-M719-XMTE-3K49
hsJ1w0Dzs97t5w,1528026138,–ö–∏—ó–≤—Å—å–∫–∏–π –º–µ—Ç—Ä–æ–ø–æ–ªi—Ç–µ–Ω,4111,4111,-500,-500,980,0,0,434385,False,1X3M-PP8H-3E74-AX49
SXprq2KhLg3lFQ,1527924530,"Lifecell
+380631692598",4812,4812,-6500,-6500,980,0,0,434885,True,3K9A-3958-EK91-741H
SHR3hiMdQcm3IQ,1527880298,Uber,4121,4121,-4779,-4779,980,0,573,441385,False,KM22-KKC5-PX5P-EP1K
lLNddAUD0sAbWg,1527876235,–ö–∏—ó–≤—Å—å–∫–∏–π –º–µ—Ç—Ä–æ–ø–æ–ªi—Ç–µ–Ω,4111,4111,-500,-500,980,0,0,446164,False,B1EP-XB31-H546-762P
EWQp5auAl5d6Yw,1527875826,McDonald's,5814,5814,-4200,-4200,980,0,0,446664,False,6PXE-41KC-B3B6-B4BK
ZS02EirAwoTnbg,1527834373,–ö–∏—ó–≤—Å—å–∫–∏–π –º–µ—Ç—Ä–æ–ø–æ–ªi—Ç–µ–Ω,4111,4111,-500,-500,980,0,0,450864,False,C55K-0T2K-33KC-017A
VQ7a0tQ1gg8lTQ,1532976065,Billa,5411,5411,-16867,-16867,980,0,168,29967,False,BBP2-B2P9-6M69-H69B
Qshz29K2Y8k3rw,1532971520,–ö–∏—ó–≤—Å—å–∫–∏–π –º–µ—Ç—Ä–æ–ø–æ–ªi—Ç–µ–Ω,4111,4111,-800,-800,980,0,0,46834,False,0M3H-4EXC-M879-4KBM
LpMnXMKE8Ta-mg,1532965679,–°–∫–∞—Å—É–≤–∞–Ω–Ω—è. Uber,4121,4121,11316,11316,980,0,0,47634,True
apyjEv0OF8xEew,1532955429,–§–æ—Ä–∞,5499,5499,-20015,-20015,980,0,200,36318,False,8X84-6HME-3H29-C598
eFybxEQSs8LS_A,1532952794,–ö–∏—ó–≤—Å—å–∫–∏–π –º–µ—Ç—Ä–æ–ø–æ–ªi—Ç–µ–Ω,4111,4111,-800,-800,980,0,0,56333,False,HX8X-ATH6-K9M0-E339
G7l20okujlel3g,1532951504,Uber,4121,4121,-12631,-12631,980,0,0,57133,False,XH2B-A2P3-MMAB-T2XM
JLmorjsw6vEKvQ,1532951375,McDonald's,5814,5814,-21300,-21300,980,0,426,69764,False,35AH-99EA-X3CA-97P6
sQK8v_HpbvobRA,1532929751,portmone.com.ua,4814,4814,-11000,-11000,980,0,0,91064,False,78M6-KETB-8KH9-B1ET
EvI_2Q3zQA3q7w,1532928699,Uber,4121,4121,-8004,-8004,980,0,0,102064,False,B2H3-5X7E-MCEP-P51X
JFadlrGxLgul_w,1532927334,"–ö–∏—ó–≤—Å—Ç–∞—Ä
+380978495150",4812,4812,-5500,-5500,980,0,0,110068,True,2A2M-6KA5-KM9P-BMTC
AR2XrPVDEcsWWw,1532925991,Uber,4121,4121,-11316,-11316,980,0,0,115568,False
rPOsncZjltE2sw,1532890294,ProduktiKabarvskaPHOP5,5499,5499,-950,-950,980,0,9,126884,False,183P-CTPB-4PXT-4XB7
fsGo0NFlUWlaNA,1532889747,restoranCHICHIKO1,5812,5812,-49802,-49802,980,0,996,127834,False,A6HA-1340-K69P-C1BH
fyHfZfI5VM6GGg,1532889718,restoran CHICHIKO,5812,5812,-8500,-8500,980,0,170,177636,False,54AE-8457-19H2-T93H
iaW10NTfgosHwg,1532877132,BigKap,5812,5812,-11400,-11400,980,0,228,186136,False,X68B-5TCE-0977-3EM4
U3kGPSlTzeM7dg,1532858291,Steam,5816,5816,-2500,-2500,980,0,0,197536,False,28XP-BX9K-M308-922T
qp_jNKBRFwCkJA,1532853672,Lvvkruasan2561B3786Y2L,5812,5812,-7200,-7200,980,0,144,200036,False,88A3-AA11-P2XP-C90X
4Uiqbjgyy2oUOA,1532847973,–í–∏–ø–ª–∞—Ç–∞ –ø—Ä–æ—Ü–µ–Ω—Ç—ñ–≤,4829,4829,4215,4215,980,0,0,207236,True
A_waNB7SqADNeA,1532804069,Wayforpay,4121,4121,-7000,-7000,980,0,0,203021,False,0BB2-C36P-6H3A-2PP7
gx0mJKkt7cjLpg,1532756367,WOG,5541,5541,-4900,-4900,980,0,0,210021,False,00X8-X381-PE3E-TK09
Irk-Dv-LHL8WcA,1532753685,–°–∫–∞—Å—É–≤–∞–Ω–Ω—è. Wayforpay,4121,4121,7000,7000,980,0,0,214921,True
TJlI3b8nMcl8bg,1532753072,Uber,4121,4121,-6542,-6542,980,0,0,207921,False,042K-CETT-9T03-KA02
BhgvPSy3JzxVVQ,1532751767,Wayforpay,4121,4121,-7000,-7000,980,0,0,214463,True
5Wi-411IuF8EXw,1532708120,–°—ñ–ª—å–ø–æ,5411,5411,-33016,-33016,980,0,330,221463,False,188B-7B22-96BA-7T1C
ttM23OJuKbuctw,1532706374,–°–∫–∞—Å—É–≤–∞–Ω–Ω—è. Uber,4121,4121,9397,9397,980,0,0,254479,True
hPDGnV8rtxlkwg,1532699435,–°–∫–∞—Å—É–≤–∞–Ω–Ω—è. Uber,4121,4121,13570,13570,980,0,0,245082,True
4a5H-A7ZdZucpg,1532690659,–í—ñ–¥: –ù–∞–¥—ñ—è –©–∏–≥–æ–ª—å,4829,4829,4350,4350,980,0,0,231512,True
js7pHgGmn6u0nQ,1532690568,–°—ñ–ª—å–ø–æ,5411,5411,-8799,-8799,980,0,87,227162,False,X52E-THH2-7831-TCK2
GV4Of8HgXA9QgQ,1532678771,CAFE DINNERS,5812,5812,-2100,-2100,980,0,42,235961,False,M27H-HH6X-AHA1-73P0
tZ-cdcLgIFxahQ,1532678689,COFFEEDOOR,5812,5812,-7400,-7400,980,0,148,238061,False,6392-H9M4-HAM7-BAEE
5ZWRu610FfOvYA,1532673985,Uber,4121,4121,-13570,-13570,980,0,0,245461,True
P3DfVwdlw96BzQ,1532673592,–°–∫–∞—Å—É–≤–∞–Ω–Ω—è. Wayforpay,4121,4121,100,100,980,0,0,259031,True
mDD3Ynxg7gFipQ,1532673590,Wayforpay,4121,4121,-100,-100,980,0,0,258931,True
K4BCy0Bk9U5IJQ,1532673426,HEALTH AND HAPPY,8099,8099,-39600,-39600,980,0,0,259031,False,5HCT-6038-04CP-AA38
uGoGWgVsNVIf3Q,1532670162,"–ö–∏—ó–≤—Å—Ç–∞—Ä
+380978495150",4812,4812,-3000,-3000,980,0,0,298631,True,T1PX-2870-0T2X-3XM0
AFupTU3Cy43x-w,1532669553,Uber,4121,4121,-9397,-9397,980,0,0,301631,False
AI-WDChwNctDAw,1532638451,Aroma Kava,5814,5814,-7800,-7800,980,0,156,311028,False,1103-166M-8554-BB3X
qfZb0Kz4j1l3CA,1532630589,"Vodafone
+380663529587",4812,4812,-2200,-2200,980,0,0,318828,True,5P2A-ECC9-MX62-6P0K
ij4KsdMLPyOXyw,1532602257,STEJKHAUS74M8VK1KG2BKD,5812,5812,-8600,-8600,980,0,172,321028,False,8CT6-ATHE-BATB-1BA0
C1gIcCNBWLm1PA,1532542382,KAFE,5812,5812,-38800,-38800,980,0,776,329628,False,1606-0787-PXM8-8C62
utdLQAZzxuMFrw,1532519494,Produktova Lavka,5499,5499,-6030,-6030,980,0,60,368428,False,026P-E1XX-7ECT-0M1P
XiSFqnEQvji1Uw,1532519036,Sanatrelo75N4F3Y8N4SHC,5812,5812,-100400,-100400,980,0,2008,374458,False,31T5-X14C-EA6E-CCXP
0wmf6Ku0tGvH3Q,1532511693,Lesya,–æ–±–µ–¥ —Ñ–æ—Ä –∑—ç –±—ç–π–±—ç ü•ë,4829,4829,-26000,-26000,980,1000,0,474858,True,54XE-XAK5-7K82-9489
sTsE8p4-QUsjaQ,1532433034,–ö–∏—ó–≤—Å—å–∫–∏–π –º–µ—Ç—Ä–æ–ø–æ–ªi—Ç–µ–Ω,4111,4111,-800,-800,980,0,0,500858,False,PM3H-2C67-4EAH-4P65
n0xtH1OGWZ2iZQ,1532431583,COFFEEDOOR,5812,5812,-12600,-12600,980,0,252,501658,False,3005-BM6A-6XK8-E322
Qmcl_89PzvDoug,1532428778,–ö–∏—ó–≤—Å—å–∫–∏–π –º–µ—Ç—Ä–æ–ø–æ–ªi—Ç–µ–Ω,4111,4111,-800,-800,980,0,0,514258,False,EBB9-XBMX-XB04-6B99
4LPAWLaPmrakEw,1532415313,–°–∫–∞—Å—É–≤–∞–Ω–Ω—è. Uber,4121,4121,6880,6880,980,0,0,515058,True
Nqf4wIEPG-oBsA,1532415260,Uber,4121,4121,-6914,-6914,980,0,0,508178,False,57H6-4ETE-2492-33X9
mpnMn6R4-T1avQ,1532413991,Uber,4121,4121,-6880,-6880,980,0,0,515092,True
oicBOsU0rdmPTg,1532366097,–°–∫–∞—Å—É–≤–∞–Ω–Ω—è. Uber,4121,4121,7069,7069,980,0,0,521972,True
_2zrDIpmwNV4wg,1532366064,Uber,4121,4121,-8064,-8064,980,0,0,514903,False,8TH4-7AE4-AP2E-XPHX
AM0b7bYxnXQiRQ,1532365909,Uber,4121,4121,-7069,-7069,980,0,0,522967,True
CDEkR506sOvzOA,1532363608,Uber,4121,4121,-2000,-2000,980,0,0,530036,False,5M47-MA3K-E44B-HBP0
UNPqtxtfzWMAhA,1532363063,Uber,4121,4121,-13901,-13901,980,0,0,532036,False,K6E4-569K-8701-KX83
TclmjzBYMDzQBw,1532347783,LIQPAY*FOP Hizhnyak N.,4215,4215,-59777,-59777,980,0,0,545937,False,X5HB-59M8-B277-8797
NaSeXV8qxcm2Ng,1532330141,Uber,4121,4121,-5796,-5796,980,0,0,605714,False,BBME-T4H1-PEB5-X3MH
S_hHS7g7UIFscA,1532290361,Zheltok,5812,5812,-2500,-2500,980,0,50,611510,False,K44C-T34M-KAH5-PBHP
e7lr5eEX5HyXEQ,1532271556,Steam,7994,7994,-7900,-7900,980,0,0,614010,False,KA75-53MA-0A1X-E1TK
4ftw-p7GHNco-Q,1532263554,–ö–∏—ó–≤—Å—å–∫–∏–π –º–µ—Ç—Ä–æ–ø–æ–ªi—Ç–µ–Ω,4111,4111,-800,-800,980,0,0,621910,False,P95X-5EX7-5M86-5A3A
xYgQPAKQXfjiuw,1532262150,FesunAOFOP,5812,5812,-9600,-9600,980,0,192,622710,False,177E-XHAE-747B-P84C
QFDcvALrqzu0yA,1532253845,–°–∫–∞—Å—É–≤–∞–Ω–Ω—è. Uber,4121,4121,12075,12075,980,0,0,632310,True
IeHTiHLj4DvACQ,1532253796,Uber,4121,4121,-15875,-15875,980,0,0,620235,False,X284-HHXM-XP2A-HAM6
Xeprho4Yox18NQ,1532250813,Uber,4121,4121,-12075,-12075,980,0,0,636110,True
cfnFnsjjUF8chg,1532250522,BARFOY,7829,7829,-13500,-13500,980,0,0,648185,False,EEK3-E0X4-HH17-B166
ALZSsesoihfDww,1532249811,Biletnakasa,7829,7829,-14000,-14000,980,0,0,661685,False,3T2H-CX0K-7PH7-TH71
BKUm4oJTjYLR1A,1532205550,–°—ñ–ª—å–ø–æ,5411,5411,-82755,-82755,980,0,827,675685,False,C5H4-8BCC-HE2H-5B55
txPnnsucWett7g,1532193425,Uber,4121,4121,-1000,-1000,980,0,0,758440,False,5C70-AP4P-X5CK-5CC6
crTZmwIVpxZKvA,1532193323,Uber,4121,4121,-4302,-4302,980,0,0,759440,False,XX85-C71E-7PKB-B1B1
9FlcYKrcPcTkEQ,1532192053,1900 COFFEE POINT,5499,5499,-4900,-4900,980,0,49,763742,False,50PK-K3MK-T7MM-C12K
DQJPpJEVxO0_kw,1532187879,VALDEVAL,5441,5441,-3080,-3080,980,0,30,768642,False,K5C4-74EB-B6K9-T6TC
8C5N2qM5oqvwGw,1532169117,ESPRESSO POINT 3,5499,5499,-8800,-8800,980,0,88,771722,False,T953-214H-PMP9-AM45
Ymlfu8oR0s-OJg,1532169104,KAFE BARBOSS,5812,5812,-22000,-22000,980,0,440,780522,False,0T7C-C765-C51P-EPE2
iowWb1Aie_EFIA,1532162160,Zheltok1,5812,5812,-2501,-2501,980,0,50,802522,False,848X-9A79-A9H2-3C24
aDdTrcCoCCmJuQ,1532088688,RESTAURANT KHMILNYY KN,5812,5812,-58000,-58000,980,0,1160,805023,False,3HTE-4EE9-B987-E389
nlciAbl3Th5i9g,1532088661,RESTORAN KHMILNYY KNYA,5812,5812,-17500,-17500,980,0,350,863023,False,ETAK-1200-64HB-P033
6OT-bOKw6B303g,1532074399,PRODUKTOVAJALAVKA753JU,5411,5411,-4800,-4800,980,0,48,880523,False,H05M-0PMM-C45P-B24M
4uqKADJjRseTig,1532027047,RektoranLikaGora13M50J,5812,5812,-28000,-28000,980,0,560,885323,False,KP31-8C45-M6P2-A5KX
ddynaTusyy5cHg,1532024853,CHANG25LRLUTEOZRB00,5812,5812,-10000,-10000,980,0,200,913323,False,C2TA-56X4-CAB1-867K
EL2iptEDXuViSg,1532024826,CHANG25LRLUTEOZRB001,5812,5812,-55600,-55600,980,0,1112,923323,False,2CC9-P8XM-1AH4-KC7C
7ku6f1RzkLULKw,1532016421,Roshen,5441,5441,-39850,-39850,980,0,398,978923,False,4BPP-190A-PA34-6CMH
VzYlzXsyEHXPMw,1532015724,Uber,4121,4121,-8373,-8373,980,0,0,1018773,False,H299-KX2C-56K6-0457
_HH6fIB27v9t-w,1532014647,–ö–∏—ó–≤—Å—å–∫–∏–π –º–µ—Ç—Ä–æ–ø–æ–ªi—Ç–µ–Ω,4111,4111,-800,-800,980,0,0,1027146,False,BA4E-807A-KMAP-71A6
PWb9WPkNNEHlKA,1532004450,Sanatrelo75N4F3Y8N4SHC,5812,5812,-64000,-64000,980,0,1280,1027946,False,B44M-MM1E-4823-8A58
-lEh_fstwwpOtw,1531983928,–í–∏–ø–ª–∞—Ç–∞ –ø—Ä–æ—Ü–µ–Ω—Ç—ñ–≤,4829,4829,993,993,980,0,0,1091946,True
4UFPGMWHWi4VLQ,1531981706,Uber,4121,4121,-5350,-5350,980,0,0,1090953,False,M0A4-KACC-M23E-CC9P
iBSmkFxT7Y2aMg,1531931499,PROGRESSCAFFE25KPLVB8X,5812,5812,-11500,-11500,980,0,230,1096303,False,KMM8-33T2-1X98-3EP8
rVol_cup7xZCLg,1531930235,–°–∫–∞—Å—É–≤–∞–Ω–Ω—è. Uber,4121,4121,10245,10245,980,0,0,1107803,True
os1matcDqMXp8w,1531930130,Uber,4121,4121,-10245,-10245,980,0,0,1097558,True
553uk-_mdTUNRQ,1531912710,STEJKHAUS74M8VK1KG2BKD,5812,5812,-8600,-8600,980,0,172,1107803,False,631A-6P82-AB67-M79K
IKu0R1T5H1xlLA,1531903185,Lesya,—Ñ–æ—Ä –∑—ç –±—ç–π–±—ç üòò,4829,4829,-500000,-500000,980,0,0,1116403,True,X73P-C845-TA18-5E06
IXjIvLQYuyRxSg,1531903116,–íi–¥: –ü–†–ò–•–û–î–¨–ö–û –ï.–í. –§–û–ü,4829,4829,500000,500000,980,0,0,1616403,True
OiHq9q33Czn-2w,1531895382,"–ö–∏—ó–≤—Å—Ç–∞—Ä
+380978495150",4812,4812,-10000,-10000,980,0,0,1116403,True,2M57-6C2E-HHTE-HT8K
2HK-yEgFsqwhlA,1531858373,portmone.com.ua,4814,4814,-10000,-10000,980,0,0,1126403,False,M528-33HE-TBM3-03XP
tlGkEBFoIWpwHg,1531850108,Billa,5411,5411,-30795,-30795,980,0,307,1136403,False,C2EE-T4H7-4H1A-39H3
JanzVQIFqJqpXQ,1531849364,Roshen,5441,5441,-9690,-9690,980,0,96,1167198,False,92T0-K940-HH0X-MA3K
Vw2njdvQmD_3SA,1531843772,Uber,4121,4121,-7842,-7842,980,0,0,1176888,False,1P6M-BE27-T8KB-18HT
TRSyFnRozTY0Qw,1531829716,Sanatrelo75N4F3Y8N4SHC,5812,5812,-71200,-71200,980,0,1424,1184730,False,H51H-BMAE-06TB-H7H8
UIBDR-QO43sB_w,1531811501,–°–∫–∞—Å—É–≤–∞–Ω–Ω—è. Uber,4121,4121,6473,6473,980,0,0,1255930,True
XjT8XJ01GlncLQ,1531811459,Uber,4121,4121,-6588,-6588,980,0,0,1249457,False,X6M1-M5C3-08T4-73TH
X5XLOcTJU5f7wg,1531810346,Uber,4121,4121,-6473,-6473,980,0,0,1256045,True
EMxl0jK3OSVLwQ,1531766658,McDonald's,5814,5814,-13800,-13800,980,0,276,1262518,False,B1ET-K0TP-67H6-PM73
H1GrAN4NPWHqYQ,1531760092,FOPPindzinaLV22752P0YV,5992,5992,-14000,-14000,980,0,0,1276318,False,1H85-3EP9-9B1X-5T6A
CyCIDXA7n1prMA,1531758791,PROGRESSCAFFE25KPLVB8X,5812,5812,-4500,-4500,980,0,90,1290318,False,607B-H5EM-2EBK-1MK0
f7EFqbRUf20hww,1531757956,Uber,4121,4121,-6840,-6840,980,0,0,1294818,False,H058-811M-A6TH-A3H7
DCwNgB63aYxkKg,1531740811,–íi–¥: –ü–†–ò–•–û–î–¨–ö–û –ï.–í. –§–û–ü,4829,4829,1300000,1300000,980,0,0,1301658,True
GLFS5D-sOde3lw,1531724921,Endorphin2753JU5UW73WD,5451,5451,-3700,-3700,980,0,37,1658,False,MX18-17M1-1BHX-1A4T
BVunYJplq0XYlA,1531668330,Uber,4121,4121,-12670,-12670,980,0,0,5358,False,3PE9-TEXB-K6XX-1EHX
eL-adfXp8BddHA,1531604956,–°–∫–∞—Å—É–≤–∞–Ω–Ω—è. Uber,4121,4121,11512,11512,980,0,0,18028,True
BEiIQ9TaASC0rw,1531579473,Uber,4121,4121,-11512,-11512,980,0,0,6516,False
g-qqTbXj2dE6fw,1531506763,Billa,5411,5411,-3418,-3418,980,0,34,18028,False,TMEE-26XT-BTP4-XHHB
7VXcgM6bNZiqNg,1531504757,Roshen,5441,5441,-5611,-5611,980,0,56,21446,False,03P2-E6EA-M3C1-XH9K
NIMsrIprfkN45w,1531504479,Billa,5411,5411,-22463,-22463,980,0,224,27057,False,A1MK-343K-7K3T-3034
eIxuGVg1FPDOFA,1531490799,–°–∫–∞—Å—É–≤–∞–Ω–Ω—è. Uber,4121,4121,7265,7265,980,0,0,49520,True
1f12z-EarVzhTA,1531490699,Uber,4121,4121,-7265,-7265,980,0,0,42255,True
A__v3XBWKGdH6A,1531480779,PROGRESSCAFFE25KPLVB8X,5812,5812,-17100,-17100,980,0,342,49520,False,80P3-TP7A-6P2X-A33C
fmzgjE-7VihzGQ,1531465445,MAGAZYN PRODUKTY 4,5411,5411,-2100,-2100,980,0,21,66620,False,BA7C-9M26-A7M9-HPXA
1Fimn9jIi8k0a8Ss5Nw,1531435082,–°–∫–∞—Å—É–≤–∞–Ω–Ω—è. Uber,4121,4121,859,859,980,0,0,68720,True
aklbTdKWcGKkmw,1531422152,–°—ñ–ª—å–ø–æ,5411,5411,-30800,-30800,980,0,308,67861,False,4CM3-8020-5E4H-6496
tXmpALKTbrb51Q,1531381974,MAGAZYN PRODUKTY 4,5411,5411,-3450,-3450,980,0,34,98661,False,0HK8-5EM6-T922-67E4
Nilx24LUunXZ_A,1531327890,Uber,4121,4121,-2500,-2500,980,0,0,102111,False,5773-MAP6-K96A-843M
1H8aFtYNqbSzNQ,1531323758,–°–∫–∞—Å—É–≤–∞–Ω–Ω—è. Uber,4121,4121,17038,17038,980,0,0,104611,True
Q8vY0ypYUp2Ykw,1531323704,Uber,4121,4121,-19307,-19307,980,0,0,87573,False,9AM8-3677-X5KP-9P29
g66WRawSwLLKdw,1531320398,Uber,4121,4121,-17038,-17038,980,0,0,106880,True
BJxfUZ_wcwasZA,1531315418,Uber,4121,4121,-14358,-14358,980,0,0,123918,False,8TMM-8C9K-769T-A877
4F5zwTmsHh1Hhw,1531292438,–ö–∏—ó–≤—Å—å–∫–∏–π –º–µ—Ç—Ä–æ–ø–æ–ªi—Ç–µ–Ω,4111,4111,-500,-500,980,0,0,138276,False,T99B-ME6E-0A5X-T5HX
BJSee-ytVfIaqQ,1531244599,Doggeriz752I4GSJWGKX6A,5812,5812,-2500,-2500,980,0,50,138776,False,750T-H30K-2BAB-T653
lPOfF6rjrcyEWg,1531244566,Doggeriz752I4GSJWGKX6A,5812,5812,-17800,-17800,980,0,356,141276,False,717C-63XK-5083-P442
lvguGkgcT6vehg,1531237993,Uber,4121,4121,-8717,-8717,980,0,0,159076,False,5TTA-T7T6-57PA-4422
-C3BQzY78D5xGQ,1531237672,Aroma Kava,5814,5814,-3900,-3900,980,0,78,167793,False,53X9-8183-TT07-MXBK
nT5tFaP54-d6CQ,1531206679,MAGAZYN PRODUKTY 4,5411,5411,-2100,-2100,980,0,21,171693,False,T4T6-BT9M-A8CM-0601
sYGHERN4uJCWQw,1531120881,MAGAZYN PRODUKTY 4,5411,5411,-3150,-3150,980,0,31,173793,False,X49H-BX9E-9E26-2354
0r5DGxxq2NY6YA,1531116113,–°–∫–∞—Å—É–≤–∞–Ω–Ω—è. Uber,4121,4121,20275,20275,980,0,0,176943,True
h9s3DxqV_ysrYQ,1531116072,Uber,4121,4121,-20329,-20329,980,0,0,156668,False,XHE2-E2AH-TTXT-A19T
VTvosvXp8f_hRQ,1531113464,Uber,4121,4121,-20275,-20275,980,0,0,176997,True
i6Qpjm6i1ZfenA,1531060596,–°—ñ–ª—å–ø–æ,5411,5411,-34074,-34074,980,0,340,197272,False,H7TP-A500-4EH1-6MMA
PcHvLaym0zucXQ,1531055109,–§–æ—Ä–∞,5499,5499,-39956,-39956,980,0,399,231346,False,K2P7-2PKA-6K1P-B3M1
_M6fzy6JjMggCQ,1531045603,Roshen,5441,5441,-4207,-4207,980,0,42,271302,False,6PE5-HT9H-318P-4AC4
D8Ht24lML2DJWA,1531045331,–§—É—Ä—à–µ—Ç,5499,5499,-21509,-21509,980,0,215,275509,False,1M84-175M-BK5T-5PP2
qKN7iAnbHx9U8Q,1531043665,JYSK,5712,5712,-6500,-6500,980,0,0,297018,False,AMBK-208P-3AH5-B1A7
3h18S1PYYTBQ0A,1531037594,HONEY,5812,5812,-51862,-51862,980,0,1037,303518,False,X185-0AAP-6494-032P
AxOgL0qZNEB8aA,1530975051,Bird13I5F5DSYFCAH0,5812,5812,-9000,-9000,980,0,180,355380,False,TAP1-7915-M7HB-06EB
oMtfK02yzEINag,1530972159,–°—ñ–ª—å–ø–æ,5411,5411,-24196,-24196,980,0,241,364380,False,8PMT-KXK5-EA10-TP29
6dl5aLScpjuxIg,1530971895,–°—ñ–ª—å–ø–æ,5411,5411,-9925,-9925,980,0,99,388576,False,KA32-E256-428M-PM99
dUXFr3hzNihp0g,1530970657,LyaFabrik,5812,5812,-13000,-13000,980,0,260,398501,False,EHK5-E9M5-7933-M8A0
KwgKiWf2uhP0tw,1530966858,TOVFlagmanStorKafe1,5812,5812,-94962,-94962,980,0,1899,411501,False,708E-2TA2-538E-C5XA
6nniNWDrrN84vQ,1530966823,TOVFlagmanStorKafe,5812,5812,-36080,-36080,980,0,721,506463,False,BK4A-790A-MXP0-788H
Qcon6OkDheZLwg,1530958672,ECOLINES.NET,4131,4131,-258700,-258700,980,0,0,542543,False,E6TB-TB26-T4CE-7789
YntelzCDwMSmFw,1530952926,Uber,4121,4121,-7344,-7344,980,0,0,801243,False,4BPB-X4X5-28MK-MHP1
owrhu0DsPUHKGg,1530907561,Aroma Kava,5814,5814,-7800,-7800,980,0,156,808587,False,0236-XE15-8CPP-7C6H
gdoT-yU9tA4n3A,1530881458,–ê–ª–µ–∫—Å–µ–π –í—ã–∫–∞–ª—é–∫ BCD,–ª–æ—Å–æ—Å—å üêü,4829,4829,-9776,-9776,980,376,0,816387,True,8568-BP43-TC8B-97CA
e16Mfaw0o0potQ,1530861854,Endorphin2753JU5UW73WD,5451,5451,-2200,-2200,980,0,22,826163,False,5H49-2BM2-P02E-HCK6
a706oj4a6QRJlQ,1530861348,Sokrat13LCAVTIRTLX00,5943,5943,-2740,-2740,980,0,0,828363,False,6543-K9TK-H03B-9BPK
wgQFEMPxYOa8kg,1530831985,Aroma Kava,5814,5814,-8400,-8400,980,0,168,831103,False,9C6M-PT38-6M8C-67MH
3ZxjCGHvJCiALQ,1530793604,Produktova Lavka,5499,5499,-2400,-2400,980,0,24,839503,False,1MM9-M10K-4AT3-4348
RlaThblRVL0g5A,1530773989,Uber,4121,4121,-7939,-7939,980,0,0,841903,False,759B-EBK9-3857-6HK4
Pq7vKPf_er_nKQ,1530728620,Uber,4121,4121,-2000,-2000,980,0,0,849842,False,HC25-58BX-7AP4-7BCX
60OF18sTRBSJgg,1530726821,Uber,4121,4121,-7509,-7509,980,0,0,851842,False,255C-0971-2HP1-87TX
eoyLjUfTEfMMyw,1530724733,–°—ñ–ª—å–ø–æ,5411,5411,-141463,-141463,980,0,1414,859351,False,K4B0-P38P-M70E-1BK8
1rJl5ND54fjxTg,1530720773,–ö–∏—ó–≤—Å—å–∫–∏–π –º–µ—Ç—Ä–æ–ø–æ–ªi—Ç–µ–Ω,4111,4111,-500,-500,980,0,0,1000814,False,972H-7EH5-XX9M-A2A7
O5QML0yN74BaQA,1530708990,RESTAURANT KHMILNYY KN,5812,5812,-56000,-56000,980,0,1120,1001314,False,258C-C2K5-M13A-P1K2
y_QEKjPJ5VxUyw,1530708965,RESTORAN KHMILNYY KNYA,5812,5812,-12500,-12500,980,0,250,1057314,False,BC7K-KE2H-TEPT-E7BB
xrqQ4Vr8a2sb2A,1530687952,–í–∏–ø–ª–∞—Ç–∞ –ø—Ä–æ—Ü–µ–Ω—Ç—ñ–≤,4829,4829,2223,2223,980,0,0,1069814,True
WXVMWKDquGNwjQ,1530686697,–°–∫–∞—Å—É–≤–∞–Ω–Ω—è. Uber,4121,4121,5001,5001,980,0,0,1067591,True
bCGltDpJfd1PTQ,1530686640,Uber,4121,4121,-5285,-5285,980,0,0,1062590,False,ME56-8922-A51P-K43T
7-LEkCpXo1Da6g,1530685362,Uber,4121,4121,-5001,-5001,980,0,0,1067875,True
E9PdMht_jcYrbg,1530649971,Zheltok,5812,5812,-2500,-2500,980,0,50,1072876,False,E35M-6T9M-8CPK-B3T5
FwObcvl6ADTs9A,1530649942,Zheltok148SXLOK7VDHB0C,5812,5812,-22500,-22500,980,0,450,1075376,False,5M1C-8B57-K75P-TAT6
fq80wVujxFCoWg,1530646588,AZS Z MAHAZYNOM BROVAR,5541,5541,-40013,-40013,980,0,0,1097876,False,EK9E-35X9-T18P-766M
fpir4BAtB212cw,1530643368,Uber,4121,4121,-13815,-13815,980,0,0,1137889,False,72CB-0HK1-HE4P-MC19
bYuATUDGiPVjyg,1530620149,Sanatrelo75N4F3Y8N4SHC,5812,5812,-75200,-75200,980,0,1504,1151704,False,054C-E97C-AT68-3TMX
_AyCq0zsrD3Nvg,1530620138,Sanatrelo75N4F3Y8N4SHC,5812,5812,-22700,-22700,980,0,454,1226904,False,P34T-AM2C-50HE-2CM5
kr6SVDdwjGFZXA,1530617490,–ü—Ä–∏–≤–∞—Ç24,6536,6536,1200000,1200000,980,0,0,1249604,False
fi2ai_ATZuMIHw,1530600122,Uber,4121,4121,-9446,-9446,980,0,0,49604,False,3E13-6MCM-3TKB-321H
FEfSO5V-DcZqQg,1530598275,–°–∫–∞—Å—É–≤–∞–Ω–Ω—è. Uber,4121,4121,12062,12062,980,0,0,59050,True
1LXNVCZU94QWDA,1530598223,Uber,4121,4121,-14249,-14249,980,0,0,46988,False,2TEB-P70B-XK8C-5MCC
QgzN8oLSvZsjhQ,1530594839,Uber,4121,4121,-12062,-12062,980,0,0,61237,True
gf5DmYhBMZdsSw,1530594817,–°–∫–∞—Å—É–≤–∞–Ω–Ω—è. Uber,4121,4121,10245,10245,980,0,0,73299,True
HO7-SL4222fdfQ,1530594555,Uber,4121,4121,-10245,-10245,980,0,0,63054,True
w_NqmEMw2sZBYA,1530551150,Uber,4121,4121,-6468,-6468,980,0,0,73299,False,0011-742K-0CCT-8296
znJ6r60jDfCSiQ,1530550968,–°—ñ–ª—å–ø–æ,5411,5411,-36502,-36502,980,0,365,79767,False,PPX8-25B3-C3M5-XH42
kox__kQqGLHzBw,1530549903,Zara,5651,5651,-19900,-19900,980,0,0,116269,False,3H8A-9509-PK42-6B9X
cft7Hfe_YTKN-Q,1530530287,RESTAURANT KHMILNYY KN,5812,5812,-60000,-60000,980,0,1200,136169,False,924C-H4K6-2424-M6TP
muH9jEcdnnSDgQ,1530512394,LyaFabrik57S3PAY36CBX2,5812,5812,-27000,-27000,980,0,540,196169,False,81K3-0X4A-4KAX-3E99
M0Oi1ctt8Gywsg,1530464443,FOPPindzinaLV22752P0YV,5992,5992,-15000,-15000,980,0,0,223169,False,KE39-421K-EAX8-C65P
c2O-3H7YmpOM4g,1530454502,–§–æ—Ä–∞,5499,5499,-3441,-3441,980,0,0,238169,False,6C10-P526-0553-CEHM
kT_rFUl6ERzArQ,1530452987,Lesya,–¥–µ—Ç–∫–æ  –º–æ–Ω–∏–∫—é—Ä üíÖ,4829,4829,-41600,-41600,980,1600,0,241610,True,55T0-P08X-A71C-2693
_8jdsHVjLDQ5Sg,1530452023,4MENBARBERSHOP25ND0XZM,7230,7230,-40000,-40000,980,0,0,283210,False,A808-MK53-44T4-H9A2
9xp3xhaPUfvrRg,1530446568,"–ö–∏—ó–≤—Å—Ç–∞—Ä
+380960149625",4812,4812,-7000,-7000,980,0,0,323210,True,M47E-8BKH-KC88-P5K1
zZJpFRebJ2YQlw,1530444685,–í—ñ–¥—Å–æ—Ç–∫–∏ –∑–∞ —á–µ—Ä–≤–µ–Ω—å,4829,4829,13,13,980,0,0,330210,True
HoEOXSRcxKWciw,1530434766,Uber,4121,4121,-6131,-6131,980,0,0,330197,False,T9MK-X3AX-E4P5-5P09
ua2lgMBtpEXXTw,1530433157,–ù–æ–≤–∞ –ø–æ—à—Ç–∞,4214,4214,-20400,-20400,980,0,0,336328,False,30CP-7TC2-81AB-P949
rKrGmLiXlMUwUQ,1530430614,–ö–∏—ó–≤—Å—å–∫–∏–π –º–µ—Ç—Ä–æ–ø–æ–ªi—Ç–µ–Ω,4111,4111,-500,-500,980,0,0,356728,False,36P8-M4E8-72M0-P344
DDxWzHU9feXtdA,1530430608,–ö–∏—ó–≤—Å—å–∫–∏–π –º–µ—Ç—Ä–æ–ø–æ–ªi—Ç–µ–Ω,4111,4111,-500,-500,980,0,0,357228,False,567H-X3T7-MT06-643T
MSbVcc6EtT507Q,1530430373,Cosmo,5977,5977,-7090,-7090,980,0,0,357728,False,0MP8-B9B6-5014-B0AH
OKdPag3hbBF7Qw,1535653686,MAGAZYN PRODUKTY 4,5411,5411,-3650,-3650,980,0,73,200883,False,88PA-AEKX-AK3X-61X2
IbzcOo8XyVM_fg,1535652765,–ö–∏—ó–≤—Å—å–∫–∏–π –º–µ—Ç—Ä–æ–ø–æ–ªi—Ç–µ–Ω,4111,4111,-800,-800,980,0,0,204533,False,1261-6PT0-AT2T-0T67
vvELYi6v1pW98A,1535650569,Lesya,4829,4829,-1040,-1040,980,40,0,205333,True,C37M-3T2K-KB68-64P4
5rb7eCDHrowm9Q,1535647718,–ö–∏—ó–≤—Å—å–∫–∏–π –º–µ—Ç—Ä–æ–ø–æ–ªi—Ç–µ–Ω,4111,4111,-800,-800,980,0,0,206373,False,K339-MCK2-E36E-22MX
dI_jhBTepsJq-A,1535561673,KAFE BLUE CUP,5812,5812,-16900,-16900,980,0,0,207173,False,EH97-PH2E-8A2T-ETMM
Oo5UzGKOSH7HTQ,1535561519,LE KOMORA,5921,5921,-69900,-69900,980,0,1398,224073,False,A168-674M-MHXE-49CC
_AmtxZKkIZNzAQ,1535533980,–ö–∏—ó–≤—Å—å–∫–∏–π –º–µ—Ç—Ä–æ–ø–æ–ªi—Ç–µ–Ω,4111,4111,-800,-800,980,0,0,293973,False,6PT5-KHX2-4469-M127
YAJvGbEdxKYSaA,1535529070,–ö–∏—ó–≤—Å—å–∫–∏–π –º–µ—Ç—Ä–æ–ø–æ–ªi—Ç–µ–Ω,4111,4111,-800,-800,980,0,0,294773,False,5EE3-68T5-A1M4-HB88
JrteyafDUztRtg,1535526892,MAGAZYN PRODUKTY 4,5411,5411,-4200,-4200,980,0,84,295573,False,43EH-XH77-TK39-E4BT
lHe8ci1NCCCQ8w,1535522489,–í–∏–ø–ª–∞—Ç–∞ –ø—Ä–æ—Ü–µ–Ω—Ç—ñ–≤,4829,4829,4356,4356,980,0,0,299773,True
mS3hQXkt1l5mAA,1535495740,portmone.com.ua,4814,4814,-11000,-11000,980,0,0,295417,False,M2AP-TC9A-5B64-KH67
GTasbPSxPmI2hw,1535482062,restoranCHICHIKO1,5812,5812,-60302,-60302,980,0,0,306417,False,E330-CMXC-5PB1-H243
HJByIG9gYpxSXg,1535482025,restoran CHICHIKO,5812,5812,-53900,-53900,980,0,0,366719,False,K349-9BH1-TP9P-9P49
mslt1mBevnaKRQ,1535457760,PROGRESSCAFFE25KPLVB8X,5812,5812,-11500,-11500,980,0,0,420619,False,H3EA-38K3-6KH3-EA8K
vW689OspzxaAug,1535457436,Florrum,5992,5992,-80000,-80000,980,0,16000,432119,False,TA5B-6P9P-BPK7-KM2X
Vtdiz4Pg_MFgHQ,1535455878,–íi–¥: –ü–†–ò–•–û–î–¨–ö–û –ï.–í. –§–û–ü,4829,4829,410000,410000,980,0,0,562119,True
qtbYN1BaR5tMgg,1535375339,LIQPAY*FOP Hizhnyak N.,4215,4215,-110141,-110141,980,0,0,152119,False,13M9-HA90-7PT0-3C3H
U_RlSnNEk9AMCg,1535355220,Kosk1313QDWZFACRG0,5993,5993,-19000,-19000,980,0,0,262260,False,K40X-577M-06M4-0C60
gCw3GM3TFMTxVQ,1535300424,–ö–∏—ó–≤—Å—å–∫–∏–π –º–µ—Ç—Ä–æ–ø–æ–ªi—Ç–µ–Ω,4111,4111,-800,-800,980,0,0,281260,False,ACC5-T979-9899-THAC
DO1s2AugR1dFNg,1535299410,Malevich,5812,5812,-8500,-8500,980,0,0,282060,False,886C-E73M-CKAM-K8A9
-liZW5wzbtheag,1535269333,KonditerskajaLyafabrik,5441,5441,-13000,-13000,980,0,260,290560,False,6041-X7KM-4M89-5K2K
0WoGLQ4LUE81yQ,1535213158,Steam,5816,5816,-6500,-6500,980,0,0,303560,False,5MXM-TM2P-E79C-550E
SqgecSo4wCXl4Q,1535212059,BeerMarket,5921,5921,-7998,-7998,980,0,159,310060,False,3751-B7A0-T486-M096
KEAydvSN38ft0A,1535211747,Billa,5411,5411,-22926,-22926,980,0,458,318058,False,4BPB-PM29-5THE-7M57
wq_e4K4QZVqCOQ,1535192524,–ê–ø—Ç–µ–∫–∞ –ù–∏–∑—å–∫–∏—Ö –¶—ñ–Ω,5912,5912,-4480,-4480,980,0,0,340984,False,A9H5-E3XP-E21H-PBBK
o5YA3L3LWX2sPA,1535190073,KONTSEPTUALNAPEKARNJAC,5812,5812,-36000,-36000,980,0,0,345464,False,277A-K015-EB0A-M650
30qSjFVJXMO5qA,1535183521,APTEKA 9,5912,5912,-4840,-4840,980,0,0,381464,False,1KT3-102K-MXA9-CCXA
z_w4Ad_B5-nY1A,1535137574,–ö–∏—ó–≤—Å—å–∫–∏–π –º–µ—Ç—Ä–æ–ø–æ–ªi—Ç–µ–Ω,4111,4111,-800,-800,980,0,0,386304,False,XM6C-P180-B3CK-6A1C
nbmrlCfCvYX_bw,1535137567,–ö–∏—ó–≤—Å—å–∫–∏–π –º–µ—Ç—Ä–æ–ø–æ–ªi—Ç–µ–Ω,4111,4111,-800,-800,980,0,0,387104,False,0C80-2452-4CKK-BEKX
SN0yA-jzVAUj_g,1535106411,OKKO,5541,5541,-14470,-14470,980,0,0,387904,False,9H12-325K-6TE9-3KHC
fah-nQK1W6pKxw,1535105704,Novus,5499,5499,-12246,-12246,980,0,244,402374,False,168H-8PA8-961H-PT9H
YCLNbMhEPmWQqQ,1535103091,–ö–∏—ó–≤—Å—å–∫–∏–π –º–µ—Ç—Ä–æ–ø–æ–ªi—Ç–µ–Ω,4111,4111,-800,-800,980,0,0,414620,False,P373-7MPE-C193-3AX7
KVx1YXlyZd7pDA,1535102634,Kosk1313QDWZFACRG0,5993,5993,-7600,-7600,980,0,0,415420,False,BC1M-M8T4-PBKE-23HP
1Jl1snMehTkNXw,1535100961,Steam,7994,7994,-5700,-5700,980,0,0,423020,False,P077-E622-27KB-MAT5
apR477MLkx2pVg,1535013312,Produktova Lavka,5499,5499,-3000,-3000,980,0,60,428720,False,MK0E-6A78-4X11-PTXA
FtcFNej8q1z2jA,1534927281,MAGAZYN PRODUKTY 4,5411,5411,-2100,-2100,980,0,42,431720,False,3H6P-6H7K-7AT6-BHX4
a0GKaYPyB6xESg,1534840947,FOPPindzinaLV22752P0YV,5992,5992,-17500,-17500,980,0,3500,433820,False,KXX8-9HTX-AA4C-P1H4
sZ7Bt6JYheDWqQ,1534840502,Billa,5411,5411,-9097,-9097,980,0,181,451320,False,1A7T-81M6-PBTM-T7TA
CC2pybjvhnrnnA,1534837906,–ù–æ–≤–∞ –ø–æ—à—Ç–∞,4214,4214,-3500,-3500,980,0,0,460417,False,A1K9-B99C-T3MX-MT48
dW_3dm_89didWA,1534788470,PUB SUNDUK,5814,5814,-34000,-34000,980,0,0,463917,False,M8PK-7M5A-BT2A-7185
JzUa_WJlpK6LMA,1534751819,MAGAZYN PRODUKTY 4,5411,5411,-2100,-2100,980,0,42,497917,False,C9K7-48TB-AMK9-T7PA
2pSnbFQOh4E7zg,1534685870,Lesya,4829,4829,-73600,-73600,980,0,0,500017,True,8243-8TC9-KAH1-3MT4
0nZPBDpsnCSz0w,1534684569,LIQPAY*FOP Hizhnyak N.,4215,4215,-137968,-137968,980,0,0,573617,False,555K-CP5H-90ET-EC6H
GhTvoyMEXzbuaQ,1534683987,Prodmag,5499,5499,-2390,-2390,980,0,47,711585,False,EXB4-KK2A-2MP3-75A3
GiuFNio9UAlInQ,1534683177,APTEKA LASKAVA 7,5912,5912,-3200,-3200,980,0,0,713975,False,TKT1-30H6-EBCC-A08C
1U5Ea6l3wYLl5w,1534683009,APTEKA LASKAVA 7,5912,5912,-4460,-4460,980,0,0,717175,False,BK1T-34T6-8XHT-9X3E
sqxQp6LXN4G9MQ,1534682391,KAFE,5812,5812,-33800,-33800,980,0,0,721635,False,T5H6-9609-C57B-EHA4
pJyS-I3npool-A,1534678398,–ï–∫–æ-–õ–∞–≤–∫–∞,5499,5499,-3500,-3500,980,0,70,755435,False,TE7C-K217-647B-8X5P
P7DU9GugU8nVGg,1534677555,FOTOVRAMKE,5999,5999,-17000,-17000,980,0,0,758935,False,79E1-TM01-594X-4AMB
FM0c78xgUc3KLg,1534674691,–ë–∞–Ω–∫–æ–º–∞—Ç DN00 Mykhailivska  str,6011,6011,-20100,-20100,980,100,0,775935,False,X50A-49K1-C6BK-5AP3
CwuPe5nLbwRa4g,1534663744,KonditerskajaLyafabrik,5441,5441,-30700,-30700,980,0,614,796035,False,8CP4-HBE4-M7M0-HHMT
Bna_zRuVkZ1XhQ,1534662328,–í–∏–ø–ª–∞—Ç–∞ –ø—Ä–æ—Ü–µ–Ω—Ç—ñ–≤,4829,4829,1026,1026,980,0,0,826735,True
M4rdRCla9Qs8gQ,1534603910,Billa,5411,5411,-6536,-6536,980,0,130,825709,False,93EX-B23M-91PC-HEK0
_5ohSmzy1rwtxA,1534537617,COLOR FACTORY NEW YORK,7922,7922,-244502,-8683,840,0,0,832245,False,90K5-3B9E-0A44-0P9A
yyPIUEmEUUWl2Q,1534508934,–ë—ñ–ª–∏–π –ù–∞–ª–∏–≤,5812,5812,-5800,-5800,980,0,0,1076747,False,047B-3CTP-07TA-H9M5
s-UNfTNQ-wLAwQ,1534508281,Xiaomi Store,5732,5732,-129900,-129900,980,0,0,1082547,False,2309-6BCM-M75K-EE5E
Db0h4xkKfHf7CQ,1534503166,Lesya,–ø—Ä–∏—è—Ç–Ω–æ–≥–æ –∞–ø–ø–µ—Ç–∏—Ç–∞ üòò,4829,4829,-100000,-100000,980,0,0,1212447,True,TM8M-2XC6-A9H4-951H
oN_hlzEDrGhwYw,1534487526,RajtKophibar26CPJ17EVB,5812,5812,-26800,-26800,980,0,0,1312447,False,5TT7-A9MC-2120-PE8K
huyYjcu-6uNFmA,1534486193,–í–∏–≤—ñ–∑ —Å–º—ñ—Ç—Ç—è,4900,4900,-2311,-2311,980,0,0,1339247,True,3HPX-C1T4-BTP9-8B9M
hSwhi7k2HsiFlQ,1534486193,–ö–≤–∞—Ä—Ç–ø–ª–∞—Ç–∞,4900,4900,-12120,-12120,980,0,0,1341558,True,MH87-PXP1-A3C8-79A0
c-lLC0lD-9tu_w,1534486193,–°–≤—ñ—Ç–ª–æ,4900,4900,-11352,-11352,980,0,0,1353678,True,9PA5-CT4C-7MX5-4M69
dSmMHhA8YyVIdw,1534486192,–•–æ–ª–æ–¥–Ω–∞ –≤–æ–¥–∞,4900,4900,-18387,-18387,980,0,0,1365030,True,4915-7E6P-BB8H-2X06
4-gWFSxSi-BWHA,1534486192,–ì–∞–∑,4900,4900,-2296,-2296,980,0,0,1383417,True,69M9-B29A-9K8H-B3AK
ykySEr_x9lgBeA,1534452969,Steam,7994,7994,-9900,-9900,980,0,0,1385713,False,M683-3399-CCCA-E7EE
mJxBOO0ZPHHUGg,1534445027,Il Molino,5814,5814,-21603,-21603,980,0,0,1395613,False,6CC1-A5TM-69X7-8110
jBSrDTJCpYbD_Q,1534442284,Epicenter,5211,5211,-33468,-33468,980,0,0,1417216,False,PAEP-HMHX-P330-5343
QTWHUHDDK7jyjw,1534436638,–ö–∏—ó–≤—Å—å–∫–∏–π –º–µ—Ç—Ä–æ–ø–æ–ªi—Ç–µ–Ω,4111,4111,-800,-800,980,0,0,1450684,False,B431-P321-2P88-5585
b2oD6imvjqjsyg,1534426570,Lesya,‚òï —Ñ–æ—Ä –∑—ç —á–∏–∞ –±—ç–π–±—ç,4829,4829,-100000,-100000,980,0,0,1451484,True,B00M-HHMA-5C3C-91HH
MigLDvLc0yfoIA,1534422762,–íi–¥: –ü–†–ò–•–û–î–¨–ö–û –ï.–í. –§–û–ü,4829,4829,1750000,1750000,980,0,0,1751484,True
E4ZCLZa42JEIoA,1534332925,–ê–ø—Ç–µ–∫–∞ –ù–∏–∑—å–∫–∏—Ö –¶—ñ–Ω,5912,5912,-2800,-2800,980,0,0,1484,False,AC99-6TPX-K5K9-C239
VI9NUIQaFC92IA,1534331647,Valdeval,5812,5812,-8400,-8400,980,0,0,4284,False,0K72-EMET-6X22-3CE5
twbFA0GeMUpgjA,1534331372,–°—ñ–ª—å–ø–æ,5411,5411,-29319,-29319,980,0,586,12684,False,88A2-TE1H-KBMC-4976
Lyh8tF3Mk2jmLQ,1534276503,–°—ñ–ª—å–ø–æ,5411,5411,-31162,-31162,980,0,623,42003,False,XT9E-H333-291K-62XE
Xepohoocoxp9NQ,1534270167,Epicenter,5211,5211,-13086,-13086,980,0,0,73165,False,95E8-17HH-7TC5-X02H
f1FFQB_C3VAV0A,1534261214,–ö–∏—ó–≤—Å—å–∫–∏–π –º–µ—Ç—Ä–æ–ø–æ–ªi—Ç–µ–Ω,4111,4111,-800,-800,980,0,0,86251,False,E68A-BTPA-496K-5P9E
AfJyjGP-HK75vg,1534245879,InternetMagazin,5399,5399,-3800,-3800,980,0,76,87051,False,80C7-BAC9-EA1M-3E33
DF-3h7m4ycK_hg,1534232710,YAROSLAVA,5814,5814,-2600,-2600,980,0,0,90851,False,BX21-CHT4-X7HX-MA76
F4huMzE9kMu9jA,1534146979,Steam,5816,5816,-3400,-3400,980,0,0,93451,False,4H8C-558K-B01X-663B
1vaADVpXOb4NgQ,1534143846,YAROSLAVA,5814,5814,-2600,-2600,980,0,0,96851,False,1079-8K0C-2614-9CHT
VhW7IHT7Lx2Q1g,1534095298,–í–µ–ª–∏–∫–∞ –ö–∏—à–µ–Ω—è,5411,5411,-27188,-27188,980,0,543,99451,False,052B-55CB-7X05-T9H6
ae9x8UheKc_aCg,1534093541,McDonald's,5814,5814,-17400,-17400,980,0,0,126639,False,9MM9-343E-B69X-HH42
3sz9R9yXhBCSRw,1534078625,Steam,5816,5816,-3200,-3200,980,0,0,144039,False,0AA5-58EP-8PK4-B9AM
6gpgzXndA8Tanw,1534068251,RESTAURANT TRES BRANCH,5812,5812,-37000,-37000,980,0,0,147239,False,6T2H-X4X9-4442-6KA5
g1crcYnuS3TF7g,1533998256,–ö–∏—ó–≤—Å—å–∫–∏–π –º–µ—Ç—Ä–æ–ø–æ–ªi—Ç–µ–Ω,4111,4111,-800,-800,980,0,0,184239,False,P1AC-XA9K-AB9E-TK65
QJXOijjod4hdrg,1533998251,–ö–∏—ó–≤—Å—å–∫–∏–π –º–µ—Ç—Ä–æ–ø–æ–ªi—Ç–µ–Ω,4111,4111,-800,-800,980,0,0,185039,False,XATB-06H7-612P-38PT
rBQ2Q6pCjZ3bWA,1533993685,PHOPGEJKOOV,5533,5533,-450308,-450308,980,0,0,185839,False,6TEM-X0B8-6APT-305P
t3ZbtEEweTQFfQ,1533986285,–ú–µ–≥–∞–º–∞—Ä–∫–µ—Ç,5411,5411,-35080,-35080,980,0,701,636147,False,12AX-PAB9-BE50-00M3
1AMrVnpkxIOC0A,1533982729,KuhnjaBouling13R4KF5X1,5812,5812,-7500,-7500,980,0,0,671227,False,462P-0C6T-391K-3X5X
sNesqdgpHxGJZA,1533982696,KuhnjaBouling13R4KF5XM,5812,5812,-14800,-14800,980,0,0,678727,False,MXX8-20KT-4986-553M
IeuoYX2PO2TL1g,1533971199,–ö–∏—ó–≤—Å—å–∫–∏–π –º–µ—Ç—Ä–æ–ø–æ–ªi—Ç–µ–Ω,4111,4111,-800,-800,980,0,0,693527,False,6574-5542-4MKT-4TAE
IJ1It78zHmBJPA,1533971194,–ö–∏—ó–≤—Å—å–∫–∏–π –º–µ—Ç—Ä–æ–ø–æ–ªi—Ç–µ–Ω,4111,4111,-800,-800,980,0,0,694327,False,EA6E-H2X7-PT9C-8H7X
5fYPwTpW39dC8g,1533905541,Produktova Lavka,5499,5499,-2400,-2400,980,0,48,695127,False,CH7C-K295-T6MC-9E21
uxH1ioqS3ljw2A,1533901006,–°—ñ–ª—å–ø–æ,5411,5411,-4293,-4293,980,0,85,697527,False,712E-4T7B-HB9K-B2CE
h-hpuxOnn2auyw,1533899697,Lesya,4829,4829,-280000,-280000,980,0,0,701820,True,95X7-55EM-8868-04MH
kZt6iE9JUDJi8A,1533899642,–íi–¥: –ü–†–ò–•–û–î–¨–ö–û –ï.–í. –§–û–ü,4829,4829,810000,810000,980,0,0,981820,True
UZbPG6HWuJ1_ug,1533889559,YAROSLAVA,5814,5814,-2600,-2600,980,0,0,171820,False,39P2-715M-E9KA-6B6H
RU-AeyaHam_zPw,1533883567,RESTORAN BASSANO DOLCE,5812,5812,-8000,-8000,980,0,0,174420,False,397E-C133-6C2X-P11T
WZDACULdc-upyA,1533828098,PHOPPROBACHAJON2272VZG,742,742,-99800,-99800,980,0,0,182420,False,X1P3-H010-B7P9-4T23
wmSehnOZYj1Zew,1533826910,Lesya,4829,4829,-34320,-34320,980,1320,0,282220,True,2771-4CAK-9ECK-KKHT
VNT2x5Y4Rs_eHA,1533811590,PYRIZHKOVA T. KLARA,5814,5814,-3400,-3400,980,0,0,316540,False,MPC8-09EP-9P5X-4XCX
gG69hYGli9d-Lw,1533806246,Lvvkruasan2561B3786Y2L,5812,5812,-5000,-5000,980,0,0,319940,False,MKMH-6K1K-6P0E-XA58
WewR5KjInQBHKQ,1533748369,33477,5912,5912,-3518,-3518,980,0,0,324940,False,7A14-11EA-0240-71TT
URo-IpYKR1nd8Q,1533739296,Wayforpay,5995,5995,-41500,-41500,980,0,0,328458,False,PCBK-HE0B-5B15-8789
hkZN2mOIkn8zPA,1533727595,–°—ñ–ª—å–ø–æ,5411,5411,-11026,-11026,980,0,220,369958,False,7T73-0922-90AB-9969
Zk6_IqTTiLw7zw,1533713243,YAROSLAVA,5814,5814,-2600,-2600,980,0,0,380984,False,XP21-M1KE-CX28-T12E
m6G3HB_gUhhUMg,1533663462,FOP ZOGHYJ OS,5812,5812,-8100,-8100,980,0,0,383584,False,9K69-1T99-XXE4-23P6
bURUUG0W66yjzw,1533639861,–ü—Ä–∏–≤–∞—Ç24,6536,6536,2800,2800,980,0,0,391684,False
UDtCf147T1__bQ,1533639534,–°—ñ–ª—å–ø–æ,5411,5411,-22028,-22028,980,0,440,388884,False,81E7-A3C2-32MH-TXPB
2z1u6pI2l-PQ9A,1533626092,Cosmo,5977,5977,-3390,-3390,980,0,0,410912,False,M43E-K4B7-M5M7-XM1E
KFJOJ3ZP1tAobQ,1533623915,Steam,7994,7994,-8600,-8600,980,0,0,414302,False,54XX-8459-K79B-8TH1
nu1tQllv4Qer_g,1533585891,–§–û–ü –ì—Ä–∏–≥–æ—Ä—è–Ω –û–ª–µ–Ω–∞ –í–æ–ª–æ–¥–∏–º–∏—Ä—ñ–≤–Ω–∞,4829,4829,-45208,-45208,980,886,0,422902,True,BAEH-92AA-577B-X03B
RNZUrkypqwgirw,1533579273,–í–µ–ª–º–∞—Ä—Ç,5499,5499,-1349,-1349,980,0,26,468110,False,MC93-3E53-0T8E-P194
fFWaFCuDqmyFAQ,1533579085,–í–µ–ª–º–∞—Ä—Ç,5499,5499,-34896,-34896,980,0,697,469459,False,AH0X-KA58-XK50-X655
3G9LIyzGT8syLw,1533577918,JYSK,5712,5712,-37500,-37500,980,0,0,504355,False,505T-HX8K-B76C-A6EP
131lYlEzNqtdWA,1533577065,Valdeval,5812,5812,-6300,-6300,980,0,0,541855,False,81BC-9C40-1B87-8207
v7xX92KOCt-Xkg,1533575722,BarrestoranDoggeris,5812,5812,-7900,-7900,980,0,0,548155,False,4X26-E12A-P6EP-E1M4
xQ3WH5Jc2q9e-w,1533569664,portmone.com.ua,4814,4814,-10000,-10000,980,0,0,556055,False,42H8-E84C-B5PT-54HH
UHhi4RAEiipIPA,1533554290,–°—ñ–ª—å–ø–æ,5411,5411,-8198,-8198,980,0,163,566055,False,85P3-8TPK-4583-370P
rzWtF1adWFO-mg,1533539966,MAGAZYN PRODUKTY 4,5411,5411,-4200,-4200,980,0,84,574253,False,12C7-K0KE-HCEX-T8HH
qLMW2q5baGr0Aw,1533488526,Valdeval,5812,5812,-5840,-5840,980,0,0,578453,False,19PH-8CMP-0A40-C58K
jmHovOlLwdgBrg,1533487934,Cosmo,5977,5977,-26610,-26610,980,0,0,584293,False,T43A-1744-KBB3-XMA7
cMyPWuki3Ui45Q,1533477307,–ï–∫–æ-–õ–∞–≤–∫–∞,5499,5499,-2200,-2200,980,0,44,610903,False,64X1-3KT5-AXC0-MCME
sXuB3Y-BbDWqDA,1533476641,TurkanaGonchara,5812,5812,-24780,-24780,980,0,0,613103,False,46T2-1B4A-45EX-8H2X
p-Y4VnoJ-uK8yA,1533474498,RestoranTinTin,5812,5812,-57800,-57800,980,0,0,637883,False,2MM2-MXTC-0MX3-CBM2
VOFBB-peoUjXbg,1533411537,Steam,7994,7994,-4200,-4200,980,0,0,695683,False,M75E-2826-BBT5-7XME
WsWiwaNTOA336w,1533396425,–ö–∏—ó–≤—Å—å–∫–∏–π –º–µ—Ç—Ä–æ–ø–æ–ªi—Ç–µ–Ω,4111,4111,-800,-800,980,0,0,699883,False,MC38-XAPE-K995-TA31
EsuPeY5QMM0GMg,1533373982,Lesya,4829,4829,-56000,-56000,980,0,0,700683,True,KAXM-5156-XKH8-6P1E
H9_7z8zHwIWjGg,1533373783,Novus,5499,5499,-105983,-105983,980,0,2119,756683,False,0203-X4T1-5PP6-470B
IwWZ6lXJ25Aw9Q,1533367418,–ö–∏—ó–≤—Å—å–∫–∏–π –º–µ—Ç—Ä–æ–ø–æ–ªi—Ç–µ–Ω,4111,4111,-800,-800,980,0,0,862666,False,B004-CB2P-CBXA-A383
4cbxPpz7kVYAdw,1533366357,–í–∏–ø–ª–∞—Ç–∞ –ø—Ä–æ—Ü–µ–Ω—Ç—ñ–≤,4829,4829,2297,2297,980,0,0,863466,True
zT0x3-tsDhimGQ,1533319896,Biletnakasa,7829,7829,-4000,-4000,980,0,0,861169,False,02BC-XKEX-1A03-X4B9
uOlY4oEGFVd22A,1533319083,HONEY,5812,5812,-35900,-35900,980,0,0,865169,False,9101-8715-E12T-9P15
yDAguKQCAaOXQg,1533296415,STEJKHAUS74M8VK1KG2BKD,5812,5812,-17300,-17300,980,0,0,901069,False,76MM-6T9B-EE92-E77B
VR0j0nmHTudXuA,1533281761,YAROSLAVA,5814,5814,-2600,-2600,980,0,0,918369,False,X6A9-6HX2-97P6-728E
mwTG7z426ZzHSw,1533236491,BURGERFARM,5814,5814,-33500,-33500,980,0,0,920969,False,EP92-KH0K-0AK2-87BH
bXRXfO5moVKr4w,1533228214,Wayforpay,4121,4121,-3000,-3000,980,0,0,954469,False,4575-PT6X-A80B-X74X
HBAWR1rjASSOJw,1533227727,Steam,5816,5816,-7500,-7500,980,0,0,957469,False,1XCB-7B9T-3HE4-M1CT
df47GjaxACOYcA,1533210506,Kolo25KLS5LCOLHS00,5499,5499,-6000,-6000,980,0,120,964969,False,3C2X-MEC9-EBC9-KH46
AetDsMLPzBH4uQ,1533210187,KAFE BLUE CUP,5812,5812,-7800,-7800,980,0,0,970969,False,8712-99A1-675E-8ETM
hibnDfwjrGhlqw,1533208225,Salateira,5814,5814,-19801,-19801,980,0,0,978769,False,2BB8-3T56-7BX5-160C
4ftw_pbNGtko_w,1533192436,YAROSLAVA,5814,5814,-2600,-2600,980,0,0,998570,False,E663-P72M-KXT6-9MXC
H6AQSzTCzqT1mg,1533154152,Lesya,4829,4829,-550000,-550000,980,0,0,1001170,True,96PP-M078-B330-4216
jhS1zyzfxH5EAg,1533154078,–°–≤—ñ—Ç–ª–æ,4900,4900,-14010,-14010,980,0,0,1551170,True,6X1H-E325-2TTB-16E0
jJRDbgoX5uYzBA,1533154078,–ì–∞–∑,4900,4900,-100,-100,980,0,0,1565180,True,PXCB-H206-55CT-1758
cPYx5bt6MmG4vA,1533147060,–°—ñ–ª—å–ø–æ,5411,5411,-35408,-35408,980,0,708,1565280,False,E5X5-98CX-PKA9-05PH
5747YNXJuIRCoA,1533143664,33477,5912,5912,-17780,-17780,980,0,0,1600688,False,M8K0-4BM0-4C0M-X6A4
5aLG_Q7K7d5sPg,1533140957,Lesya,—Ñ–æ—Ä –∑—ç –ø–æ—è—Å,4829,4829,-50000,-50000,980,0,0,1618468,True,CPT8-BA09-617H-XEC0
JMWvGusWt9-T2g,1533133522,–í—ñ–¥—Å–æ—Ç–∫–∏ –∑–∞ –ª–∏–ø–µ–Ω—å,4829,4829,49,49,980,0,0,1668468,True
AL-WH93AK6MdqA,1533131852,–í—ñ–¥: –û–ª–µ–∫—Å–∞–Ω–¥—Ä–∞ –õ–∞–≤—â–µ–Ω–∫–æ,–∑–∞ –º–æ—Ä–æ–∂–µ–Ω–∫—É üç¶,4829,4829,2400,2400,980,0,0,1668419,True
xNl9hzY2pb6gGg,1533131076,–í—ñ–¥: –ù–∞–¥—ñ—è –©–∏–≥–æ–ª—å,"üëãüèº–æ—Ç –û–ª–µ—Å–∏, –∑–∞ –º–∏–∫—Ä–æ–≥—Ä–∞–º–º –∫–æ–∫–∞–∏–Ω–∞",4829,4829,5700,5700,980,0,0,1666019,True
dMoZO0WVtIBmGA,1533131072,–ü—Ä–∏–≤–∞—Ç24,6536,6536,6400,6400,980,0,0,1660319,False
_AmvwpWnIJR2BQ,1533130857,COFFEEDOOR,5812,5812,-19500,-19500,980,0,0,1653919,False,15AC-1THA-BHBP-94KH
eQytc1n8iK9VlA,1533124155,–ù–∞–¥—ñ—è –©–∏–≥–æ–ª—å,–æ—Ç –õ–µ—Å–∏,4829,4829,-58000,-58000,980,0,0,1673419,True,972B-A7K7-1H8T-P5P5
uMYTD7DajGoK1A,1533123311,–íi–¥: –ü–†–ò–•–û–î–¨–ö–û –ï.–í. –§–û–ü,4829,4829,2000000,2000000,980,0,0,2031419,True
eEEKBo6ADgfCgw,1533114468,–í–∏–≤–µ–¥–µ–Ω–Ω—è –∫–µ—à–±–µ–∫—É 306.59‚Ç¥,4829,4829,24680,24680,980,0,0,31419,True
Lh2KFMeXixzSqA,1533113729,MAGAZYN PRODUKTY 4,5411,5411,-2100,-2100,980,0,0,6739,False,064T-6XXX-KEM0-9MB4
QHRjSD3Te46JZg,1533081349,Uber,4121,4121,-9397,-9397,980,0,0,8839,False,EA5T-PT3M-6A6T-T8PX
FJxbTZalSgWFLg,1538235951,–í–µ–ª–º–∞—Ä—Ç,5499,5499,-8000,-8000,980,0,0,1726521,False,0P94-M31X-EEP8-A2T0
ruttCxxH1_t5Dg,1538235828,–í–µ–ª–º–∞—Ä—Ç,5499,5499,-15484,-15484,980,0,0,1734521,False,3XKT-4AAK-M91T-9T85
UL24ER9DjGDNsw,1538235393,JYSK,5712,5712,-134000,-134000,980,0,0,1750005,False,PT1K-PM56-0A1T-4B9E
HR31nKTdZFCG8Q,1538200849,–í–∏–ø–ª–∞—Ç–∞ –ø—Ä–æ—Ü–µ–Ω—Ç—ñ–≤,4829,4829,4352,4352,980,0,0,1884005,True
inP3LC1aymvM0A,1538118091,–°–∫–∞—Å—É–≤–∞–Ω–Ω—è. Google,7399,7399,600,600,980,0,0,1879653,True
k9NCfrSdS-f_0A,1538117212,portmone.com.ua,4814,4814,-5000,-5000,980,0,0,1879053,False,EP5P-6TPA-8AK6-4ETB
lXPAtrFUfkYHTA,1538117189,Google,7399,7399,-600,-600,980,0,0,1884053,True
OvPmwmpSTUePog,1538089072,–°–∫–∞—Å—É–≤–∞–Ω–Ω—è. Google,7399,7399,600,600,980,0,0,1884653,True
pTMLGU3-NoXgCQ,1538088188,portmone.com.ua,4814,4814,-11000,-11000,980,0,0,1884053,False,0295-E958-1B2M-6264
9HAfNBdUcz-3Jw,1538088169,Google,7399,7399,-600,-600,980,0,0,1895053,True
dc_dD9jK-m-ZNQ,1538070830,Lesya,4829,4829,-300000,-300000,980,0,0,1895653,True,948C-80CP-ATX8-55AB
xHy4LvynYrrlmw,1538049334,CafeBlueCup,5814,5814,-11700,-11700,980,0,0,2195653,False,M93M-E4HE-MXCX-625P
1uWIyq2pn_JbZQ,1537988812,Taxi,4121,4121,-10300,-10300,980,0,0,2207353,False,M21K-EEPH-X9H7-2AP5
saIRmRn2GcL3UQ,1537980725,Uklon,4121,4121,-16400,-16400,980,0,0,2217653,False,6XM8-CM28-5B1T-345A
U7i6ZUW-rwANSw,1537968498,LIQPAY*FOP Hizhnyak N.,4215,4215,-104676,-104676,980,0,0,2234053,False,B54M-E90M-29T1-BA9A
UkA4jcCM7Se7Tg,1537963359,STEYKHAUS,5812,5812,-8800,-8800,980,0,0,2338729,False,7BBP-272C-19KM-9H81
gWHJ4UijxVMg4g,1537876222,PRODUKTI,5499,5499,-4800,-4800,980,0,0,2347529,False,9158-K767-1HB7-MT2T
LxfAuLtFV0L6XA,1537857634,Lesya,4829,4829,-800000,-800000,980,0,0,2352329,True,C5EA-255K-PXXT-55M3
ZCVMeRbhYLJcBA,1537856887,–íi–¥: –ü–†–ò–•–û–î–¨–ö–û –ï.–í. –§–û–ü,4829,4829,3000000,3000000,980,0,0,3302329,True
F2fdr1n8i4iyexXzLdvF9iE,1537741959,–°–∫–∞—Å—É–≤–∞–Ω–Ω—è. Amazon,5942,5942,2816,100,840,0,0,302329,True
SPd4iV2kga-fxg,1537690559,MISA 01,5812,5812,-7631,-990,985,0,0,299513,False,18C9-AC8A-APA4-2T05
t0v_7m2h1r7scQ,1537480859,Lesya,4829,4829,-160000,-160000,980,0,0,307144,True,PB68-1P9E-5CHB-9M72
1AyCZKX0LYJb4Q,1537336827,–í–∏–ø–ª–∞—Ç–∞ –ø—Ä–æ—Ü–µ–Ω—Ç—ñ–≤,4829,4829,1026,1026,980,0,0,467144,True
763CU_s7bgPupg,1537308019,EILEENSSPECIALCHEESECA,5812,5812,-35298,-1250,840,0,0,466118,False,THM4-X1BH-H8B5-M4M0
TAai5K83rat5Vg,1537234960,–í–∏–≤–µ–¥–µ–Ω–Ω—è –∫–µ—à–±–µ–∫—É 500.00‚Ç¥,4829,4829,40250,40250,980,0,0,501416,True
O1fRNFsoouHdoQ,1537233532,SHAKE SHACK - 1148,5814,5814,-42329,-1499,840,0,0,461166,False,0917-5M2C-CCM7-A262
5qYAz3NlK1hE8dtoOG0d,1537225019,"Cienfuegos, 95 Avenue A, New York, US",5812,5812,-207579,-7351,840,0,4672,-72294,True
UumsUi5hamUP5Rek5w,1537225019,"SQU*SQ *DEVOCION ¬¶ WIL, 66 North 7th Street, Brooklyn, US",5812,5812,-34112,-1208,840,0,1023,135285,True
AGrojYUqApodjkHbaw,1537225019,"SQU*SQ *LITTLE CHOC AP, 347 Union Avenue, Brooklyn, US",5499,5499,-162483,-5754,840,0,3249,169397,True
HcrcjCPZHlI52qgz44X_u6M,1537225019,–°–∫–∞—Å—É–≤–∞–Ω–Ω—è. TST* JULIANA'S P,5812,5812,234311,8274,840,0,-7029,403708,True
jlVZnVkG-4IS81xO4DCyja4,1537225019,–°–∫–∞—Å—É–≤–∞–Ω–Ω—è. SQ *DEVOCION ? WILLIAM,5812,5812,29735,1050,840,0,-892,199132,True
eiOR8pJVG51ueBlY,1537225019,"TST* JULIANA'S PIZZA, 19 OLD FULTON ST, BROOKLYN, US",5812,5812,-272273,-9642,840,0,8168,331880,True
NeNXM_p-e9p8bvoaC8FFzzM,1537225019,–°–∫–∞—Å—É–≤–∞–Ω–Ω—è. SQ *LITTLE CHOC APOTHE,5499,5499,140292,4954,840,0,-2805,472172,True
z_dFU6Tkwxytr2c-bDg-_ZU,1537225019,–°–∫–∞—Å—É–≤–∞–Ω–Ω—è. CIENFUEGOS,5812,5812,174190,6151,840,0,-5225,506070,True
KAjxupflI-s2VFALCIUEkmI,1537225019,–°–∫–∞—Å—É–≤–∞–Ω–Ω—è. SQ *SCARRS PIZZA,5812,5812,29735,1050,840,0,-892,-75033,True
W30QlLca_wrHs4s-tQ,1537225019,"SQU*SQ *SCARRS PIZZA, 123 Essex Street, New York, US",5812,5812,-32474,-1150,840,0,0,-104768,True
Vh6-_PVC9vTeOg,1537148761,TST* JULIANA'S P,5812,5812,-234311,-8274,840,0,7029,604153,False
Qk083DgtlOqK3g,1537141750,MTA MVM VENDING MACHIN,4111,4111,-93453,-3300,840,0,0,838464,False,BB3B-CA5K-MHM4-7MC6
mtKaYH4f09Zq2g,1537130746,MTA MVM VENDING MACHIN,4111,4111,-8496,-300,840,0,0,931917,False,289C-2876-677K-7X37
tRYD2gtF4WJMog,1537119438,SQ *DEVOCION ? WILLIAM,5812,5812,-29735,-1050,840,0,892,940413,False
ctAzQzHoN9spBw,1537117071,SQ *LITTLE CHOC APOTHE,5499,5499,-140292,-4954,840,0,2805,970148,False
vYVi4YeOsOKwww,1537053436,CIENFUEGOS,5812,5812,-174190,-6151,840,0,5225,1110440,False
mTYYy_s-BmdxFlFZkGlKO64,1537051297,–°–∫–∞—Å—É–≤–∞–Ω–Ω—è. SUMNER CAFE,5812,5812,191370,6777,840,0,-5741,1284630,True
21rYC6H5EyqPmJJEPA,1537051297,"Sumner Cafe, 144 Decatur St., Brooklyn, US",5812,5812,-220237,-7777,840,0,6607,1093260,True
JkeESBMUUMFGFQ,1537047431,SQ *SCARRS PIZZA,5812,5812,-29735,-1050,840,0,892,1313497,False
u-W9b0Grz3ym2w,1536967990,Lesya,4829,4829,-700000,-700000,980,0,0,1343232,True,H030-X598-CHHE-49C2
CaiOgnGCl7FhHA,1536954098,Pret a Manger,5814,5814,-52588,-1857,840,0,1577,2043232,False,H4PH-MT99-8PKT-XA9T
TxWy3bqihAfWQQ,1536939500,Starbucks,5814,5814,-22202,-784,840,0,666,2095820,False,C5X7-3K36-2XC9-3AM2
bGw7rrV_Z36rYA,1536895162,BARCELONA DELI AND GRO,5499,5499,-28238,-1000,840,0,564,2118022,False,M3A5-3M75-8791-3496
AFlt5Mb3Y1CU7A,1536888558,SQ *IL LABORATORIO DEL,5814,5814,-16237,-575,840,0,487,2146260,False,6981-B1A8-H2C2-MXPX
m7HxqwEnUL5lGBZBevrUcPk,1536880557,–°–∫–∞—Å—É–≤–∞–Ω–Ω—è. TOP HOPS BEER SHOP,5812,5812,26826,950,840,0,-804,2162497,True
GsVIcLL7Ueu-jMD0f-s,1536880557,"TOP HOPS BEER SHOP, 94 ORCHARD STREET, NEW YORK, US",5812,5812,-31062,-1100,840,0,931,2135671,True
B612QaPHL96hiQ,1536870768,–ì–∞–∑,4900,4900,-2296,-2296,980,0,0,2166733,True,374M-0H45-67T6-21K2
lDorH9Lo0QFcow,1536870767,–ö–≤–∞—Ä—Ç–ø–ª–∞—Ç–∞,4900,4900,-12120,-12120,980,0,0,2169029,True,7EK2-T398-65PK-649C
lroIFvfKiWguSQ,1536870766,–ì–∞—Ä—è—á–∞ –≤–æ–¥–∞,4900,4900,-17308,-17308,980,0,0,2181149,True,B6H8-H57B-8B28-3P9P
VntpDR_NzDglfg,1536870766,–•–æ–ª–æ–¥–Ω–∞ –≤–æ–¥–∞,4900,4900,-18387,-18387,980,0,0,2198457,True,7ATK-A359-AMAK-8E32
BDtqI37arNDQ-g,1536870765,–°–≤—ñ—Ç–ª–æ,4900,4900,-11352,-11352,980,0,0,2216844,True,32CH-6KXH-1EBC-AEC1
Brvq2HA_ooii8A,1536870764,–ì–∞—Ä—è—á–∞ –≤–æ–¥–∞,4900,4900,-1843,-1843,980,0,0,2228196,True,84TB-125X-9E9B-0810
Mf-kwH_Le-pqWw,1536870764,–í–∏–≤—ñ–∑ —Å–º—ñ—Ç—Ç—è,4900,4900,-2309,-2309,980,0,0,2230039,True,8599-8HXB-356H-206X
lWeVyyz-CCx3Pw,1536861845,TST* DOUGHNUT PL,5812,5812,-11295,-400,840,0,338,2232348,False,T488-T5H3-5A2X-B827
yHX3ho-kQvZP3A,1536861508,TST* DOUGHNUT PL,5812,5812,-22026,-780,840,0,660,2243643,False,1023-P08X-17KE-CTE7
Ht1m1M6f0JS3GQ,1536849925,SUMNER CAFE,5812,5812,-191370,-6777,840,0,5741,2265669,False
f1Pdar3KH7VP7HMDLbFP-04,1536793767,–°–∫–∞—Å—É–≤–∞–Ω–Ω—è. SQ *MORGENSTERN'S FINE,5812,5812,29198,1034,840,0,-875,2459855,True
DceT7cuKVdrzloOr,1536793767,"SQ *SQ *MORGENSTERN'S, 60 Spring Street, New York, US",5812,5812,-32016,-1137,840,0,960,2430657,True
mnNNv6VtHA_XHg,1536792731,Amazon,5942,5942,-2816,-100,840,0,0,2459857,False
Gzohl_gQBcnafg,1536775558,Starbucks,5814,5814,-9039,-321,840,0,271,2462673,False,3156-H3M4-47B9-MEP3
WatFcybo06cbNg,1536767015,Starbucks,5814,5814,-20246,-719,840,0,607,2471712,False,1AXC-CM2B-B11E-5PA2
t6sDOzEJ0mj8qg,1536716122,Lesya,4829,4829,-200000,-200000,980,0,0,2491958,True,KC15-5C0H-5P0K-81H1
EjuxLnEOG1k0Lw,1536708539,TOP HOPS BEER SHOP,5812,5812,-26826,-950,840,0,804,2691958,False
ycuKrocl-mosIQ,1536706725,SQ *MORGENSTERN'S FINE,5812,5812,-29198,-1034,840,0,875,2718784,False
yITsCGPOIl8RXg,1536705161,SQ *SCARRS PIZZA,5812,5812,-29650,-1050,840,0,889,2747982,False,49HE-4687-AC0C-3KPE
7HUmXDn1StIGMQ,1536701513,NYC FERRY DUMBO PIER 1,4111,4111,-15531,-550,840,0,0,2777632,False,0166-CT11-9AH3-KTBC
f_OGenyAkhJ5Vw,1536691577,DUNKIN #350503 Q35,5814,5814,-24087,-853,840,0,722,2793163,False,XMXC-33H7-BXP0-CA2E
M5q1TRx_GL_C0_WaM2e3fWg,1536619857,–°–∫–∞—Å—É–≤–∞–Ω–Ω—è. Bunny,5812,5812,170056,5988,840,0,-5101,2817250,True
oB1qoynb_LPFfouqDEk,1536619857,"BUNNY, 449 NOSTRAND AVE, BROOKLYN, US",5812,5812,-189397,-6688,840,0,5681,2647194,True
UOonnEayRt__iw,1536617567,7-ELEVEN 36979,5541,5541,-6457,-228,840,0,0,2836591,False,C5H4-023B-0BPX-M17M
r75NIPGNe0OTyw,1536616771,TST* DOUGHNUT PL,5812,5812,-29593,-1045,840,0,887,2843048,False,X87P-71MH-1T2P-8HB0
YISuvBnluw7c0w,1536533336,TRADER JOE'S # 540,5411,5411,-42372,-1492,840,0,847,2872641,False,6ACM-4EX1-XM93-0199
5IRPRoKq97qsYg,1536512486,CHIPOTLE 2168,5814,5814,-80228,-2825,840,0,2406,2915013,False,PC1C-AC95-EPPE-TTK5
UJ-ydLzz8q-arw,1536503199,SQ *THIRD RAIL COFFEE,5499,5499,-10650,-375,840,0,213,2995241,False,A879-2M17-211K-7HX8
Ws7KwdovdggyYw,1536499708,MTA MVM VENDING MACHIN,4111,4111,-93718,-3300,840,0,0,3005891,False,358B-XXEP-6CHK-KBP9
W3hnAAyQfw8vtA,1536499645,MTA MVM VENDING MACHIN,4111,4111,-90878,-3200,840,0,0,3099609,False,EC63-07A1-2TKK-E4CM
wYOajvPWXQoNjQ,1536453204,Bunny,5812,5812,-170056,-5988,840,0,5101,3190487,False
BHOERdbD4VNB-Q,1536439721,MTA MVM VENDING MACHIN,4111,4111,-15620,-550,840,0,0,3360543,False,2271-5085-494K-19K9
zA9t_oFL7oN3Lg,1536439002,METROCARD VALUE @ AIRT,4111,4111,-14200,-500,840,0,0,3376163,False,994H-2162-P203-14KE
gIT074s8aJkdDg,1536397070,AUTOMAT 1,5814,5814,-3806,-500,985,0,114,3390363,False,152M-6PTA-K499-P74X
fDVzQAMR9_DIYg,1536381543,WOG Cafe MEDOVA,5814,5814,-12500,-12500,980,0,375,3394169,False,EPTE-A2K5-HKT4-M5HP
5kJFqloMpR_pJQ,1536342223,Doggeriz752I4GSJWGKX6A,5812,5812,-10000,-10000,980,0,300,3406669,False,T098-83K2-E097-095M
h8yqdZ6-8biIqQ,1536342102,BarrestoranDoggeris,5812,5812,-20300,-20300,980,0,609,3416669,False,3PPK-5EK1-364B-EMBT
DvE5RvrXRazpeA,1536307998,SWEET FRESH,5812,5812,-63400,-63400,980,0,1902,3436969,False,6PBE-HXX5-HMPH-BH7E
AttgpY9al3PDUA,1536229313,–íi–¥: –ü–†–ò–•–û–î–¨–ö–û –ï.–í. –§–û–ü,4829,4829,3000000,3000000,980,0,0,3500369,True
ev9B7hIHqeAQTQ,1536216143,KonditerskajaLyafabrik,5441,5441,-20000,-20000,980,0,400,500369,False,733A-HE89-1H51-K0XH
Vt62q7geoN3R7A,1536172430,restoranCHICHIKO1,5812,5812,-41802,-41802,980,0,1254,520369,False,APK8-7PX0-CP9X-92X2
_GRn1evlNpfh_w,1536138938,–ê–¢–ë,5411,5411,-7750,-7750,980,0,155,562171,False,58EA-91X3-8M6E-E917
EapuwXh2mXl_Og,1536132806,YAROSLAVA,5814,5814,-2600,-2600,980,0,78,569921,False,KB86-BAEA-T738-6KPA
5tUxEX_qz27e6A,1536050214,YAROSLAVA,5814,5814,-1300,-1300,980,0,39,572521,False,5B43-58MT-MM2P-3EE6
51UptFm2QI5c9A,1536049859,Kosk1313QDWZFACRG0,5993,5993,-20000,-20000,980,0,0,573821,False,4ECM-4TPE-8P00-6A28
aHkZzajAZPOhgQ,1536040869,–í–∏–ø–ª–∞—Ç–∞ –ø—Ä–æ—Ü–µ–Ω—Ç—ñ–≤,4829,4829,2297,2297,980,0,0,593821,True
QMIN-uorHhoI8w,1536005488,Steam,7994,7994,-4400,-4400,980,0,0,591524,False,E8BA-91BB-5A76-1E92
azaF9O4OsVaqIA,1535993590,BeerMarket,5921,5921,-7898,-7898,980,0,157,595924,False,8M7C-MX2C-TKT7-739M
qzLY332_WjSATQ,1535993250,Billa,5411,5411,-25197,-25197,980,0,503,603822,False,4787-96H2-9K26-AEX4
beVHv725XRNpaw,1535971771,Lesya,4829,4829,-400000,-400000,980,0,0,629019,True,T587-1BPP-0ECE-0A11
3IZatKleWIi8jw,1535971600,–íi–¥: –ü–†–ò–•–û–î–¨–ö–û –ï.–í. –§–û–ü,4829,4829,1100000,1100000,980,0,0,1179019,True
6n0O7JpudS-8dg,1535956116,Produktova Lavka,5499,5499,-3500,-3500,980,0,70,79019,False,9756-6PE3-4P13-K95P
Ar_NhLCfqCVseg,1535955794,–ö–∏—ó–≤—Å—å–∫–∏–π –º–µ—Ç—Ä–æ–ø–æ–ªi—Ç–µ–Ω,4111,4111,-800,-800,980,0,0,82519,False,86KC-5713-B0CK-H88T
b6zTdcxnwguvSg,1535955113,YAROSLAVA,5814,5814,-5400,-5400,980,0,162,83319,False,79KP-61C4-56C5-BCP1
_7b30N81FEyVYQ,1535951430,AptekaDS5425NF67BMDATU,5912,5912,-3094,-3094,980,0,0,88719,False,48PB-82X4-TC20-P19H
Gdsb5s4ncE59Rg,1535912523,Kosk1313QDWZFACRG0,5993,5993,-7600,-7600,980,0,0,91813,False,BP5B-3BH8-X631-95P1
4CA3OJsiPIjkJw,1535911942,PRODUKTOVAJALAVKA753JU,5411,5411,-11200,-11200,980,0,224,99413,False,1E1A-BPB0-3T12-3385
evM0mJXsnwmuug,1535908490,PYVNA DUMA,5813,5813,-6500,-6500,980,0,195,110613,False,0AM6-XM3K-E80X-T0K4
HF4L3eMMGxQ8yA,1535907095,ONE LOVE coffee,5814,5814,-6000,-6000,980,0,180,117113,False,062E-CTA4-TTTP-7E48
IXjKv7cQuSF0TQ,1535906970,KAFE-KONDITERSKA PICNI,5812,5812,-9000,-9000,980,0,270,123113,False,H8KB-122P-AATK-B7X2
Bp6G9w2IF1sfhQ,1535906638,Egersund Seafood,5411,5411,-29412,-29412,980,0,588,132113,False,6B54-A933-A7B2-KX48
WkXtMJUi9ihFMA,1535800496,–í—ñ–¥—Å–æ—Ç–∫–∏ –∑–∞ —Å–µ—Ä–ø–µ–Ω—å,4829,4829,228,228,980,0,0,161525,True
fNPjOW_zxPtDLQ,1535794705,–í–∏–≤–µ–¥–µ–Ω–Ω—è –∫–µ—à–±–µ–∫—É 307.18‚Ç¥,4829,4829,24727,24727,980,0,0,161297,True
nZfXIKTgBgtmSg,1535791418,–§–æ—Ä–∞,5499,5499,-10313,-10313,980,0,0,136570,False,HC81-BH77-H235-AC3P
xR7nivTHVoafc4E,1540921178,MAGAZYN PRODUKTY 4,5411,5411,-2100,-2100,980,0,0,608518,False,PC4C-3BH8-C6CP-0KMT
kyNLjyjYHXjvkb0,1540893989,Steam,5816,5816,-22600,-22600,980,0,0,610618,False,CT67-TBC8-9E3T-EAA9
im-Eb1-ERQYhW0w,1540835380,Cosmo,5977,5977,-2060,-2060,980,0,0,633218,False,47X1-PBB9-3C8P-2K3A
dT9CdVbn5KB2hAY,1540831219,Wayforpay,4121,4121,-7800,-7800,980,0,0,635278,False,1152-5XE6-9M65-75TE
AlBcnUJWz_uLKKo,1540818199,McDonald's,5814,5814,-9700,-9700,980,0,0,643078,False,48K5-K6EB-7PK1-8MMP
4_UNoeGTQaAwMaw,1540797214,Wayforpay,4121,4121,-8400,-8400,980,0,0,652778,False,341C-3E88-7K60-0H0C
pGXm0sOWR4i_kaI,1540796444,–í–∏–ø–ª–∞—Ç–∞ –ø—Ä–æ—Ü–µ–Ω—Ç—ñ–≤,4829,4829,4214,4214,980,0,0,661178,True
T_j_bxwVB6d2SxI,1540731053,BeerMarket,5921,5921,-2799,-2799,980,0,0,656964,False,1CB4-HHCT-8XBX-EK48
cFhjiCgLycg9vCQ,1540730951,MolokovidPHermera,5451,5451,-11625,-11625,980,0,0,659763,False,T573-0T62-E2T3-MH6C
h1xpIEKCC4leu9A,1540651895,Billa,5411,5411,-21387,-21387,980,0,0,671388,False,6KCT-0661-7EC1-B472
-lYO_Tx6hY0tv8o,1540572878,SWEET FRESH,5812,5812,-14000,-14000,980,0,0,692775,False,4M33-BC2E-B7CM-CEP0
IWOTlS_BkeWhwsI,1540572704,MIRA KAFE,5814,5814,-10900,-10900,980,0,0,706775,False,C217-01C5-TKT9-0068
fVLf2swxzRqjgqo,1540572489,MAGAZYN PRODUKTY 4,5411,5411,-2100,-2100,980,0,0,717675,False,METT-EX53-HE2A-A420
lPqRo4C4Qp2hRoE,1540549337,–íi–¥: –ü–†–ò–•–û–î–¨–ö–û –ï.–í. –§–û–ü,4829,4829,800000,800000,980,0,0,1019775,True
6ffOI7cojLOfJRQ,1540536449,–°–∫–∞—Å—É–≤–∞–Ω–Ω—è. Google,7399,7399,600,600,980,0,0,219775,True
gn1rmUb8gkxryIw,1540535571,portmone.com.ua,4814,4814,-14700,-14700,980,0,0,219175,False,H7PK-3A25-K710-TXA4
JNvfJ5fJrEtLuIE,1540535540,Google,7399,7399,-600,-600,980,0,0,233875,True
nI80HNe3I1mQtNk,1540458544,Taxi,4121,4121,-10500,-10500,980,0,0,234475,False,73EM-E49E-3509-M6X4
PXLsbObncwwsET0,1540453069,FOP Pindzina L V 2,5992,5992,-17500,-17500,980,0,0,244975,False,HM53-4916-899K-MH95
D5YTGY6jGRtFN8c,1540388310,POW HOSPITALITY,7922,7922,-516312,-14000,826,0,0,262475,False,A211-8789-53B7-3E4H
2weEET3BfQvQDCY,1540388223,DELFONT MACKINTOSH THE,7922,7922,-1106423,-30000,826,0,0,778787,False,1T84-K55E-TC1H-2H48
RfOmNw84WAQbrxI,1540386059,–ü—Ä–∏–≤–∞—Ç24,6536,6536,13000,13000,980,0,0,485210,False
2VZBPtFzpSafDOE,1540385803,–í—ñ–¥: –ú–∞–∫—Å–∏–º –§–µ—â–µ–Ω–∫–æ,–¥—è–∫—É—é),4829,4829,9500,9500,980,0,0,472210,True
gwFeAQWp6HobFi8,1540383976,MUSAFIR,5812,5812,-27100,-27100,980,0,0,462710,False,K36E-P26X-60TC-X23K
lvGh-WyZWlxXZtw,1540294594,Lesya,–Ω–∞ –±—É–ª–∫–∏ ü•ê,4829,4829,-130000,-130000,980,0,0,489810,True,PXXM-B78H-K7P2-M363
TykoErey_QEiKd0,1540236066,Il Molino,5814,5814,-25403,-25403,980,0,0,619810,False,BBPH-XMXC-6869-0KPH
4Ghrz3VgiUVxceY,1540211245,SWEET FRESH,5812,5812,-35000,-35000,980,0,0,645213,False,PH51-E5P5-8HX3-61KC
rqzfbbrff5yRm64,1540210832,Mira Cafe,5814,5814,-15300,-15300,980,0,0,680213,False,P7PK-B89C-9753-MMAT
0LwVVPGhaVUt6P0,1540135163,Epicenter,5211,5211,-13500,-13500,980,0,0,695513,False,H7E9-2945-7C9X-91M1
k_UFUtMyeKIJv0Y,1540127491,–ö–∏—ó–≤—Å—å–∫–∏–π –º–µ—Ç—Ä–æ–ø–æ–ªi—Ç–µ–Ω,4111,4111,-800,-800,980,0,0,709013,False,4A7A-7042-EH54-0H5K
5EgQ8NS4tpJ1ER4,1540062935,FOP  SOKOL VB,5812,5812,-34700,-34700,980,0,0,709813,False,HH3E-H3AE-HB8P-T9AX
Zy3gDhGP8PScx3k,1540050367,–°—ñ–ª—å–ø–æ,5411,5411,-24356,-24356,980,0,0,744513,False,KH92-819E-034H-2KCM
u37bhr_fro2ceEI,1540048225,PUB Floyd,5813,5813,-41800,-41800,980,0,0,768869,False,PC38-M9BK-EKK2-BA0B
-Gt56QCiKDXVNi8,1540035262,Wayforpay,4121,4121,-6400,-6400,980,0,0,810669,False,M8AB-72M1-C0A3-8205
wOAvGFRyNc3GOQc,1539952213,restoranChIChIKO1,5812,5812,-12800,-12800,980,0,0,817069,False,00AH-7515-TA7B-398X
n2BPZDrPIp-5H68,1539947140,Wayforpay,4121,4121,-6900,-6900,980,0,0,829869,False,45E9-P11A-6E2X-MXB0
aS5_ZYUmnCWNjqg,1539941445,Wayforpay,4121,4121,-15300,-15300,980,0,0,836769,False,0CT0-496H-MH3P-APT0
N-QFRgOgEKcF_v0,1539939572,CafeBlueCup,5814,5814,-7800,-7800,980,0,0,852069,False,BH5M-EA0K-8HM1-KP1P
r7EH7BNl0j_e6_c,1539936938,–í–∏–ø–ª–∞—Ç–∞ –¥–µ–ø–æ–∑–∏—Ç—É,4829,4829,100000,100000,980,0,0,959869,True
swNCf7YvlvAu4sA,1539936792,–í–∏–≤–µ–¥–µ–Ω–Ω—è –∫–µ—à–±–µ–∫—É 500.00‚Ç¥,4829,4829,40250,40250,980,0,0,859869,True
ZQnkTN7SaBff_rY,1539935310,Wayforpay,4121,4121,-14600,-14600,980,0,2874,819619,False,BEX3-3P40-5BPE-954M
9QthcOWNkPcU-6Q,1539930023,Wayforpay,4121,4121,-7400,-7400,980,0,1480,834219,False,7AM3-1CH2-0853-M58E
wwBtqv0DdqZ02mE,1539928812,–í–∏–ø–ª–∞—Ç–∞ –ø—Ä–æ—Ü–µ–Ω—Ç—ñ–≤,4829,4829,990,990,980,0,0,841619,True
F3J_a1sJjqCCoV4,1539884423,Wayforpay,4121,4121,-8000,-8000,980,0,1600,840629,False,HB02-8XH1-9057-MP93
oYsjVsi429nu87A,1539863683,FOP ARTYUKH GENNADIY,5812,5812,-67600,-67600,980,0,2028,848629,False,5M55-E3BT-9C8C-3MHB
NglRDUX5tgNiWlM,1539863650,KANAPE,5812,5812,-25600,-25600,980,0,768,916229,False,XHP2-3A1X-0C73-5XXT
CJT9C8EGBNgOew,1539846299,Wayforpay,4121,4121,-9400,-9400,980,0,1880,941829,False,0491-XHC2-H9M8-KHKB
yy5j9snJOGvasg,1539793956,Lesya,4829,4829,-600000,-600000,980,0,0,951229,True,0M7K-3K68-60PP-747C
gs5w4ZvIiKjYrw,1539778982,–ú–∞–∫—Å–∏–º –§–µ—â–µ–Ω–∫–æ,4829,4829,-4400,-4400,980,0,0,1751229,True,4HTM-82XX-CC58-B0TX
rDHCA4fddN4-7A,1539777723,–íi–¥: –ü–†–ò–•–û–î–¨–ö–û –ï.–í. –§–û–ü,4829,4829,1500000,1500000,980,0,0,1755629,True
nkzqOecNySXK1g,1539771329,–ê–ª–µ–∫—Å–µ–π –í—ã–∫–∞–ª—é–∫ BCD,—Ç—É–Ω–µ—Ü,4829,4829,-10400,-10400,980,400,0,255629,True,BX6A-0P34-64BH-XAH2
dCiUaRJzETBw6w,1539707073,restoranChIChIKO1,5812,5812,-31500,-31500,980,0,945,266029,False,965P-BCME-1KE6-5K21
-SKCpf6v3gE9Ow,1539706274,Wayforpay,4121,4121,-9300,-9300,980,0,1860,297529,False,H4KC-4KC5-P7H2-2AA7
6x8_iH_NmRbQfA,1539690253,McDonald's,5814,5814,-47500,-47500,980,0,1425,306829,False,XKP8-K7CT-8652-T047
9e5R8TN5Mrut9Q,1539619460,Wayforpay,4121,4121,-10100,-10100,980,0,2020,354329,False,C8KA-8H96-2327-1717
0FKG60em6sF3FA,1539587529,Billa,5411,5411,-17547,-17547,980,0,0,364429,False,M4ET-A3K5-H4B2-2CXP
98DZH6RMPg9m_w,1539587354,EVA,5977,5977,-6990,-6990,980,0,0,381976,False,76B0-X2AC-A3H3-KPC9
oVPzSO38bclyGQ,1539584969,Wayforpay,4121,4121,-6300,-6300,980,0,1260,388966,False,K13C-4BP0-2E75-T736
2OApRuLtqd-svw,1539504882,MolokovidPHermera,5451,5451,-17817,-17817,980,0,0,395266,False,K7CC-28TT-MM78-32C7
AErfm1FpxBtbtA,1539503880,Lesya,–Ω–∞ –±–µ–Ω–∑–∏–Ω ‚õΩ,4829,4829,-150000,-150000,980,0,0,413083,True,TC0B-5452-B6A1-7EM1
SNd33JoXalFS-w,1539442165,–•–æ–ª–æ–¥–Ω–∞ –≤–æ–¥–∞,4900,4900,-18387,-18387,980,0,0,563083,True,1C3M-PP72-E6KB-5M2A
jRYB9jPG5yiM8g,1539442164,–ì–∞—Ä—è—á–∞ –≤–æ–¥–∞,4900,4900,-2380,-2380,980,0,0,581470,True,9798-E642-B9PP-C0B3
ThebTAQyiq_8JA,1539442164,–ö–≤–∞—Ä—Ç–ø–ª–∞—Ç–∞,4900,4900,-12120,-12120,980,0,0,583850,True,A2C6-7KEA-2T16-1CP7
fRNPygBmsZN-vw,1539442164,–í–∏–≤—ñ–∑ —Å–º—ñ—Ç—Ç—è,4900,4900,-2601,-2601,980,0,0,595970,True,P9BA-BC2X-86C9-B543
6BJhS-2u3llAVQ,1539442163,–ì–∞–∑,4900,4900,-5402,-5402,980,0,0,598571,True,0T44-0XBT-THMA-744B
7RLXOWjRehGzEQ,1539442163,–ì–∞—Ä—è—á–∞ –≤–æ–¥–∞,4900,4900,-16394,-16394,980,0,0,603973,True,31T1-8363-17A3-7T7P
sJZlIAvLwFX7yQ,1539437198,BeerMarket,5921,5921,-7747,-7747,980,0,0,620367,False,AA9X-60B1-9K0H-65HH
JovrxyG3DyCqnA,1539374459,RESTAURANT KHMILNYY KN,5812,5812,-38000,-38000,980,0,1140,628114,False,09CH-626T-C26X-0P71
sWpFDeJiT1MDtg,1539374426,RESTORAN KHMILNYY KNYA,5812,5812,-78500,-78500,980,0,2355,666114,False,M897-1M23-08E3-2E0H
ri1ATbuBPHHkug,1539349973,MUSAFIR,5812,5812,-58000,-58000,980,0,1740,744614,False,730X-CHET-BMB5-93BT
1zukRFhHK6Wc8g,1539349829,–í—ñ–¥: –û–ª–µ–∫—Å—ñ–π –í–∏–∫–∞–ª—é–∫,–∑–∞ —Ö–æ—Ä–æ—à–∏–π –æ–±—ñ–¥ ü•ü,4829,4829,20000,20000,980,0,0,802614,True
H1d_o0p9OmvdkQ,1539280162,MAGAZYN PRODUKTY 4,5411,5411,-2100,-2100,980,0,0,782614,False,7XE9-9CAP-6A13-XK5M
k4ETqST-KCRUww,1539243619,Wayforpay,4121,4121,-6100,-6100,980,0,1220,784714,False,6B20-XC5M-X9M1-0TC4
Ke4mR9Ohno5MQg,1539237258,Lvivskikruasani,5462,5462,-8600,-8600,980,0,0,790814,False,EA33-6CT0-1MK4-C998
YS1gClsIJM2_zQ,1539197108,SWEET FRESH,5812,5812,-21000,-21000,980,0,630,799414,False,E6E9-4P0T-C0T5-06CT
S2gTRsjd_1n3kQ,1539195161,RESTAURANT KHMILNYY KN,5812,5812,-6000,-6000,980,0,180,820414,False,X8BB-A918-X09X-0B0H
jZktf0tm-weCag,1539195132,RESTORAN KHMILNYY KNYA,5812,5812,-37500,-37500,980,0,1125,826414,False,00HC-8046-11A2-B2AK
0iV-ra3HE3g7Ow,1539190149,Wayforpay,4121,4121,-9600,-9600,980,0,1920,863914,False,7941-H10E-CH82-2C6C
49bpdRYB66sZcg,1539152723,Wayforpay,4121,4121,-5900,-5900,980,0,1180,873514,False,MM8M-EME8-46C4-M04C
DWx3XTYubFq_Gg,1539089332,RESTAURANT KHMILNYY KN,5812,5812,-97000,-97000,980,0,2910,879414,False,TE32-P521-P734-A39E
Dj-lncA7qAmW6A,1539089302,RESTORAN KHMILNYY KNYA,5812,5812,-5500,-5500,980,0,165,976414,False,75P3-9331-07EH-X328
tH3AKD5XBqlZMw,1539089183,–í—ñ–¥: –í–ª–∞–¥–∏—Å–ª–∞–≤ –ß–æ—Ä–Ω–∏–π,–∫–Ω—è–∑—å,4829,4829,15000,15000,980,0,0,981914,True
x6oris5IHodkLw,1538996233,McDonald's,5814,5814,-17600,-17600,980,0,528,966914,False,924E-XA95-2P3H-TB6E
nayWs4A7puoq4g,1538988271,Lesya,4829,4829,-700000,-700000,980,0,0,1084514,True,KPEC-439K-X688-C5TA
per4Ot1gV1OsaQ,1538988188,–íi–¥: –ü–†–ò–•–û–î–¨–ö–û –ï.–í. –§–û–ü,4829,4829,1700000,1700000,980,0,0,1784514,True
zsbvBvZu9ANNzg,1538976475,Taxi,4121,4121,-1000,-1000,980,0,200,84514,False,49BC-263A-80TC-E2TX
N-isnjuPMF4Slg,1538933569,Mira Cafe,5814,5814,-5450,-5450,980,0,163,85514,False,7X32-PX82-6TAK-9KBX
PN08c-EUjE66lg,1538933112,Aroma Kava,5814,5814,-7800,-7800,980,0,234,90964,False,B5M8-0E51-T2PX-M714
j4M2-Vbk6al3wA,1538922068,Taxi,4121,4121,-10000,-10000,980,0,2000,98764,False,X9TE-92BE-K8K5-8KB0
1_Vy7CYVnWYfcw,1538913359,Wayforpay,4121,4121,-6500,-6500,980,0,1300,108764,False,XM97-AC8T-HB6B-PXH5
LW6oS3E0PGJCjQ,1538912171,–§–æ—Ä–∞,5499,5499,-8799,-8799,980,0,0,115264,False,7096-ABM1-HCCK-T0H4
IqUTKMzwuQZ9nA,1538903441,KonditerskajaLyafabrik,5441,5441,-15000,-15000,980,0,0,124063,False,PMEK-HPTB-5XC4-MHHM
-P0kfPwUMWNX0w,1538830664,Doggeriz,5812,5812,-6000,-6000,980,0,180,139063,False,A17H-EHC7-TKKA-TPKE
HihNW2IhfGVw8Q,1538830409,BarrestoranDoggeris,5812,5812,-24700,-24700,980,0,741,145063,False,42X5-48A0-MB8A-7K44
qL-LdZ-bDo49yg,1538817573,Steam,7994,7994,-2700,-2700,980,0,0,169763,False,C082-2A0T-3AMM-64CX
ihlU9kjSSCtSyg,1538776510,Ryan Air,3246,3246,-248681,-7587,978,0,0,172463,False,PMKE-X4PB-0A6B-4263
Xh6TLDVwe5lDeQ,1538774655,–°–∫–∞—Å—É–≤–∞–Ω–Ω—è. Google,7399,7399,600,600,980,0,0,71144,True
EZDmp2au5SUs6A,1538773749,Google,7399,7399,-600,-600,980,0,0,70544,True
VNDQqZJ_ltujTg,1538772716,UKVI,9399,9399,-357272,-10900,978,0,0,71144,False,7020-CH03-71H5-EX8K
6yOrD-sE_dmE4w,1538770329,UKVI,9399,9399,-357272,-10900,978,0,0,428416,False,2TXK-M81T-1XXH-P7X3
SqdUA7Sl6GLBYw,1538741672,restoran ChIChIKO,5812,5812,-6500,-6500,980,0,195,785688,False,A1B6-58X6-X46X-CET8
ipBAyoHo3PQekw,1538741639,restoranChIChIKO1,5812,5812,-110604,-110604,980,0,3318,792188,False,03CH-34B0-X44A-7P89
CNNGOymUZ59Uiw,1538736381,Lesya,—Ü—å–æ–º,4829,4829,-500000,-500000,980,0,0,902792,True,KXM7-CX6X-P1E8-57MX
xpxV0oFJOm0dLg,1538679155,Billa,5411,5411,-40978,-40978,980,0,0,1402792,False,P0X9-TX61-CAPH-HBAE
c7RWKvyY08tG7A,1538654822,–í—ñ–¥: –û–ª–µ–∫—Å—ñ–π –í–∏–∫–∞–ª—é–∫,—Ç—É—Ç –∑ —á–∞—î–º üí∞,4829,4829,26000,26000,980,0,0,1443770,True
ZpKt1aHNhppmuA,1538654782,RESTAURANT KHMILNYY KN,5812,5812,-88000,-88000,980,0,2640,1417770,False,CH5K-A844-4KHH-5810
xZKAUEmYv-XHNw,1538654749,RESTORAN KHMILNYY KNYA,5812,5812,-27000,-27000,980,0,810,1505770,False,M4E9-C2E4-TKPT-K1HM
zU2hqDj-AHIY3Q,1538639515,–ú–∞–∫—Å–∏–º –§–µ—â–µ–Ω–∫–æ,–º–∞–∫,4829,4829,-8800,-8800,980,0,0,1532770,True,HHXT-E8TP-41K7-738X
Q8zb2AtwF-r7CQ,1538632857,–í–∏–ø–ª–∞—Ç–∞ –ø—Ä–æ—Ü–µ–Ω—Ç—ñ–≤,4829,4829,2224,2224,980,0,0,1541570,True
JYwuYqpfXWR2cA,1538589525,Wayforpay,4121,4121,-7500,-7500,980,0,1500,1539346,False,7P6A-K506-47TP-0624
hsJ_x0H0tt3v4Q,1538587778,–°–∫–∞—Å—É–≤–∞–Ω–Ω—è. Wayforpay,4121,4121,100,100,980,0,-20,1546846,True
sJXg2LJ6U0k4pA,1538587776,Wayforpay,4121,4121,-100,-100,980,0,20,1546746,True
8eWe9K1up1ZSgw,1538585587,SWEET FRESH,5812,5812,-34500,-34500,980,0,1035,1546846,False,C58T-76TH-PE41-6K9B
nQLy1Tukbwzduw,1538547134,SWEET FRESH,5812,5812,-62700,-62700,980,0,1881,1581346,False,BB2H-43T2-T0C2-7P00
nQfqr73hsj2oZw,1538486289,–û–ª–µ–∫—Å—ñ–π –í–∏–∫–∞–ª—é–∫,—Ç—å–æ—Ç—è –ö–ª–∞—Ä–∞,4829,4829,-4000,-4000,980,0,0,1644046,True,XPXM-8KB3-A6A2-4T73
i5yYsNipZem5UA,1538414428,restoranChIChIKO1,5812,5812,-19000,-19000,980,0,570,1648046,False,5TCX-88AK-47PE-1011
AySJEm1BDPYnDw,1538386265,–í—ñ–¥—Å–æ—Ç–∫–∏ –∑–∞ –≤–µ—Ä–µ—Å–µ–Ω—å,4829,4829,6928,6928,980,0,0,1667046,True
bV2dJXWXGDUm7w,1538380073,McDonald's,5814,5814,-8800,-8800,980,0,0,1660118,False,7990-03A9-65H3-8590
7wVUt0uv1U8jpw,1538379023,–ö–∏—ó–≤—Å—å–∫–∏–π –º–µ—Ç—Ä–æ–ø–æ–ªi—Ç–µ–Ω,4111,4111,-800,-800,980,0,0,1668918,False,MKE3-H94H-BTMC-67EA
ETDYDLwpMQG9MBI,1543514921,TOV SHOKOLADNITZA,5812,5812,-24000,-24000,980,0,0,2018486,False,B62H-P547-0E94-EM8K
_HH-foh_5v9s8H4,1543506559,–ö–∏—ó–≤—Å—å–∫–∏–π –º–µ—Ç—Ä–æ–ø–æ–ªi—Ç–µ–Ω,4111,4111,-800,-800,980,0,0,2042486,False,PAH7-H21X-5803-1277
PXLsb-PjcwgtHz4,1543502848,–°–∫–∞—Å—É–≤–∞–Ω–Ω—è. Google,7399,7399,1000,1000,980,0,0,2043286,True
39jdggMm0T7pNd0,1543497604,Google,7399,7399,-1000,-1000,980,0,0,2042286,True
DDmDDQSYfoJIC2w,1543491302,APTECHN PUNKT 3,5912,5912,-4700,-4700,980,0,0,2043286,False,CAT1-0EKA-HK25-AB89
1szpX96ywAb5xro,1543484488,Amazon,7399,7399,-17129,-598,840,0,0,2047986,False,X5X3-44T8-K304-6X0X
VgPA6CQhPvbbJBk,1543477795,–í–∏–ø–ª–∞—Ç–∞ –¥–µ–ø–æ–∑–∏—Ç—É,4829,4829,398100,398100,980,0,0,2065115,True
V4_0WhQ2jJ3TLeA,1543474843,–í–∏–ø–ª–∞—Ç–∞ –ø—Ä–æ—Ü–µ–Ω—Ç—ñ–≤,4829,4829,4355,4355,980,0,0,1667015,True
9sLutfOlWBBhnD8,1543441748,Aroma Kava,5814,5814,-7800,-7800,980,0,0,1662660,False,EK2E-AX9K-51HT-TA0K
LdA-M3CJ7io8AwY,1543440775,–ö–∏—ó–≤—Å—å–∫–∏–π –º–µ—Ç—Ä–æ–ø–æ–ªi—Ç–µ–Ω,4111,4111,-800,-800,980,0,0,1670460,False,APK4-584T-482A-32CE
52V-h6EksymG7Rs,1543424000,Wayforpay,4121,4121,-7500,-7500,980,0,0,1671260,False,9T2B-X148-TH83-3K1P
sX8bFPTLn8DCKxE,1543408968,STEYKHAUS,5812,5812,-9500,-9500,980,0,0,1678760,False,T4TB-P463-E32P-7C03
B-iuIPe5JZ_1lVk,1543405550,Lesya,4829,4829,-1450000,-1450000,980,0,0,1888260,True,0740-MH8C-XAT7-8PE8
gpphaA2I95SbFio,1543405322,–íi–¥: –ü–†–ò–•–û–î–¨–ö–û –ï.–í. –§–û–ü,4829,4829,3000000,3000000,980,0,0,3338260,True
P8APocEO7t_9bR4,1543390567,Wayforpay,4121,4121,-6000,-6000,980,0,0,338260,False,6TK5-8XH9-MMT1-M912
rd_8iBmA-vZ71kc,1543342204,MAGAZYN PRODUKTY,5411,5411,-7350,-7350,980,0,0,344260,False,90K7-30CE-MAA4-B6M2
160mfNUd0BzHDgA,1543325088,STEYKHAUS,5812,5812,-12300,-12300,980,0,0,351610,False,H4KH-HB46-M37P-1HE7
P5C1Qtd2sDIGYRA,1543323043,Parking,7523,7523,-66385,-1800,826,0,0,363910,False,A6AC-2BHC-6190-KH58
okGLRnJuPAEFsbc,1543321518,aptechniypunkt 3,5912,5912,-8800,-8800,980,0,0,430295,False,BH9C-AAEP-8P8X-HT66
Mmj4qmHFmuMr0Og,1543320058,Glovo,4215,4215,-61150,-61150,980,0,0,439095,False,C05K-B829-9EA3-4595
t_-qvOh3oBEaEXQ,1543271443,–°–∫–∞—Å—É–≤–∞–Ω–Ω—è. Google,7399,7399,600,600,980,0,0,500245,True
3j8s_HLZBUnflxo,1543270578,SHOP.PZU.COM.UA,6300,6300,-33000,-33000,980,0,0,499645,False,9T1E-E09T-KAP4-6TH2
RDp6qWD5aqfRCMI,1543270537,Google,7399,7399,-600,-600,980,0,0,532645,True
0_oOnagM0cTIxwQ,1543258128,Mira Cafe,5814,5814,-8400,-8400,980,0,0,533245,False,AETM-T91A-B9E4-2E0C
9NRIRG-jQ8JkGJ8,1543236171,aptechniypunkt 3,5912,5912,-12200,-12200,980,0,0,541645,False,C413-0MPA-0AH9-7C4C
DCOhfkGF7eKvw1I,1543225554,–°–∫–∞—Å—É–≤–∞–Ω–Ω—è. Google,7399,7399,600,600,980,0,0,553845,True
-eqLFozZrNIVI7w,1543224708,–°–∫–∞—Å—É–≤–∞–Ω–Ω—è. Google,7399,7399,600,600,980,0,0,553245,True
JBPKkQ8o3K6tPV8,1543224675,portmone.com.ua,4814,4814,-15900,-15900,980,0,0,552645,False,T75H-4KC5-PA36-K8P1
tgJ2gu6Cu8dfl10,1543224652,Google,7399,7399,-600,-600,980,0,0,568545,True
iL68ZZuW0Gs5EeA,1543223806,Google,7399,7399,-600,-600,980,0,0,569145,True
05LFQqbqrbcTohs,1543172295,Roshen,5441,5441,-10501,-10501,980,0,0,569745,False,889E-T51H-23TM-E8MA
VrhY02jIXzS4isU,1543084678,Produkti,5499,5499,-12250,-12250,980,0,0,580246,False,C4CH-X9CH-83T2-E56K
XILihEv_VCMB0q8,1543067547,restoranChIChIKO1,5812,5812,-60202,-60202,980,0,0,592496,False,1AM7-P7B5-EH12-8X1T
VMBGOQ9kLaMuVtw,1543067512,restoran ChIChIKO,5812,5812,-13300,-13300,980,0,0,652698,False,K38B-A0A0-TB80-7XA6
VdZuG4Sn2bSgI9U,1542995213,LIQPAY*cipollino,5812,5812,-27400,-27400,980,0,0,665998,False,X0HH-P8C5-82E4-4X9H
0CK9-YU70kJhRMs,1542986817,LIQPAY*FOP Hizhnyak N.,4215,4215,-103697,-103697,980,0,0,693398,False,9845-7500-8BKX-KC3T
_oMEm7LXctquGIY,1542979926,STEYKHAUS,5812,5812,-9800,-9800,980,0,0,797095,False,5433-6MB0-1HXP-KP67
qPZJmeWHiTOaw20,1542968835,City24_C2C,6536,6536,19000,19000,980,0,0,806895,False
2FAen9LetUTFQ3A,1542963355,ASOS,5651,5651,-133285,-3720,826,0,1332,787895,False,MX7P-C2AT-H5KT-MCE8
2uzlWKZWoDwulGI,1542961324,Ryan Air,3246,3246,-54434,-1944,840,0,0,921180,False,PT8K-93C8-56AK-B764
odzmx7rUunPj5vI,1542913654,Epicenter,5211,5211,-100000,-100000,980,0,0,975614,False,7XCC-2XA2-BM6A-M5EP
95Mhs0pBhr4teX4,1542878455,Steam,7994,7994,-29700,-29700,980,0,0,1075614,False,4C02-TT98-987M-7M0P
CQtTgj78x_emgFg,1542820730,Wayforpay,4121,4121,-10700,-10700,980,0,0,1105314,False,0939-HCX1-KEMB-PKT9
k9DmysixH1CMuC4,1542816427,–í—ñ–¥: –û–ª–µ–∫—Å—ñ–π –í–∏–∫–∞–ª—é–∫,üçîüçî‚ú®,4829,4829,9500,9500,980,0,0,1116014,True
5p2fjXsEsLfsZcM,1542800382,Bistro bistro,5814,5814,-23000,-23000,980,0,0,1106514,False,T61E-PC5E-9MHM-2EC3
a2DVoduhiMDnvEE,1542740071,MIRA KAFE,5814,5814,-9900,-9900,980,0,0,1129514,False,6TM2-B27H-A8XC-01P3
QHpxYER7pOdLeqM,1542719844,McDonald's,5814,5814,-36300,-36300,980,0,0,1139414,False,C567-1E26-4A3H-3M17
NhYXUlsys69AxlU,1542630788,Lesya,4829,4829,-900000,-900000,980,0,0,1375714,True,TE12-P68T-225C-9PX5
M0xPpL8l7be-iT8,1542629567,–íi–¥: –ü–†–ò–•–û–î–¨–ö–û –ï.–í. –§–û–ü,4829,4829,2250000,2250000,980,0,0,2275714,True
e0tCBaPFTbPY7Wk,1542469712,–ö–∏—ó–≤—Å—å–∫–∏–π –º–µ—Ç—Ä–æ–ø–æ–ªi—Ç–µ–Ω,4111,4111,-800,-800,980,0,0,25714,False,KA9E-TTC5-7X8X-X8B9
6pW4ynhba8qr74k,1542469074,–°—ñ–ª—å–ø–æ,5411,5411,-34235,-34235,980,0,0,26514,False,A2X5-MBET-04BM-E14B
74MP-_Btk5aeArU,1542455359,SPRINGFIELD,5655,5655,-129900,-129900,980,0,1299,60749,False,C0BE-4318-C2A2-A37E
Xxnftx1sOXXUj7E,1542452385,KCAFE,5812,5812,-24100,-24100,980,0,0,90649,False,28PE-A0E1-AX2A-C669
RiIJ7UmZoFPKdxI,1542401103,Wayforpay,7832,7832,-16800,-16800,980,0,3192,114749,False,6CK7-C1M9-5H69-26T3
4vE8pxweFwXXFYo,1542395013,MAGAZYN PRODUKTY 4,5411,5411,-6700,-6700,980,0,0,131549,False,M9B5-CT5M-AH38-813T
blee2OG-TnejH78,1542376782,APTECHN PUNKT 3,5912,5912,-8880,-8880,980,0,0,138249,False,HHK4-480K-ATMT-KH46
yEgjhfBcVWAQRBw,1542301069,Wayforpay,4121,4121,-9000,-9000,980,0,0,147129,False,5BCK-54PM-2M7K-P4H7
qTROcr_FxuT4nco,1542289075,aptechniypunkt 3,5912,5912,-6200,-6200,980,0,0,156129,False,0KTB-TH83-7B65-X4M2
kRDcUvt2gHu2Ea0,1542221629,PICCOPIZZA,5814,5814,-18300,-18300,980,0,0,162329,False,2962-KKHM-724B-8KTX
iwrmpNnW6yzpgSQ,1542219206,MAGAZYN PRODUKTY 4,5411,5411,-4500,-4500,980,0,0,180629,False,28C3-X21H-H8A8-E839
5pZZ57OgGyYCCZw,1542205132,–°–∫–∞—Å—É–≤–∞–Ω–Ω—è. Google,7399,7399,600,600,980,0,0,185129,True
6HdNTEWJTIVcRCM,1542204429,–í–∏–≤—ñ–∑ —Å–º—ñ—Ç—Ç—è,4900,4900,-2601,-2601,980,0,0,184529,True,17HA-K053-0AB9-128E
K3aGAF2Rj0HL8ZM,1542204428,–ö–≤–∞—Ä—Ç–ø–ª–∞—Ç–∞,4900,4900,-12120,-12120,980,0,0,187130,True,4TX3-XE25-053A-AMPB
2fa1NKq_f9dVFK0,1542204428,–ì–∞–∑,4900,4900,-2686,-2686,980,0,0,199250,True,69P3-2B8X-H9B6-XETX
2Lb-V_z5LwHZtRc,1542204428,–•–æ–ª–æ–¥–Ω–∞ –≤–æ–¥–∞,4900,4900,-8274,-8274,980,0,0,201936,True,424K-B34C-K4KP-99HP
TbdtH_NiR5ORLzU,1542204427,–¢–µ–ø–ª–æ,4900,4900,-8169,-8169,980,0,0,210210,True,445E-K7KK-71EC-TTH1
efUtQuNHBiPnxh8,1542204427,–°–≤—ñ—Ç–ª–æ,4900,4900,-11352,-11352,980,0,0,218379,True,XEXK-P1B3-465P-MT01
HbRtbT-YUWi5flY,1542204426,–ì–∞—Ä—è—á–∞ –≤–æ–¥–∞,4900,4900,-18029,-18029,980,0,0,229731,True,PE70-0HMK-4M09-PX8M
KYEUYkIar-fpZJs,1542204336,LIQPAY*FOP Hizhnyak N.,4215,4215,-111754,-111754,980,0,0,247760,False,1MM7-C28B-KK1P-A63T
XdBiPervyD34M5k,1542204229,Google,7399,7399,-600,-600,980,0,0,359514,True
oNtgOLlSohu5Zgc,1542179959,KonditerskajaLyafabrik,5441,5441,-16500,-16500,980,0,0,360114,False,3B8B-73TT-TB30-C9B0
_zhDAQ5bP3VCnwY,1542112954,Florrum,5992,5992,-60000,-60000,980,0,0,376614,False,3004-PXA6-A5A4-5X66
NLiLaFC9rn0dVzc,1542108576,–í–ª–∞–¥–∏—Å–ª–∞–≤ –ß–æ—Ä–Ω–∏–π,–º–∞–∫,4829,4829,-9152,-9152,980,352,0,436614,True,0C1K-H18A-ECMT-C968
zyJcUdrJll7iOwo,1542056284,–í–µ–ª–∏–∫–∞ –ö–∏—à–µ–Ω—è,5411,5411,-19053,-19053,980,0,0,445766,False,7TT4-T826-6H3A-MXP0
slO6wecaqCWyNVM,1542011038,–°–∫–∞—Å—É–≤–∞–Ω–Ω—è. Wayforpay,4121,4121,7500,7500,980,0,0,464819,True
ctzugncU-ohLi0E,1542009190,Wayforpay,4121,4121,-7500,-7500,980,0,0,457319,True
YkBh44fXGKMLESg,1541877047,–§–æ—Ä–∞,5499,5499,-7184,-7184,980,0,0,464819,False,9P7K-4E27-3H97-EC40
CvHWDeHO77X3y7A,1541864995,Wayforpay,4121,4121,-5500,-5500,980,0,0,472003,False,2374-AK5H-EMK6-88H5
o7cbAyE7dUE_e_U,1541858174,Steam,7994,7994,-4200,-4200,980,0,0,477503,False,79A3-5KT9-EPX3-5X44
rw4Jb31ufWV3vpM,1541785624,APTECHN PUNKT 3,5912,5912,-41124,-41124,980,0,0,481703,False,1CTH-TXM9-9HAC-TA35
ftAUC1EpORFO1FM,1541769555,Wayforpay,4121,4121,-1000,-1000,980,0,0,522827,False,P643-XPM5-3A91-3C0T
TJ_nTUPdRgAJahk,1541758666,KonditerskajaLyafabrik,5441,5441,-14000,-14000,980,0,0,523827,False,TEM3-4A8X-H5HB-8HEH
vkl3MqPUD--xry0,1541758334,PRODUKTI (PEREMOGY),5411,5411,-2100,-2100,980,0,0,537827,False,A265-1861-71T7-EA39
JlmvjDdz5KVgADA,1541755282,Wayforpay,4121,4121,-9000,-9000,980,0,0,539927,False,3M0H-4K1B-A344-0E60
j_p-ItbtBSeNcH4,1541747596,Uber,4121,4121,-21083,-21083,980,0,0,548927,False,CPH5-90TB-7KCA-8ACP
7hqxd4NPmcXAFec,1541705222,Uber,4121,4121,-10807,-10807,980,0,0,570010,False,1041-0P81-5730-6377
O4PaaoubEFtwCrA,1541700423,PICCOPIZZA,5814,5814,-15900,-15900,980,0,0,580817,False,T303-HC76-H3PE-8KP2
F2-wPov2fqqOxks,1541700122,PRODUKTI (PEREMOGY),5411,5411,-7300,-7300,980,0,0,596717,False,K87C-570P-5EH4-BMK0
DSuG6jbdJ0X0MG4,1541690417,Uber,4121,4121,-10060,-10060,980,0,0,604017,False,HHT0-XC5E-X57X-EP9A
0usQZhBneCEdcLY,1541676301,MAGAZYN PRODUKTY,5411,5411,-3400,-3400,980,0,0,614077,False,5XP8-7P3X-721M-1AA8
VThF3QEEcRY1wmc,1541674363,Uber,4121,4121,-9062,-9062,980,0,0,617477,False,XM77-CPTA-2E55-61PE
3B5SjxY8NpBdig4,1541671693,KonditerskajaLyafabrik,5441,5441,-16000,-16000,980,0,0,626539,False,C3B2-1974-C82B-0P0E
Ta6LAzwe7kh6v4o,1541667748,APTEKA SAKSAGANSKOGO,5912,5912,-88320,-88320,980,0,0,642539,False,4B50-3TX7-EM14-4TX2
e8rmYyJ4LsFKvXo,1541658683,Uber,4121,4121,-9779,-9779,980,0,0,730859,False,BTAX-33M5-2X08-HAEC
VdzQ2eeon6A3fx8,1541613489,Uber,4121,4121,-11199,-11199,980,0,0,740638,False,97X1-X0ET-CTXE-THHC
ww1-TTMeLVdWQ6U,1541597572,YAROSLAVA,5814,5814,-5150,-5150,980,0,0,751837,False,A74M-C610-E1XH-A0KM
sWpNCudjQVcDta8,1541597128,MIRA KAFE,5814,5814,-20300,-20300,980,0,0,756987,False,CX53-07AE-9614-T5P2
IZRutawbk0_CZ_I,1541596708,MAGAZYN PRODUKTY 4,5411,5411,-2100,-2100,980,0,0,777287,False,BMBT-MM0P-8BM5-T788
0gjmtRKjjdpuGl0,1541592399,Wayforpay,4121,4121,-6200,-6200,980,0,0,779387,False,4E43-44C5-8B3C-E4XB
X76-BfacXAkfwP8,1541581606,APTECHN PUNKT 3,5912,5912,-12670,-12670,980,0,0,785587,False,0ATH-69H7-ETM1-X058
qSK9cjDaZ4s9E4I,1541579455,aptechniypunkt 3,5912,5912,-88015,-88015,980,0,0,798257,False,2E4X-HA79-BX66-AT5C
Ey2MORPF_pljR_8,1541543560,–õ–∏–Ω–¥–∞-–§–∞—Ä–º,5912,5912,-8563,-8563,980,0,0,886272,False,X5X8-4XA5-AMMH-5P9A
UPg5lxQzhRfDJ0s,1541542665,Apteka 1,5912,5912,-121744,-121744,980,0,0,894835,False,656T-15M2-0AEE-2055
fNqWs3QSdInrQ-U,1541530218,MIRA KAFE,5814,5814,-10900,-10900,980,0,0,1016579,False,7M1B-A607-TP1E-805C
QNs0Aku53vXhPdo,1541513349,–í—ñ–¥: –í–ª–∞–¥–∏—Å–ª–∞–≤ –ß–æ—Ä–Ω–∏–π,—á–µ–±—É—Ä–µ–∫–∏,4829,4829,5800,5800,980,0,0,1027479,True
oQAm0O6mO3J6rfQ,1541511881,MUSAFIR,5812,5812,-16200,-16200,980,0,0,1021679,False,5A24-HHB1-ATH5-6A1H
3pAeC-lDbhhUfmA,1541493336,KvitividNoriti,5992,5992,-25000,-25000,980,0,0,1037879,False,M6P8-EAAC-6B18-798A
flpzRkxWUMds75I,1541489285,Wayforpay,4121,4121,-6000,-6000,980,0,0,1062879,False,PBMM-M297-A1E5-3KM6
kEHy-YS0wsQ2xHA,1541442771,BURGERFARM,5814,5814,-31500,-31500,980,0,0,1068879,False,B990-8E4P-37E6-CC53
lwjRgstn62qwy2o,1541440594,FOPBichenkoRV,5691,5691,-35000,-35000,980,0,350,1100379,False,0659-6CEC-A55P-782K
FhzmUiScl1VRpx0,1541344003,SWEET FRESH,5812,5812,-45500,-45500,980,0,0,1135379,False,CCPA-H4BC-15B6-9131
8WhWxfc_qJmk_Ko,1541343282,LE KOMORA,5921,5921,-69900,-69900,980,0,0,1180879,False,7003-M003-4A79-C9T0
LDZLDL6aNGrKDJc,1541329331,FOPBichenkoRV,5691,5691,-35000,-35000,980,0,350,1250779,False,XM69-85PM-M4T5-24PM
HyZr4i9tiqJ3fVk,1541328481,SWEET FRESH,5812,5812,-54056,-54056,980,0,0,1285779,False,TPT7-K570-T840-X4T1
8qkYBz3SBNz4J54,1541323026,–í–∏–ø–ª–∞—Ç–∞ –¥–µ–ø–æ–∑–∏—Ç—É,4829,4829,210000,210000,980,0,0,1339835,True
H5n8Y-7h7YS2C5s,1541314852,–í–∏–ø–ª–∞—Ç–∞ –ø—Ä–æ—Ü–µ–Ω—Ç—ñ–≤,4829,4829,2297,2297,980,0,0,1129835,True
rRaz4iOEKNCaVRU,1541152691,PROGRESS CAFFE,5812,5812,-3600,-3600,980,0,0,1127538,False,0MP4-H197-ET8A-895E
hFlbjMX7mwKVH8w,1541149870,KonditerskajaLyafabrik,5441,5441,-27200,-27200,980,0,0,1131138,False,1B11-AKBX-PM3H-4K13
qVe1_kX8Wq3AGxs,1541139286,Wayforpay,4121,4121,-1200,-1200,980,0,0,1158338,False,742A-B1TE-1K78-3B8M
2muUVATd5khnY3c,1541113975,Wayforpay,4121,4121,-7900,-7900,980,0,0,1159538,False,27CA-HC7K-CCA5-019A
Y8NLRCY3CBqoKok,1541092304,Wayforpay,4121,4121,-10000,-10000,980,0,0,1167438,False,HX45-ATMB-K1TB-1894
ALlqCF4jund0tV4,1541091631,MIRA KAFE,5814,5814,-18800,-18800,980,0,0,1177438,False,PXE8-43B4-PE70-A82H
4k-OcTYmz00KxfU,1541091415,MAGAZYN PRODUKTY 4,5411,5411,-10100,-10100,980,0,0,1196238,False,2E8X-9A87-KCKX-BP6E
JPBvSW_Qca9Cgw8,1541072075,–í—ñ–¥—Å–æ—Ç–∫–∏ –∑–∞ –∂–æ–≤—Ç–µ–Ω—å,4829,4829,2350,2350,980,0,0,1206338,True
JSLOwhLqMgS0GZM,1541069265,Lesya,4829,4829,-1000000,-1000000,980,0,0,1403988,True,0AXH-3H10-29A3-1KK5
UJogg3E31Chf2ik,1541068720,–íi–¥: –ü–†–ò–•–û–î–¨–ö–û –ï.–í. –§–û–ü,4829,4829,1950000,1950000,980,0,0,2403988,True
fMKOWmFKSMe-Tbs,1541057383,Wayforpay,4121,4121,-6000,-6000,980,0,0,453988,False,B667-MKBH-B8BM-0K9T
80i-ldaFW7dIUw8,1546184534,–°–∫–∞—Å—É–≤–∞–Ω–Ω—è. Google,7399,7399,600,600,980,0,0,253406,True
dhRXajyf5WGEF-8,1546183669,LIQPAY*FOP Kostova O.I,4215,4215,-158921,-158921,980,0,0,252806,False,PTMC-35E9-07P9-T410
VNDYrpZ7kdeqTx8,1546183632,Google,7399,7399,-600,-600,980,0,0,411727,True
gBDk1Vg0rJ-ebi0,1546180256,–ù–∞–∫–ª–∞–¥–µ–Ω–∏–π –ø–ª–∞—Ç—ñ–∂ (–ù–æ–≤–∞ –ø–æ—à—Ç–∞),6538,6538,-139700,-139700,980,0,0,412327,False,HMHH-2E7E-MC89-70T5
LobAlnxQ0Az3HhA,1546179749,APTEKA 7,5912,5912,-43130,-43130,980,0,0,552027,False,H0E1-E93A-ABX0-6E1H
EFXapSKX8c3WSdY,1546179462,–§–æ—Ä–∞,5499,5499,-30381,-30381,980,0,303,595157,False,620B-39HC-8T64-8434
IwWd51fH3JE88Y4,1546110433,ProduktiPetl6,5499,5499,-1650,-1650,980,0,16,625538,False,3T0M-36KX-EA5M-H00E
g6raPccJNKbpWfY,1546109930,ARM GREEK,5812,5812,-46200,-46200,980,0,0,627188,False,E8C5-PKH3-KHA0-HEHP
cX1E69TwV_U39AU,1546069488,Wayforpay,4121,4121,-5500,-5500,980,0,0,673388,False,E4H5-243H-006M-AMA7
dNcwWWptjDjznZ0,1546034601,Taxi,4121,4121,-8000,-8000,980,0,0,678888,False,48P7-B800-X667-C758
0NjSBodLFcAisqc,1546019178,Wayforpay,4121,4121,-8800,-8800,980,0,0,686888,False,9MX2-H3T1-T4ME-1M93
7vIJwzG46s2RFTw,1545995391,APTEKA 35,5912,5912,-15385,-15385,980,0,0,695688,False,KCM1-33E7-X8PC-0HBE
OHUdLEbz7FdDcrk,1545995197,APTEKA 35,5912,5912,-32800,-32800,980,0,0,711073,False,7H3C-0C57-H7PE-2XE7
EfS4ysRTvk_jsBg,1545992055,–ê–ø—Ç–µ–∫–∞ –î–æ–±—Ä–æ–≥–æ –î–Ω—è,5912,5912,-34160,-34160,980,0,0,743873,False,9BAP-213T-B1AH-M2M0
WQZQOdnjtUo_uvo,1545943330,iHerb,5499,5499,-112820,-112820,980,0,1128,778033,False,80XX-6C2H-3670-E10C
Lw497XZ7-InQXeU,1545900468,Wayforpay,4121,4121,-12000,-12000,980,0,0,890853,False,E6BT-E66M-M08X-5HCT
6AxFM2cYTq-vTk8,1545898456,KonditerskajaLyafabrik,5441,5441,-3500,-3500,980,0,35,902853,False,E02M-H4B5-08XT-PX3A
lnFFPZJ5F68mOjE,1545851600,MASTER ZOO,5995,5995,-38700,-38700,980,0,0,906353,False,CP0C-TT42-CTHT-5P67
fj271lj7hxHn-4w,1545850232,–ü–ª–∞—Ç—ñ–∂ COMFY,4829,4829,-137000,-137000,980,0,0,945053,True
F2WNZ8dCRfKdrJo,1545830136,4412Z4,5944,5944,-282300,-282300,980,0,0,1082053,False,EAPM-X919-844X-6B62
9Jjm3rQ52tt-15w,1545828969,Lesya,4829,4829,-900000,-900000,980,0,0,1364353,True,4P73-379B-5KET-K77T
swLw9-4Yu6FN_NU,1545828822,–íi–¥: –ü–†–ò–•–û–î–¨–ö–û –ï.–í. –§–û–ü,4829,4829,2200000,2200000,980,0,0,2364353,True
YHSBZQ9n5Yn1mXQ,1545819139,–°–∫–∞—Å—É–≤–∞–Ω–Ω—è. Google,7399,7399,600,600,980,0,0,164353,True
c-OF7P4xqvC8h5g,1545818268,portmone.com.ua,4814,4814,-17000,-17000,980,0,0,163753,False,E7XX-67A6-4E88-931X
1RACJ9vogG2mQvE,1545818236,Google,7399,7399,-600,-600,980,0,0,180753,True
1CeLj3Xv0a1rATI,1545815817,APTECHN PUNKT 3,5912,5912,-11165,-11165,980,0,0,181353,False,HME4-BM7M-T9PX-M4ET
q2ukeg12ffwtvRU,1545740847,Lesya,4829,4829,-10400,-10400,980,400,0,192518,True,93C5-CA5K-8E80-94C5
LhixpngEpxVvjeA,1545733406,APTECHN PUNKT 3,5912,5912,-33000,-33000,980,0,0,202918,False,0HH3-32EB-BX53-6AP9
O_V-5h-uTlWqEBI,1545717971,Wayforpay,4121,4121,-1600,-1600,980,0,0,235918,False,2571-17C8-BCMM-0HBT
UQUF1srxxgRtO0Y,1545681789,Wayforpay,4121,4121,-8500,-8500,980,0,0,237518,False,0B0T-89A6-1C3X-C8X8
VYvEbHb0exQv4oM,1545664435,99 lari,5812,5812,-5000,-5000,980,0,0,246018,False,471A-KBPP-E9AH-6CK8
91uyd3xfa29he9c,1545664402,99 LARI,5812,5812,-32201,-32201,980,0,0,251018,False,A5CT-H9CH-XH17-XE0M
fu6nbfPkQ_K_A4E,1545661941,APTEKA15,5912,5912,-2010,-2010,980,0,0,283219,False,C346-96AA-TM3M-6PK9
5PLSWNuiTgi6xZg,1545573350,–ù–æ–≤–∞ –ø–æ—à—Ç–∞,4214,4214,-13645,-13645,980,0,0,285229,False,60ME-C95A-X333-BP96
m6_z-nHGlVMLnVw,1545571967,–°—ñ–ª—å–ø–æ,5411,5411,-52895,-52895,980,0,528,298874,False,T55E-072M-47X1-HC6M
k5umiOCDn4zmTag,1545557771,KonditerskajaLyafabrik,5441,5441,-24500,-24500,980,0,245,351769,False,M864-03BP-M0A1-HTPE
aHNYK-h2BVk7mxE,1545476603,Apteka2tovValena,5912,5912,-33530,-33530,980,0,0,376269,False,E5P2-PTA9-2PXA-40P0
Sz_q6pTLQWNiK8k,1545466945,–ö–∏—ó–≤—Å—å–∫–∏–π –º–µ—Ç—Ä–æ–ø–æ–ªi—Ç–µ–Ω,4111,4111,-800,-800,980,0,0,409799,False,PA63-K737-HP9M-7T9M
13eVDgHl1_e19Mo,1545465401,KonditerskajaLyafabrik,5441,5441,-34500,-34500,980,0,345,410599,False,1XHC-72BM-7X62-078E
EA2xnbyj4qemBTg,1545404768,–í—ñ–¥: –î–µ–Ω–∏—Å –ö–æ—Ç–æ–≤,–°–¥–∞—á–∞ –∑–∞ —Ç—É–Ω–µ—Üü¶à,4829,4829,400,400,980,0,0,445099,True
0hPL_a7s51eBqUQ,1545404015,–î–µ–Ω–∏—Å –ö–æ—Ç–æ–≤,—Ç—É–Ω–µ—Ü ü¶à,4829,4829,-8900,-8900,980,0,0,444699,True,0CBT-8TK8-C2E9-MB4T
1Z0mWl2TL4GkE2Y,1545397382,CafeBlueCup,5814,5814,-3900,-3900,980,0,0,453599,False,1XH6-CCK4-AX83-E959
kUUS_Prqx5nEEYk,1545330952,MolokovidPHermera,5451,5451,-6614,-6614,980,0,66,457499,False,PB2K-MK5E-X1KP-0K93
79ZvvGfPkkVKg4U,1545330798,BeerMarket,5921,5921,-18299,-18299,980,0,182,464113,False,12CB-8MPM-PT32-40AK
qnRPD-BbcLywAvM,1545328049,–ü—Ä–∏–≤–∞—Ç24,6536,6536,15600,15600,980,0,0,482412,False
SXLpldWkPw_Zko0,1545325093,Wayforpay,4121,4121,-12000,-12000,980,0,0,466812,False,PB0H-82MB-9XP5-0126
agVHfZ709NrvFeo,1545313196,Glovo,4215,4215,-35500,-35500,980,0,0,478812,False,EBBM-T02M-86HB-5E9C
KmDdOQLoGBWpx6o,1545298639,LTD SWEET FRESH 1,5812,5812,-9000,-9000,980,0,0,514312,False,1A3P-1171-AE2M-A0X3
FHEOgynqHYMKM-g,1545251023,Lesya,4829,4829,-300000,-300000,980,0,0,523312,True,1594-CK4X-9451-40E3
lRN8ePczIbIc1Io,1545248474,Billa,5411,5411,-7326,-7326,980,0,73,823312,False,C5X5-MMP5-94HX-66H7
T6k6MQ7vdYwwIQY,1545214334,PROGRESS CAFFE,5812,5812,-7000,-7000,980,0,0,830638,False,41MX-5PM1-039T-K73B
uskGkvPLwwF3BFw,1545214084,PROGRESS CAFFE,5812,5812,-8000,-8000,980,0,0,837638,False,7T63-686K-E7E6-0HH0
QIworZpyfPxgnaA,1545212140,–ù–æ–≤–∞ –ø–æ—à—Ç–∞,4214,4214,-21736,-21736,980,0,0,845638,False,6C3X-048T-H7M5-C11C
f8VefraPJ44v38I,1545141527,Salateira,5814,5814,-8201,-8201,980,0,0,867374,False,96B4-C73M-5994-XPK2
aGIMKAcF6Ph1EHI,1545122502,APTEKA LASKAVA 7,5912,5912,-71120,-71120,980,0,0,875575,False,AE6K-676A-ABEC-C759
c-zAZU0VQ5qZ3zM,1545071826,–°—ñ–ª—å–ø–æ,5411,5411,-103456,-103456,980,0,1034,946695,False,AECB-61CP-64P5-HHAE
RobXJRR2DCjRV04,1545052573,STEYKHAUS,5812,5812,-10500,-10500,980,0,0,1050151,False,4M8X-P7K7-3M4E-0M52
CMuWInLd8xkXNaM,1545050036,Lesya,4829,4829,-1000000,-1000000,980,0,0,1060651,True,0291-B79B-9M15-86P7
_7jiBkphVS7TcMM,1545049989,–¢–µ–ø–ª–æ,4900,4900,-62388,-62388,980,0,0,2060651,True,8H2A-H1XT-MPCB-BAXX
armnJCAKcEpmHF4,1545049989,–°–≤—ñ—Ç–ª–æ,4900,4900,-10680,-10680,980,0,0,2123039,True,3BX8-A5HA-KHH4-T54A
n7kynkQBw7hKJfo,1545049988,–ì–∞—Ä—è—á–∞ –≤–æ–¥–∞,4900,4900,-22356,-22356,980,0,0,2133719,True,T4PX-0102-46A9-E4PH
Crj4-H9bUu9GL7U,1545049988,–°–≤—ñ—Ç–ª–æ,4900,4900,-10680,-10680,980,0,0,2156075,True,EK33-0CH9-C49M-6EH7
zLkT1MFQd7Cmjjw,1545049987,–ì–∞—Ä—è—á–∞ –≤–æ–¥–∞,4900,4900,-2611,-2611,980,0,0,2166755,True,5XKH-H4E1-T0B5-A47E
zg8jvHFPWPOuuf0,1545049987,–•–æ–ª–æ–¥–Ω–∞ –≤–æ–¥–∞,4900,4900,-21555,-21555,980,0,0,2319366,True,437K-T052-6BE9-8PXT
_4sXhk9xO-asOH8,1545049987,–í–∏–≤—ñ–∑ —Å–º—ñ—Ç—Ç—è,4900,4900,-2601,-2601,980,0,0,2340921,True,B2KP-4687-1EHX-MMH1
b4r8VGnxQdFODVM,1545049986,–ö–≤–∞—Ä—Ç–ø–ª–∞—Ç–∞,4900,4900,-12122,-12122,980,0,0,2343522,True,MH11-CMME-EE68-HE54
XgvpRXfLXn0bHdY,1545049986,–ì–∞–∑,4900,4900,-3104,-3104,980,0,0,2355644,True,1MK9-C82P-7CX4-T4CC
DKNUndamgaGslVY,1545048774,–íi–¥: –ü–†–ò–•–û–î–¨–ö–û –ï.–í. –§–û–ü,4829,4829,2200000,2200000,980,0,0,2358748,True
ikYIoUALq7NR450,1544979109,EVA,5977,5977,-1499,-1499,980,0,0,158748,False,EX75-T8CX-9618-6BB1
izkr2trbEZZcyvo,1544978643,BeerMarket,5921,5921,-5999,-5999,980,0,59,160247,False,PTBK-P6MK-P098-MPT2
i_rpkOSeKzMKn6U,1544978389,MolokovidPHermera,5451,5451,-23693,-23693,980,0,236,166246,False,EAAC-KT76-4774-C29P
Ikekha5GGgJMXVg,1544963479,Glovo,4215,4215,-28800,-28800,980,0,0,189939,False,5EP9-K200-X56P-4C0K
TSydSBWJgQur-4s,1544962886,–°–∫–∞—Å—É–≤–∞–Ω–Ω—è. Google,7399,7399,600,600,980,0,0,218739,True
40VMPV4EaTlgnJ8,1544961980,Google,7399,7399,-600,-600,980,0,0,218139,True
gZtlDE1wG5vTJPU,1544949480,KonditerskajaLyafabrik,5441,5441,-7600,-7600,980,0,76,218739,False,TA1B-876H-CKCM-13K4
nn9J5Dfy2LVa3MQ,1544949316,Prodmag,5499,5499,-1730,-1730,980,0,17,226339,False,8534-C7A2-T78P-1PA2
Uup4RmbXXOXKes8,1544949101,MAGAZYN PRODUKTY,5499,5499,-3550,-3550,980,0,35,228069,False,23C2-6BB3-9577-0178
r_RezOzWKVgUexs,1544813833,–°—ñ–ª—å–ø–æ,5411,5411,-17150,-17150,980,0,171,231619,False,6KAK-8TP6-890H-MEBP
68EMlYlZ3U0UoiY,1544792627,CHERNOBYLADVENTURE.COM,7991,7991,-109200,-109200,980,0,0,248769,False,2H2K-213E-72AT-H9ET
aef_6AZd2kOmKhN5DPASODu5,1544752099,–°–∫–∞—Å—É–≤–∞–Ω–Ω—è. Amazon,5942,5942,2840,100,840,0,0,357969,True
IAWOQvsJIqeTHSA,1544728140,Produkti,5499,5499,-14500,-14500,980,0,145,355129,False,B5M2-T2PH-9563-6462
siQGK1c96H_lXDs,1544722320,APTEKA1,5912,5912,-11487,-11487,980,0,0,369629,False,6TA4-AT3H-3TK5-A2K0
yGZzzfRcy3CSbfs,1544704494,–ù–æ–≤–∞ –ø–æ—à—Ç–∞,4214,4214,-15300,-15300,980,0,0,381116,False,1K19-62BX-108C-016K
G5yEW8H7-_hn6AQ,1544641551,restoran ChIChIKO,5812,5812,-17100,-17100,980,0,0,396416,False,5XM9-K5XX-396E-4H86
Lm2yG6hL3m0CIXU,1544641514,restoranChIChIKO1,5812,5812,-57502,-57502,980,0,0,413516,False,4BM2-597B-3049-TT7T
snjnzVRcQvJsjSo,1544605518,PROGRESS CAFFE,5812,5812,-4500,-4500,980,0,0,471018,False,1T05-153P-X7A9-05A3
S-pECIQ-uPII6tE,1544562865,RESTORAN KHMILNYY KNYA,5812,5812,-24000,-24000,980,0,0,475518,False,A3AK-64M4-76H9-3351
dYhjSHDfJBgoX3A,1544464868,Prodmag,5499,5499,-9641,-9641,980,0,96,499518,False,1AH7-HECA-B86H-K73B
e9tjfrMh60WIHbQ,1544444938,McDonald's,5814,5814,-17200,-17200,980,0,0,509159,False,514P-B342-HKE4-9407
QMj_BcPAMq-lP6Q,1544374196,–ö–∏—ó–≤—Å—å–∫–∏–π –º–µ—Ç—Ä–æ–ø–æ–ªi—Ç–µ–Ω,4111,4111,-800,-800,980,0,0,526359,False,7BT0-C1P6-KB39-5BX8
xwmexU7b4xM_OQ4,1544373805,–°—ñ–ª—å–ø–æ,5411,5411,-5999,-5999,980,0,59,527159,False,KTCM-7KEE-587M-23B9
WoOHS-pwS7IsO8k,1544373233,SHOP KIEHLS GULLIVER 1,5977,5977,-223600,-223600,980,0,0,533158,False,2798-8TKA-9TH1-6XTP
GcaPhm95ltdlfZg,1544372874,SHOP KIEHLS GULLIVER 1,5977,5977,-161000,-161000,980,0,0,756758,False,KPCX-0CP4-6P6K-4H65
Vxw033V7oOzYXsE,1544371527,–ö–∏—ó–≤—Å—å–∫–∏–π –º–µ—Ç—Ä–æ–ø–æ–ªi—Ç–µ–Ω,4111,4111,-800,-800,980,0,0,917758,False,7XX1-C43B-H1AA-980X
ZcU0j1p-IrcBgic,1544355207,–°—ñ–ª—å–ø–æ,5411,5411,-14580,-14580,980,0,145,918558,False,41CX-4H43-P749-KB08
mWdHDY5knq4WW9s,1544355147,–°—ñ–ª—å–ø–æ,5411,5411,-23041,-23041,980,0,230,933138,False,HCCH-TXKC-6871-MP8B
E3hwyp2t1DQMVGY,1544353043,–ö–∏—ó–≤—Å—å–∫–∏–π –º–µ—Ç—Ä–æ–ø–æ–ªi—Ç–µ–Ω,4111,4111,-800,-800,980,0,0,956179,False,KEH6-BM8P-6AAP-E4C1
4JBwdgdv3Zgzvi8,1544351824,APTECHN PUNKT 3,5912,5912,-36265,-36265,980,0,0,956979,False,CPA9-T164-M8K9-585B
cxnIafbFnoK13kM,1544348709,APTECHN PUNKT 3,5912,5912,-57091,-57091,980,0,0,993244,False,A5XH-XMH4-38C3-57K0
SdYr2YRRVsTLJ-4,1544342042,–°–∫–∞—Å—É–≤–∞–Ω–Ω—è. Google,7399,7399,600,600,980,0,0,1050335,True
R9MZvltvb8OKdwQ,1544341183,LIQPAY*FOP Hizhnyak N.,4215,4215,-97750,-97750,980,0,0,1049735,False,8H50-KE8M-3C38-79KC
Gme9SKHrdqfSs9k,1544341137,Google,7399,7399,-600,-600,980,0,0,1147485,True
mP7qP0hHDHA62mM,1544274573,APTEKA        9,5912,5912,-27950,-27950,980,0,0,1148085,False,T96K-BM8B-21HT-CBX7
QZpZfjSNc9JmSNs,1544267711,JYSK,5712,5712,-69900,-69900,980,0,0,1176035,False,113P-8E68-81K6-MT3K
Tc9FT53JNSdG4qI,1544263098,APTECHN PUNKT 3,5912,5912,-31471,-31471,980,0,0,1245935,False,CE4X-6905-C503-X4CT
6jcwWbYxO2nHh_Y,1544258475,SHIKO,4722,4722,-2000,-2000,980,0,0,1277406,False,CB76-3B9H-6B58-CXXT
mk8XQ85x7iWeZPM,1544189973,Produkti,5499,5499,-7750,-7750,980,0,77,1279406,False,6X6X-A7A7-05HB-117P
9BziImWzGYlLzFs,1544168019,Wayforpay,4121,4121,-7700,-7700,980,0,0,1287156,False,PCP3-B2HA-C14A-1CK6
OE0aWXv69bkmKQE,1544119981,–§–æ—Ä–∞,5499,5499,-11894,-11894,980,0,118,1294856,False,5M66-A6MH-M941-H58T
Xg0fI5tCbvfgGl0,1544081865,KonditerskajaLyafabrik,5441,5441,-34200,-34200,980,0,342,1306750,False,CC82-HB0H-C11C-A237
AkDS8z9nLUYsv-qZ,1543969777,"–°–∫–∞—Å—É–≤–∞–Ω–Ω—è. globalblue.com/rules, Box 200, MOLNDAL, SE",5309,5309,39911,1430,840,0,0,1340950,True
Q92nD_FhRduie_c,1543949505,MAGAZYN PRODUKTY,5499,5499,-10600,-10600,980,0,106,1301039,False,B9EA-HE23-BXH4-1TH2
EZwKBxS3S1eO8kQ,1543948548,HILTON INTERNATIONAL,3535,3535,-150000,-150000,980,0,0,1311639,False,9KMB-T52B-73EE-09A1
FSO-gNJ2Jc21Tbw,1543942689,APTEKA1,5912,5912,-7618,-7618,980,0,0,1461639,False,A3A9-33A6-PA8A-71H4
nwOFoEOWsv3EOZw,1543936851,–í—ñ–¥: –û–ª–µ—Å—è –°–∞—á–µ–Ω–∫–æ,SPA thingy,4829,4829,150000,150000,980,0,0,1469257,True
xgN64fbKRILt0EM,1543918451,Endorphin,5451,5451,-3300,-3300,980,0,33,1319257,False,15MM-K825-7M11-9205
ErOh5-8ltlc4YZGCSS4,1543883704,"TFL TRAVEL CH, VICTORIA STREET, TFL.GOV.UK/CP, GB",4111,4111,-17416,-480,826,0,0,1322557,True
dxUYuZY0DSJM5qxLfDI46XZT,1543883704,–°–∫–∞—Å—É–≤–∞–Ω–Ω—è. Travel for London,4111,4111,3635,100,826,0,0,1339973,True
bblwUq1Km91lslc,1543842532,Lesya,4829,4829,-900000,-900000,980,0,0,1336338,True,5211-2P9H-3TMH-6P7C
IdmbXXjUFmlgs00,1543840998,–íi–¥: –ü–†–ò–•–û–î–¨–ö–û –ï.–í. –§–û–ü,4829,4829,2000000,2000000,980,0,0,2436338,True
CWqN3aVsRyznuJA,1543829130,–ù–æ–≤–∞ –ø–æ—à—Ç–∞,4214,4214,-4400,-4400,980,0,0,436338,False,KXX1-69KX-X8CC-BH5B
NS1vWHb3KWrQgkI,1543828400,Amazon,5942,5942,-36380,-1281,840,0,0,440738,False,H9P0-3595-740A-K796
u4SLb3g3HJePs_g,1543828070,Amazon,5942,5942,-2840,-100,840,0,0,477118,False
aHt5PewxyvLA_K4,1543780860,KL_KYIV_Bazhana_1D,5541,5541,-72002,-72002,980,0,720,479958,False,A171-00K2-6CBB-E5MM
CIo52wVT5-nbORM,1543780383,McDonald's,5814,5814,-27800,-27800,980,0,0,551960,False,X0AH-511B-EA3C-44E8
WxhJnx75uAGbm94,1543762226,WORLD DUTY FREE EUROPE,5309,5309,-84147,-2320,826,0,0,579760,False,X6KE-KMC7-93P2-0T6C
7ykCYyRBZvaolPo,1543688369,BAROQUE,5812,5812,-114251,-3150,826,0,0,663907,False,4XA8-8C0X-5E94-MTC2
-btqiPkz81ZbVZA,1543675029,HARDYS ST PAULS,5441,5441,-16500,-454,826,0,0,778158,False,28PC-496C-XCHX-M55M
2H_idLxiLoyxY_U,1543669701,BREWDOG TOWER HILL,5812,5812,-22549,-620,826,0,0,794658,False,29P2-XXM0-19BK-0045
YWsBs0XLfSIfVZE,1543669549,BREWDOG TOWER HI,5812,5812,-22549,-620,826,0,0,817207,False,34B9-5E13-1BTB-496H
XPJ33Bc30Kg4qQs,1543667493,BREWDOG TOWER HILL,5812,5812,-22549,-620,826,0,0,839756,False,X36C-5T8P-937C-M300
Gkfc5z0wrMaYBbE,1543666492,–í—ñ–¥—Å–æ—Ç–∫–∏ –∑–∞ –ª–∏—Å—Ç–æ–ø–∞–¥,4829,4829,611,611,980,0,0,862305,True
NrmP8gbU53pDBkQ,1543663357,Travel for London,4111,4111,-3635,-100,826,0,0,861694,False
2BRRsC-w41pYFoY,1543662666,Tiffany,5944,5944,-436300,-12000,826,0,0,865329,False,A91E-8AKX-5BCH-E808
4ag3Scm85gnfuCU,1543660239,Bread Ahead Ltd,5462,5462,-58900,-1620,826,0,0,1301629,False,22X9-9X5B-95EM-3461
li27-vSJQphNGyk,1543658848,AIRPORT BUS EXPRESS LT,4131,4131,-87271,-2400,826,0,0,1360529,False,XKMA-PMTH-7E9H-76TB
vO4v-XwTXPZZXmc,1543617967,SHAKE SHACK - VICTORIA,5812,5812,-38169,-1050,826,0,0,1447800,False,PB68-MC39-1EB3-C86C
f1tjZIyh67XSgis,1543616995,VICTORIA PALACE,7922,7922,-43621,-1200,826,0,0,1485969,False,M2M4-0BB8-H8H3-4AT1
LAQugIZwyrQu_3U,1548877448,FOP PROBAChAY OM,742,742,-20500,-20500,980,0,0,392850,False,X25E-AP7X-509K-PHK2
L3HuA4JD2DsPW5w,1548846764,APTEKADD00000000005915,5912,5912,-13460,-13460,980,0,0,413350,False,4ME0-2T5P-A374-80K1
5YQeGMkyjf8SLco,1548846261,"–ü–∏—Ä—ñ–∂–∫–æ–≤–∞ ""–¢—ñ—Ç–∫–∞ –ö–ª–∞—Ä–∞""",5814,5814,-15100,-15100,980,0,453,426810,False,P091-BTXC-MHPE-BT17
uEtT55C9K8QBdaA,1548845416,HEALTH AND HAPPY,8099,8099,-39600,-39600,980,0,0,441910,False,E813-209H-KEK6-A7EP
o1sq1JpbcY3HGIc,1548758439,–°–∫–∞—Å—É–≤–∞–Ω–Ω—è. Google,7399,7399,600,600,980,0,0,481510,True
jzY3S9tcmHoHytU,1548757562,LIQPAY*cipollino,5812,5812,-22200,-22200,980,0,666,480910,False,1P31-4X04-9A4H-MB38
FpYP3jTRgj-n6mk,1548757537,Google,7399,7399,-600,-600,980,0,0,503110,True
FFNSOuvS0BBVt74,1548747765,ProduktiSaks,5499,5499,-12700,-12700,980,0,0,503710,False,0674-7BPT-PP7H-5APM
Mf-iz37GcO1vWnk,1548705577,Wayforpay,4121,4121,-5000,-5000,980,0,0,516410,False,T771-TEK8-9845-BA9H
vEJltlZHl2m6nD0,1548688098,Lesya,4829,4829,-600000,-600000,980,0,0,521410,True,4M73-TPHH-10P9-B55T
kRRkUG1izCaHIW0,1548668551,–íi–¥: –ü–†–ò–•–û–î–¨–ö–û –ï.–í. –§–û–ü,4829,4829,1100000,1100000,980,0,0,1121410,True
U6jAjn2oNOAjtvc,1548664780,PRODUKTI,5499,5499,-2950,-2950,980,0,0,21410,False,TC71-ACCE-94X3-X98P
LwdOPB2QpHaYFb0,1548588546,PRODYKTU GILJANSKAJA,5499,5499,-14588,-14588,980,0,0,24360,False,58KT-BEC1-BM1H-XMT9
uC-U82chCWINOwo,1548588385,–í–∏–≤–µ–¥–µ–Ω–Ω—è –∫–µ—à–±–µ–∫—É 438.97‚Ç¥,4829,4829,35336,35336,980,0,0,38948,True
svBTCMYT3NGzw-s,1548543455,Steam,7994,7994,-2500,-2500,980,0,0,3612,False,354E-C28B-PEB1-BHBH
0_RSXiUSMQrLbf4,1548491443,FOP GUSAKOV VYu,5995,5995,-24811,-24811,980,0,0,6112,False,C99X-BKTC-BM9E-PB58
b7MT6vNFoC7vXd4,1548491211,–í—ñ–¥: –û–ª–µ—Å—è –°–∞—á–µ–Ω–∫–æ,4829,4829,30000,30000,980,0,0,30923,True
UQItjcqK72E5jWY,1548489393,–í—ñ–¥: –û–ª–µ—Å—è –°–∞—á–µ–Ω–∫–æ,üíã,4829,4829,15000,15000,980,0,0,923,True
7tymWCfUx-x9-nU,1548486258,–ü–ª–∞—Ç—ñ–∂ COMFY,4829,4829,-137000,-137000,980,0,0,-14077,True
wLlO1KM7MUrYnCo,1548449353,Steam,7994,7994,-9100,-9100,980,0,0,122923,False,X7XP-MHPE-XH56-8XBA
DLDPKcH4K-r2xgI,1548448335,–°–∫–∞—Å—É–≤–∞–Ω–Ω—è. Google,7399,7399,600,600,980,0,0,132023,True
KKacZny4KwU8COg,1548447462,portmone.com.ua,4814,4814,-18000,-18000,980,0,0,131423,False,C4AK-87C7-M5EM-3X3A
SFeryNrlPvz3a90,1548447434,Google,7399,7399,-600,-600,980,0,0,149423,True
AAWaBPFNACMdA74,1548447248,Lesya,4829,4829,-55000,-55000,980,0,0,150023,True,9EKM-HM61-BTA7-EC1X
aYb2sOq2jwDs7lw,1548424773,–ú–∞–∫—Å–∏–º –ó–∞–±–æ–ª–æ—Ç–Ω–∏–π,–ø–∏–≤–∞—Å üçª,4829,4829,-16000,-16000,980,0,0,205023,True,A4XT-9EAB-P549-9ME0
o60RKYeMI-z7pY4,1548407886,PROGRESS CAFFE,5814,5814,-7500,-7500,980,0,225,221023,False,5HB6-0A9T-CHPA-6HAB
iUFqAwy51-FfYqY,1548407562,Florrum,5992,5992,-60000,-60000,980,0,9000,228523,False,4H89-9T48-43M5-M82C
-JQA5jW2OfGHSTk,1548402376,–°–µ—Ä–≥–µ–π –ù–∞–∑–∞—Ä–æ–≤—Å–∫–∞—è 7,–∞—Ä–µ–Ω–¥–∞ üè†,4829,4829,-1106600,-1106600,980,0,0,288523,True,1872-T08E-K96K-15E0
TyK2D4IzEjLNQiY,1548351833,–ö–∏—ó–≤—Å—å–∫–∏–π –º–µ—Ç—Ä–æ–ø–æ–ªi—Ç–µ–Ω,4111,4111,-800,-800,980,0,0,1395123,False,K54M-T3XT-2196-2HCP
eLQaHPQNFuM7tes,1548349202,–ö–∏—ó–≤—Å—å–∫–∏–π –º–µ—Ç—Ä–æ–ø–æ–ªi—Ç–µ–Ω,4111,4111,-800,-800,980,0,0,1395923,False,X9PP-029A-7TT5-TA3C
nuMyMeYnO_RFepg,1548322373,CafeBlueCup,5814,5814,-3900,-3900,980,0,117,1396723,False,EA5K-EA83-P7C3-9855
wpWYP9_BWqpRpD0,1548321985,–ü–∏—Ä–æ–≥–∏ —Ç–∞ –¥—Ä—É–∑—ñ,5814,5814,-15000,-15000,980,0,450,1400623,False,XA20-PT75-4E8H-58EK
SA2VgCPy4pijM-w,1548270427,FOP PROBAChAY OM,742,742,-6400,-6400,980,0,0,1415623,False,A7PM-XBAK-H8HC-T4A7
g1azWVpuSx1sTh8,1548253392,–î–µ–Ω–∏—Å –ö–æ—Ç–æ–≤,–æ—Ä–µ—à–µ–∫ ü•ú,4829,4829,-1000,-1000,980,0,0,1422023,True,K30X-10K2-K4CP-89A1
8m5DkAWCtOotKsM,1548252797,–í—ñ–¥: –û–ª–µ–∫—Å—ñ–π –í–∏–∫–∞–ª—é–∫,üå∞ü•üüçΩÔ∏è,4829,4829,21000,21000,980,0,0,1423023,True
kH85ls0ALkgl6ek,1548252790,Sanatrelo,5812,5812,-135000,-135000,980,0,4050,1402023,False,8PE5-K87C-24TK-83P3
Gc-gBMSSGFtwC8E,1548252709,–í—ñ–¥: –í–ª–∞–¥–∏—Å–ª–∞–≤ –ß–æ—Ä–Ω–∏–π,—Å–∞–Ω–∞—Ç—Ä–µ–ª–ª–æ,4829,4829,24500,24500,980,0,0,1537023,True
tJWtTIlqvcyHOZc,1548251499,–°–∫–∞—Å—É–≤–∞–Ω–Ω—è. Glovo,4215,4215,11000,11000,980,0,0,1512523,True
urLlmrgazZaiqAk,1548251429,Glovo,4215,4215,-11000,-11000,980,0,0,1501523,True
y9jsvpNCoo-PIhc,1548182792,–ü—Ä–∏–≤–∞—Ç24,6536,6536,76700,76700,980,0,0,1512523,False
5zLYHdDcBf40zXc,1548177233,PROGRESS CAFFE,5812,5812,-13500,-13500,980,0,405,1435823,False,5806-92PX-CEEX-872T
ZVm-b5oczplDQpg,1548177071,Florrum,5992,5992,-60000,-60000,980,0,9000,1449323,False,C88P-0PP6-XKAA-T595
TkXBwdZZK_87c28,1548170695,–ú–∞–∫—Å–∏–º –ó–∞–±–æ–ª–æ—Ç–Ω–∏–π,–º–∞–∫,4829,4829,-9600,-9600,980,0,0,1509323,True,CAE4-K9P8-807A-54KA
68grZ7jh1TQwfnA,1548093610,–ü–∏—Ä–æ–≥–∏ —Ç–∞ –¥—Ä—É–∑—ñ,5814,5814,-11000,-11000,980,0,330,1518923,False,7E9X-9456-93KE-PCMP
CZeMMpqbodQOkug,1548080807,–ê–ª–µ–∫—Å–µ–π –í—ã–∫–∞–ª—é–∫ BCD,–ø–ª–æ–≤ üçö,4829,4829,-11000,-11000,980,0,0,1529923,True,H9EP-00C6-C0MT-6A10
b8X6gUlHMfwobU4,1547997496,"–ü–∏—Ä—ñ–∂–∫–æ–≤–∞ ""–¢—ñ—Ç–∫–∞ –ö–ª–∞—Ä–∞""",5814,5814,-10700,-10700,980,0,321,1540923,False,M6E4-M6BB-P87C-6A8A
0un7aRjrMHVypik,1547982632,–õ—é–±–∏–º—ã–π –¥—è–¥—è,5812,5812,-74700,-74700,980,0,2241,1551623,False,PTP1-372H-07M8-BTK8
3v6_4dGhMH89bII,1547909728,Glovo,4215,4215,-24500,-24500,980,0,0,1626323,False,P737-T18C-32E4-T94A
oZvzUadABJdbHjc,1547901355,414962****0489,4829,4829,-260000,-260000,980,0,0,1650823,True,2006-X626-344X-089P
YRzsWrExdD3l5w0,1547892074,Produkty,5499,5499,-7220,-7220,980,0,0,1910823,False,7E6E-TAK6-TM96-A7PP
IE1mSGpn5PqGccU,1547843785,–ê–ø—Ç–µ–∫–∞ –î–æ–±—Ä–æ–≥–æ –î–Ω—è,5912,5912,-12760,-12760,980,0,0,1918043,False,XP9P-T48X-ET9T-0PP7
weIXzVktGTh5fXs,1547836119,–í—ñ–¥: –í–ª–∞–¥–∏—Å–ª–∞–≤ –ß–æ—Ä–Ω–∏–π,—Å–ø–ª–∏—Ç–≤–∞–π–∑,4829,4829,19800,19800,980,0,0,1930803,True
5hOyAt15LNo2n6g,1547805933,PROGRESS CAFFE,5812,5812,-17500,-17500,980,0,525,1911003,False,HC7A-B170-7A33-BT3B
utboQ9mg9gd3QVM,1547755485,PRESTIZHK CHACHAPURI,5812,5812,-8000,-8000,980,0,240,1928503,False,CXE6-P0K6-P5H1-HXT4
LsSgs8bFqyIh8Lo,1547755469,FOP OKHRIMENKO OM,5814,5814,-58906,-58906,980,0,1767,1936503,False,K1BT-5KB8-11PE-KPB8
CA_0s6rmxe7-7FU,1547752674,TOV AGP APTEKA N3,5912,5912,-7000,-7000,980,0,0,1995409,False,KPE0-0030-B6PX-893X
b3rSnanEH3Lx2f4,1547741847,Lesya,4829,4829,-400000,-400000,980,0,0,2002409,True,8X00-36C0-HA6B-4434
JU4CvKG72wESeN0,1547730721,–íi–¥: –ü–†–ò–•–û–î–¨–ö–û –ï.–í. –§–û–ü,4829,4829,2200000,2200000,980,0,0,2452409,True
ZV8pghoDl6cjw0A,1547653033,–°–∫–∞—Å—É–≤–∞–Ω–Ω—è. Google,7399,7399,600,600,980,0,0,252409,True
IFRngUC4o2_iYbo,1547652161,LIQPAY*FOP Hizhnyak N.,4215,4215,-114411,-114411,980,0,0,251809,False,MC36-4XM2-375M-KBME
kZT68pxLeGS4VfM,1547652127,Google,7399,7399,-600,-600,980,0,0,366220,True
8OXyZ4qDjjbzwFg,1547650482,–°–∫–∞—Å—É–≤–∞–Ω–Ω—è. Google,7399,7399,600,600,980,0,0,366820,True
sKxkw_TOhXCR0FY,1547649578,Google,7399,7399,-600,-600,980,0,0,366220,True
2-9m74KS7uvtB5Y,1547643296,–ú–∞–∫—Å–∏–º –ó–∞–±–æ–ª–æ—Ç–Ω–∏–π,4829,4829,-9600,-9600,980,0,0,366820,True,4TB2-8E59-TC95-30M8
xGCiD-EtkXmPo4A,1547629688,PROGRESS CAFFE,5812,5812,-5000,-5000,980,0,150,376420,False,9ABH-A108-5MTT-AX8K
TrcOTn5pnI3ppD4,1547624733,Wayforpay,4121,4121,-7000,-7000,980,0,0,381420,False,H0HX-XHAK-754A-37H2
fNvTmmPpZu9lDt8,1547623345,FOP PROBAChAY OM,742,742,-10000,-10000,980,0,0,388420,False,5294-XET6-7E9A-BP19
d2lQ4W_0-0BcLz4,1547623284,FOP PROBAChAY OM,742,742,-10000,-10000,980,0,0,398420,False,T6MK-3923-C851-3KX8
qz3HcYCNQBQp2-w,1547556090,Wayforpay,4121,4121,-6000,-6000,980,0,0,408420,False,6PPH-3BC2-AMBK-5E6T
q1HzMew7nUGYY2o,1547553574,Wayforpay,4121,4121,-6500,-6500,980,0,0,414420,False,X601-ET27-691B-BCH0
rVENSK9uI-UhRAY,1547494123,–ü–∏—Ä–æ–≥–∏ —Ç–∞ –¥—Ä—É–∑—ñ,5814,5814,-22000,-22000,980,0,660,420920,False,CP6T-P752-8HB6-74M0
MPkUmDdLe4LEjbw,1547469665,–í—ñ–¥: –û–ª–µ–∫—Å—ñ–π –í–∏–∫–∞–ª—é–∫,üçîüçüüëå,4829,4829,15000,15000,980,0,0,442920,True
7cnldxjJZWGcigA,1547469534,–í—ñ–¥: –í–ª–∞–¥–∏—Å–ª–∞–≤ –ß–æ—Ä–Ω–∏–π,–º–∞–∫–¥–æ–Ω–∞–ª—å—Å,4829,4829,17400,17400,980,0,0,427920,True
LQIx0yHFQjrIglE,1547468195,Glovo,4215,4215,-81300,-81300,980,0,0,410520,False,A7E9-CEM5-9E09-6438
UYGp9F2jEWhllV4,1547449915,FOP PROBAChAY OM,742,742,-16000,-16000,980,0,0,491820,False,MX73-2AB1-TE6X-CH86
GlrVq-MYn7zQsPI,1547380095,–í–µ–ª–º–∞—Ä—Ç,5499,5499,-21368,-21368,980,0,0,507820,False,MCKM-H7CB-A57H-KBBK
ti-ey0oMiqmeYTk,1547379297,Eurobyket,5992,5992,-7500,-7500,980,0,1125,529188,False,T2A0-TMA9-7C28-EPHT
oJBHaRU2gGqb2uQ,1547378537,JYSK,5712,5712,-34000,-34000,980,0,0,536688,False,6069-CA65-TX7P-PM7X
Crqzm1xyQ9XIlFg,1547372426,FOP PROBAChAY OM,742,742,-15000,-15000,980,0,0,570688,False,X8EE-11AK-4T06-8M32
_w8yiEeLjUKDaEM,1547304508,APTEKA15,5912,5912,-4320,-4320,980,0,0,585688,False,XM47-M079-0X5E-CE8A
4sBQTQzqWjvFXB4,1547229642,LIQPAY*cipollino,5812,5812,-26150,-26150,980,0,784,590008,False,3XP0-5EKE-83HX-MC24
5AwbrwMKZWYloi8,1547203819,Florrum,5992,5992,-50000,-50000,980,0,7500,616158,False,M3T4-P37K-CTTC-31KB
f9iAu2tmO2zXzcU,1547129390,KRIVIJRIGOPLATASHVTRAM,4111,4111,-250,-250,980,0,0,666158,False,EC05-BAE3-0KXA-P4PP
Zgm6pv9qgS6JrNA,1547128995,–°—ñ–ª—å–ø–æ,5411,5411,-8000,-8000,980,0,0,666408,False,0BCP-3T2A-HTHK-MT40
DMYlIxg45SPN1Jk,1547108380,KAFE SV CAFFE,5812,5812,-1600,-1600,980,0,48,674408,False,0K35-P15T-HC81-C259
gjGj01zjFmPSJjg,1547106112,Wayforpay,4121,4121,-7000,-7000,980,0,0,676008,False,B72A-624H-X968-ATAC
wly83LvAkYA-Hsw,1547104218,KAFE SV CAFFE,5812,5812,-3200,-3200,980,0,96,683008,False,T2E2-P4KM-MEX8-1K7T
SCwA5ufCda_hp2g,1547097430,KAFE SV CAFFE,5812,5812,-6700,-6700,980,0,201,686208,False,4105-C265-5B0H-M11X
6rxunV4mb1QCxpo,1547049159,Cosmo,5977,5977,-7130,-7130,980,0,0,692908,False,0707-H8C6-0075-X0T5
Zma991YeGIfoo7M,1547031153,Lesya,4829,4829,-400000,-400000,980,0,0,700038,True,HH3K-M1B1-KTCK-975X
dYplxABFYDvfO0w,1547030504,–íi–¥: –ü–†–ò–•–û–î–¨–ö–û –ï.–í. –§–û–ü,4829,4829,900000,900000,980,0,0,1100038,True
TD1u5LUCj-jevvE,1547028350,Lesya,4829,4829,-14000,-14000,980,0,0,200038,True,H2C9-521A-K9AA-P673
m3zvtzOGl4s2Mv8,1546938011,VETERANO COFFEE,5814,5814,-4400,-4400,980,0,132,214038,False,E074-ET42-B0X2-7806
3s5LUQpWabAAE0Y,1546883396,Steam,7994,7994,-32900,-32900,980,0,0,218438,False,HAAM-7XMP-40HB-M6MK
cHP8MJbFQEoaxu8,1546878511,KL_KYIV_Brovarsky_31,5541,5541,-70016,-70016,980,0,0,251338,False,EEPP-6AE0-3KPA-A801
uXL6CVBovgSZ6Q8,1546860729,–ê–¢–ë,5499,5499,-12770,-12770,980,0,0,321354,False,7TCB-27C6-X210-CX0T
DMLHjyWYHWqa6iY,1546857004,Wayforpay,4121,4121,-17000,-17000,980,0,0,334124,False,71C5-EC4B-9M6K-M6BA
UYOb4xcDM0ndb2g,1546856987,–ü–∏—Ä–æ–≥–∏ —Ç–∞ –¥—Ä—É–∑—ñ,5814,5814,-4500,-4500,980,0,135,351124,False,XP9M-6M8H-B1H3-H9H8
QvD7ZkQct484xGw,1546856853,–ü–∏—Ä–æ–≥–∏ —Ç–∞ –¥—Ä—É–∑—ñ,5814,5814,-79000,-79000,980,0,2370,355624,False,8TM2-72B8-9T37-9T9E
a_OL0WeLe11BCBw,1546801406,–°–∫–∞—Å—É–≤–∞–Ω–Ω—è. Steam,5816,5816,24900,24900,980,0,0,434624,True
F9ohobBLi_am670,1546795614,Steam,5816,5816,-24900,-24900,980,0,0,409724,False
NuObuTQpf-qZ2lc,1546700680,Beer Market,5921,5921,-8149,-8149,980,0,0,434624,False,HCXK-A3H5-T93P-X3XB
sb6McI5lm4__AdA,1546700239,–ú–µ–≥–∞–º–∞—Ä–∫–µ—Ç,5411,5411,-15220,-15220,980,0,0,492773,False,EMM4-5328-M37H-7B0B
GQ_H9YVfCo81-nc,1546700147,–ú–µ–≥–∞–º–∞—Ä–∫–µ—Ç,5411,5411,-72920,-72920,980,0,0,507993,False,B1E1-MHC7-8X43-03MP
H26HoGJzqixBfMM,1546687472,–§–æ—Ä–∞,5499,5499,-26954,-26954,980,0,0,580913,False,3MHT-70M9-AAT5-9TME
hUl49PcAx270SBw,1546686780,APTEKA92,5912,5912,-31614,-31614,980,0,0,607867,False,K28H-4E02-8K2M-TE5E
YxJhJ8MBWlmu83Q,1546619866,Wayforpay,4121,4121,-14000,-14000,980,0,0,639481,False,5B14-8T45-6PCK-C22H
iG6yl2nbCAXB5Zo,1546610843,Urban Space 500,5812,5812,-67500,-67500,980,0,2025,653481,False,5T58-HKT4-7626-07E5
k7q8AlOyvbBoGwA,1546602147,–í—ñ–¥: –î–µ–Ω–∏—Å –ö–æ—Ç–æ–≤,4829,4829,500,500,980,0,0,720981,True
0ug0g9PM68aGYb0,1546585930,–íi–¥: –ü–†–ò–•–û–î–¨–ö–û –ï.–í. –§–û–ü,4829,4829,700000,700000,980,0,0,720481,True
wAbqZ7nE0pyv3tA,1546523175,–í—ñ–¥: –î–µ–Ω–∏—Å –ö–æ—Ç–æ–≤,4829,4829,13600,13600,980,0,0,20481,True
eNwv67xtTv3qPmo,1546516161,Glovo,4215,4215,-55300,-55300,980,0,0,6881,False,214K-P5PA-4H17-2T8E
PrXD2gyp97pRUGg,1546432469,Steam,5816,5816,-2300,-2300,980,0,0,62181,False,5T09-P66X-H68P-1HPK
2m7Ehp8ye3WCMNM,1546429844,Glovo,4215,4215,-28000,-28000,980,0,0,64481,False,9KP3-2HHA-940T-E8HB
2aXF1E15Anx-ma4,1546364631,Wayforpay,4121,4121,-10500,-10500,980,0,0,92481,False,99T0-HK29-A43K-B528
ed34qCrDV9-lmTc,1546355493,ChEHOLHAUS,5631,5631,-55000,-55000,980,0,0,102981,False,PE45-4M02-M8KX-54X3
o1i1LgFz-Dzd0Rk,1546355298,–ú–µ–≥–∞–º–∞—Ä–∫–µ—Ç,5411,5411,-12000,-12000,980,0,0,157981,False,731A-8PEK-927P-TTPA
PWxUz8yGGAuve1k,1546355231,–ú–µ–≥–∞–º–∞—Ä–∫–µ—Ç,5411,5411,-35923,-35923,980,0,0,169981,False,M301-079K-K07H-542A
0UAbuIhygDAY_W4,1546341272,–í–∏–≤–µ–¥–µ–Ω–Ω—è –∫–µ—à–±–µ–∫—É 131.43‚Ç¥,4829,4829,10579,10579,980,0,0,205904,True
0ZBDtfh56fY8g3k,1546339047,–í—ñ–¥—Å–æ—Ç–∫–∏ –∑–∞ –≥—Ä—É–¥–µ–Ω—å,4829,4829,1355,1355,980,0,0,195325,True
aHNbL-l1BVk3lBQ,1551298088,–ü–∏—Ä–æ–≥–∏ —Ç–∞ –¥—Ä—É–∑—ñ,5814,5814,-13500,-13500,980,0,0,27695,False,K0PA-AH90-8EPT-XMTX
_LzaCKudWIM_uhg,1551285572,–ê–ª–µ–∫—Å–µ–π –í—ã–∫–∞–ª—é–∫ BCD,—Ö–æ—Ç–¥–æ–≥,4829,4829,-7800,-7800,980,300,0,41195,True,P1M0-37B9-2M4C-2M07
MC795UipUUJR8O8,1551257337,APTEKADD00000000005915,5912,5912,-1290,-1290,980,0,0,48995,False,1T87-CABH-BXMM-5A7C
n8hbsKjb03Cqpv4,1551206328,Good Wine,5411,5411,-43500,-43500,980,0,435,50285,False,9ACA-A1EM-MET7-3B16
y3jKhJ2v5r56sgE,1551190888,Glovo,4215,4215,-20600,-20600,980,0,0,93785,False,H56K-P373-39PC-23X4
pqgNJhJKyGSQVLE,1551173096,ProduktiSaks,5499,5499,-12900,-12900,980,0,258,14385,False,K3XX-5CBE-TA52-8E64
1oF5WPB5FtWVkF4,1551164512,–ü–ª–∞—Ç—ñ–∂ COMFY,4829,4829,-137000,-137000,980,0,0,27285,True
_AXjElcbz6iRs3c,1551097944,Glovo,4215,4215,-36800,-36800,980,0,0,164285,False,K3TA-059B-43TE-PBPK
6-0BrWqZbKR63ks,1551096859,Lesya,4829,4829,-300000,-300000,980,0,0,201085,True,0736-X1AM-4H37-X86B
lXdZbmXsjriWpM8,1551091451,414943****7302,4829,4829,-81000,-81000,980,0,0,501085,True,2EE6-3TX7-MAK8-B0B0
7tQfFrBA0koB_dw,1551089602,–°–µ—Ä–≥–µ–π –ù–∞–∑–∞—Ä–æ–≤—Å–∫–∞—è 7,–∫–æ–º–º—É–Ω–∞–ª–∫–∞ —è–Ω–≤–∞—Ä—å üöø,4829,4829,-86400,-86400,980,0,0,582085,True,1P3T-PKA1-0T63-13X9
O8NOTIfEnSNXkBo,1551089543,–°–µ—Ä–≥–µ–π –ù–∞–∑–∞—Ä–æ–≤—Å–∫–∞—è 7,–∞—Ä–µ–Ω–¥–∞ üè°,4829,4829,-1200000,-1200000,980,0,0,668485,True,49B2-1TP4-14TX-KCXA
nNnaHlLF3AiVoJM,1551088782,–íi–¥: –ü–†–ò–•–û–î–¨–ö–û –ï.–í. –§–û–ü,4829,4829,1400000,1400000,980,0,0,1868485,True
Bbi4TBJirboY2K8,1551015217,Steam,5816,5816,-7900,-7900,980,0,0,468485,False,KKXE-T4CK-K1KA-P40C
-wh9V-5pfVJ--TY,1551008825,"–ü–∏—Ä—ñ–∂–∫–æ–≤–∞ ""–¢—ñ—Ç–∫–∞ –ö–ª–∞—Ä–∞""",5814,5814,-6800,-6800,980,0,0,476385,False,1A33-MT9M-CK98-43H1
PM2-hGVCkdtE15k,1551006894,Tommy Gun  Universitet,7230,7230,-70000,-70000,980,0,0,483185,False,M993-MAAM-7TCM-0X7C
EkbEoNyaE8HXNck,1550941138,516798****8706,4829,4829,-165829,-165829,980,0,0,553185,True,2A9E-7TBX-BMXC-2T4P
hmOj8y9e4Eo0T7g,1550931086,–§–æ—Ä–∞,5499,5499,-49298,-49298,980,0,985,719014,False,EX6M-A68H-M884-CBB7
Mlp1SNtsvXD34uE,1550930331,APTEKA TAS 168,5912,5912,-9460,-9460,980,0,0,768312,False,P89C-MP76-AAB2-661C
9iE76w1rh7fJF8E,1550857819,–ü–∏—Ä–æ–≥–∏ —Ç–∞ –¥—Ä—É–∑—ñ,5814,5814,-13500,-13500,980,0,0,777772,False,XTB8-1PA8-X375-EPK9
9mX7_vY3g4XDgZ0,1550857313,Good Wine,5411,5411,-44300,-44300,980,0,886,791272,False,K28K-2574-K2C4-19MX
YZXgXF_tVMzwyJo,1550845567,–°–∫–∞—Å—É–≤–∞–Ω–Ω—è. Google,7399,7399,600,600,980,0,0,835572,True
P6qwkoByDcQQgSg,1550844690,portmone.com.ua,4814,4814,-16000,-16000,980,0,0,834972,False,T629-HH7K-K287-A8HH
P5qitqoo7L4bpKM,1550844665,Google,7399,7399,-600,-600,980,0,0,850972,True
9SII4dxpPirRI6A,1550841437,–ú–∞–∫—Å–∏–º –§–µ—â–µ–Ω–∫–æ,4829,4829,-20000,-20000,980,0,0,851572,True,KE6K-4TBP-K4XK-90X2
sa4Y6UpL04Zm4ZE,1550820780,Kviti,5992,5992,-21000,-21000,980,0,4200,871572,False,02MC-PBMH-K5XC-T64M
sZ7FsaRRg-DVrYc,1550820501,"–ü–∏—Ä—ñ–∂–∫–æ–≤–∞ ""–¢—ñ—Ç–∫–∞ –ö–ª–∞—Ä–∞""",5814,5814,-17200,-17200,980,0,0,892572,False,1A0M-MTAP-9K05-P8P1
PuJnnGXak2izp4E,1550819638,HEALTH AND HAPPY,8099,8099,-17200,-17200,980,0,0,909772,False,79T1-XKA5-7PT3-K1MH
1xhFAJPRFwhC1giaCe_e,1550795196,"–°–∫–∞—Å—É–≤–∞–Ω–Ω—è. ATLANTA-SHOU, 1-16,VUL.LVATOLSTOGO, KYYIV, UA",5733,5733,57500,57500,980,0,0,926972,True
qnW0BLKhGiMLYAs,1550775623,Apteka 1,5912,5912,-13350,-13350,980,0,0,869472,False,3T43-E18K-38AK-BXP6
8rXLeRi9YSFP55A,1550771738,516749****3010,4829,4829,-140000,-140000,980,0,0,882822,True,506E-4X0E-8EEB-P6AK
jqFr265WObdeaCg,1550740371,–ü—Ä–∏–≤–∞—Ç24,6536,6536,11000,11000,980,0,0,1022822,False
3KVggB2bIpOcAbY,1550739813,PRODUKTI,5499,5499,-2600,-2600,980,0,52,1011822,False,P58T-H7KH-T00T-907T
LnqxEMhW0ydwYFg,1550739395,ProduktiBH,5499,5499,-2200,-2200,980,0,44,1014422,False,CXX0-HME9-B17B-TP2A
sDo79madkJ0vGkE,1550739211,–ü–∏—Ä–æ–≥–∏ —Ç–∞ –¥—Ä—É–∑—ñ,5814,5814,-20000,-20000,980,0,0,1016622,False,50P9-2K0P-C563-BE84
WqDrJjoLDZ8Ijjk,1550738094,Lesya,–∂–µ–Ω—É—à–∫–µ üíõ,4829,4829,-400000,-400000,980,0,0,1036622,True,0368-2BT1-HB4A-3719
vUYO3RPjNjWiOFQ,1550688916,McDonald's,5814,5814,-25700,-25700,980,0,0,1436622,False,B8M5-TEHA-731B-AT2B
W43wmX9yEnQHShg,1550688080,516874****5365,4829,4829,-650000,-650000,980,0,0,1462322,True,9KC3-K034-13B0-A99X
CRchHI_kGvV2JN4,1550683976,ATLANTA-SHOU,5733,5733,-34400,-34400,980,0,0,2112322,False,77C0-25B7-B78E-E0XC
9vHGqlp7t88UVO8,1550662911,–ê–ª–µ–∫—Å–µ–π –í—ã–∫–∞–ª—é–∫ BCD,–ª–æ—Å–æ—Å—å,4829,4829,-14900,-14900,980,0,0,2146722,True,5531-25T6-ME3H-4BK8
Gl9Km1KOP70qJ9M,1550606614,portmone.com.ua,7399,7399,-133400,-133400,980,0,0,2161622,False,9PB9-M945-67HC-6EHH
TvoexuI3scr_oTE,1550601461,Glovo,4215,4215,-35500,-35500,980,0,0,2295022,False,P2ME-MTCH-HXAA-2168
9kwXXceUHYDm3pc,1550601126,ATLANTA-SHOU,5733,5733,-57500,-57500,980,0,0,2330522,False
0_IRU_l_Xc3kNYI,1550600287,SINYUK,5499,5499,-8600,-8600,980,0,172,2388022,False,9KPA-43A6-AAEB-B003
7TWA2IeBV7HcYy4,1550600243,SINYUK,5499,5499,-12900,-12900,980,0,258,2396622,False,A3C2-5696-2159-28M5
QhDoTwOkrTr9fUw,1550598774,–ö–∏—ó–≤—Å—å–∫–∏–π –º–µ—Ç—Ä–æ–ø–æ–ªi—Ç–µ–Ω,4111,4111,-800,-800,980,0,0,2409522,False,355M-P707-P0EE-KPAH
8ErFTSfkPuX8LHo,1550596611,–ö–∏—ó–≤—Å—å–∫–∏–π –º–µ—Ç—Ä–æ–ø–æ–ªi—Ç–µ–Ω,4111,4111,-800,-800,980,0,0,2410322,False,677M-44CH-X57P-888K
qcn_3z0GnA4ItwE,1550582736,Glovo,4215,4215,-16100,-16100,980,0,0,2411122,False,8E58-E69X-B33K-5P33
UwgSZ7JNU3T8J9U,1550582443,PRODUKTI,5499,5499,-10000,-10000,980,0,200,2427222,False,P1PX-P05M-E19M-0264
3w8TiS85vcIItxA,1550582021,–ê–ª–µ–∫—Å–µ–π –í—ã–∫–∞–ª—é–∫ BCD,–≥–æ—Å—Ç—å –Ω–æ–º–µ—Ä –æ–¥–∏–Ω,4829,4829,-20000,-20000,980,0,0,2437222,True,37HT-7CP6-92XC-MTKK
rrbMwjtDuQsLQVY,1550578078,–íi–¥: –ü–†–ò–•–û–î–¨–ö–û –ï.–í. –§–û–ü,4829,4829,2500000,2500000,980,0,0,2507222,True
58F0oZTNxgwt0jM,1550518335,MAGAZYN PRODUKTY 2,5411,5411,-4250,-4250,980,0,42,7222,False,4M50-8EXH-P7B7-1CB6
_kmibCw_juiKKfI,1550407767,"–ü–∏—Ä—ñ–∂–∫–æ–≤–∞ ""–¢—ñ—Ç–∫–∞ –ö–ª–∞—Ä–∞""",5814,5814,-7200,-7200,980,0,0,11472,False,1K02-KME1-P1MB-95T5
uPA8xtbSk7Ojktk,1550333444,Glovo,4215,4215,-28000,-28000,980,0,0,18672,False,2589-K2T8-3MA1-754C
sLZQ4pFbVNVn1rc,1550324801,–§—É—Ä—à–µ—Ç,5499,5499,-8888,-8888,980,0,144,46672,False,T406-8AX5-BH0M-4127
qKN-hgvZFxhf-qo,1550321399,magazinkaphe,5814,5814,-13200,-13200,980,0,0,55560,False,69BC-643B-83BC-5CMT
XZMzrCYseW4LxeQ,1550318221,DARI JEWELRY,5944,5944,-75000,-75000,980,0,0,68760,False,018H-KXP7-210X-EE95
Yp835FnKSi21Up0,1550316282,–ö–∏—ó–≤—Å—å–∫–∏–π –º–µ—Ç—Ä–æ–ø–æ–ªi—Ç–µ–Ω,4111,4111,-800,-800,980,0,0,143760,False,07M2-79TE-X494-BP28
eLP12Faa9HRGN24,1550312528,kafeAltruist,5814,5814,-17800,-17800,980,0,0,144560,False,MB26-ACET-KE6H-XBC4
JWIqvdG8hRRANbs,1550312488,KAFE SARAVSARI,5814,5814,-30800,-30800,980,0,0,162360,False,026P-XE87-M7P2-8H40
kKy1J510S4ioX4c,1550243912,Glovo,4215,4215,-29500,-29500,980,0,0,193160,False,0846-C5HM-0CTK-TX98
4Xe1bb4dgABLmiQ,1550235970,–ö–∏—ó–≤—Å—å–∫–∏–π –º–µ—Ç—Ä–æ–ø–æ–ªi—Ç–µ–Ω,4111,4111,-800,-800,980,0,0,222660,False,3CX6-B1KE-HBXE-P75P
P59wic5xLAG1jlA,1550233873,CAFE BILYY SHUM,5812,5812,-22800,-22800,980,0,0,223460,False,163M-P49P-M2EA-1BXB
q35ZWG7OxI-R0i4,1550233841,RESTAURANT BELYY SHUM,5812,5812,-12000,-12000,980,0,0,246260,False,12M5-3978-3P26-TXEA
ZGYSSvUxS1qPo1o,1550231183,–ö–∏—ó–≤—Å—å–∫–∏–π –º–µ—Ç—Ä–æ–ø–æ–ªi—Ç–µ–Ω,4111,4111,-800,-800,980,0,0,258260,False,395C-ABXX-66T4-37HB
CxOFYZd-k_lcb5E,1550223365,PRODUKTI,5499,5499,-4900,-4900,980,0,98,259060,False,B4A7-7P76-102M-X84H
KTkVYk_ssQYXqaM,1550221798,"–ü–∏—Ä—ñ–∂–∫–æ–≤–∞ ""–¢—ñ—Ç–∫–∞ –ö–ª–∞—Ä–∞""",5814,5814,-21500,-21500,980,0,0,263960,False,MP50-2H01-32A0-3CA9
kSHH8CBRqUfOQj0,1550168359,Good Wine,5411,5411,-76900,-76900,980,0,1538,285460,False,B683-M7HH-H18C-62MC
-_UhvGto1QBoUNI,1550148520,–ê–ª–µ–∫—Å–µ–π –í—ã–∫–∞–ª—é–∫ BCD,–º–∏—Ä–∞ –ª–æ—Å–æ—Å—å,4829,4829,-15000,-15000,980,0,0,362360,True,8598-3H25-164T-20E0
oJuywy3gFA8smMs,1550137513,TOV AGP APTEKA N3,5912,5912,-6400,-6400,980,0,0,377360,False,TP62-H64X-7B1K-M070
jHFzOsGYvXesuiY,1550137311,FOP ABRASHYNA KJU,5812,5812,-18500,-18500,980,0,0,383760,False,XX1K-5MKX-MX0X-M602
5BHZLQIVkxnIsuE,1550085132,414949****7383,4829,4829,-10600,-10600,980,0,0,402260,True,AA4P-93HB-1M9B-71KB
Y5X_-O8GEcEv8Mo,1550079233,–ê–ª–µ–∫—Å–µ–π –í—ã–∫–∞–ª—é–∫ BCD,4829,4829,-5000,-5000,980,0,0,412860,True,M3B1-T2A2-H719-73H4
MH7o8uehxX-9GxI,1550060201,Glovo,4215,4215,-19400,-19400,980,0,0,417860,False,710K-712K-5XH8-1MKT
LclMvm5aZ0_HKtc,1550000590,APTEKADD00000000005915,5912,5912,-3350,-3350,980,0,0,437260,False,M8P0-93P5-6HB1-2M2P
DezqwkRFAedSqn8,1549956448,Wayforpay,4121,4121,-7000,-7000,980,0,0,440610,False,P2BX-PTP2-H19H-BC5C
NFz7z9dmSPhPFMo,1549914993,–ê–ø—Ç–µ–∫–∞ –î–æ–±—Ä–æ–≥–æ –î–Ω—è,5912,5912,-12390,-12390,980,0,0,447610,False,X369-2M3C-A72X-3B39
thyfVvD8aEsUBiw,1549891276,–ù–∞ –¥–æ–ª–∞—Ä–æ–≤—É –∫–∞—Ä—Ç–∫—É,4829,4829,-27203,-1000,840,0,0,460000,True
psyp9Qk0Z3M3_30,1549891118,Lesya,4829,4829,-400000,-400000,980,0,0,487203,True,670B-H037-XEMT-E13B
UWvjKuv1yrOEes4,1549889410,Glovo,4215,4215,-80000,-80000,980,0,0,887203,False,135A-9K20-4122-MBTA
tM648HIpDEOy8SM,1549812577,UKRAYINSKAZALIZNYTSYA,4112,4112,-8000,-8000,980,0,0,967203,False,XAPA-T5C7-CA89-EAPT
c4bhs3jpKLrSmrA,1549804898,des fleurs,5992,5992,-65000,-65000,980,0,13000,975203,False,T998-A0HA-2840-P3X3
MKmV_2T_PgLTKx0,1549736497,–í—ñ–¥: –ú–∞–∫—Å–∏–º –§–µ—â–µ–Ω–∫–æ,–∑–∞ –ø–∏–≤–æ,4829,4829,10000,10000,980,0,0,1040203,True
TQXDL9oGuSJMxx0,1549732403,–í–µ–ª–º–∞—Ä—Ç,5499,5499,-48958,-48958,980,0,979,1030203,False,K79T-411K-TXBM-51AX
VBhAGlZ6Cyg8RyQ,1549714408,–§–æ—Ä–∞,5499,5499,-34565,-34565,980,0,691,1079161,False,PT21-1TP5-B4XB-9CXE
U1S1OCVVuhNtBaU,1549714083,–í—ñ–¥: –û–ª–µ–∫—Å—ñ–π –í–∏–∫–∞–ª—é–∫,üçª,4829,4829,10000,10000,980,0,0,1113726,True
pTdCYrcXeQ6gI24,1549713862,APTEKA TAS 168,5912,5912,-5895,-5895,980,0,0,1103726,False,XH8E-BTC0-9221-7BBE
6F0HfRL_4SGwf1U,1549626536,"–ü–∏—Ä—ñ–∂–∫–æ–≤–∞ ""–¢—ñ—Ç–∫–∞ –ö–ª–∞—Ä–∞""",5814,5814,-17700,-17700,980,0,0,1109621,False,60EM-2KH4-T5KB-575X
ecSzFObf1_LcGOE,1549565775,PANTOMAT6,5499,5499,-8550,-8550,980,0,171,1127321,False,6THP-AE92-CT9B-B4K2
FC1-nhEoX9xZtd8,1549565297,PRODUKTI SYM PETLIURY,5411,5411,-2850,-2850,980,0,57,1135871,False,H0A8-T2KK-43HP-X3B4
ern2TZVtv9tadwQ,1549524906,–°–∫–∞—Å—É–≤–∞–Ω–Ω—è. Google,7399,7399,600,600,980,0,0,1138721,True
Rwab8a6L3OOZod8,1549524225,–íi–¥: –ü–†–ò–•–û–î–¨–ö–û –ï.–í. –§–û–ü,4829,4829,1600000,1600000,980,0,0,1688121,True
oiNVnunKUVfUiEg,1549524060,portmone.com.ua,5921,5921,-73400,-73400,980,0,734,88121,False,P607-B4A4-K6KX-XXME
F1ZOAAjyVIuSHR0,1549524002,Google,7399,7399,-600,-600,980,0,0,161521,True
pGG3N7yK2zFwbIs,1549511478,Wayforpay,4121,4121,-46500,-46500,980,0,0,162121,False,1BEB-19B6-6E8C-C35E
Ou6fo2eZlcYaM0E,1549483363,Glovo,4215,4215,-44300,-44300,980,0,0,208621,False,0CC6-KA7H-C93K-40PC
gvSEwvgDkJ2-tTI,1549454928,–ú–∞–∫—Å–∏–º –ó–∞–±–æ–ª–æ—Ç–Ω–∏–π,–º–∞–∫ üçî,4829,4829,-9568,-9568,980,368,0,252921,True,MP8T-8C29-BAPX-44HA
0Hnwq8wplKnpU2M,1549448543,MOREISLOVE COM,5691,5691,-345541,-12700,840,0,0,262489,False,BX4A-1T65-79CP-0MC7
4V22BcpLKwjU2kA,1549448506,–í—ñ–¥: –î–µ–Ω–∏—Å –ö–æ—Ç–æ–≤,4829,4829,17700,17700,980,0,0,608030,True
n0DGhNZNOCofrEA,1549443924,–ü–∏—Ä–æ–≥–∏ —Ç–∞ –¥—Ä—É–∑—ñ,5814,5814,-11500,-11500,980,0,0,65330,False,B9B8-6HB4-T392-EE0H
X3IqgrFSbHvQRQY,1549443901,–ü–∏—Ä–æ–≥–∏ —Ç–∞ –¥—Ä—É–∑—ñ,5814,5814,-17700,-17700,980,0,0,76830,False,CM97-XCP3-0H09-E21E
Fo0CKrpwyiX8SZY,1549372842,414943****1916,4829,4829,-8500,-8500,980,0,0,94530,True,MM2X-HCKB-E5HH-9AX3
5M2ubI6mdqQLaTM,1549353447,Lesya,4829,4829,-1000000,-1000000,980,0,0,103030,True,5B13-ET23-XPA6-8HKB
YBcoLb6EAWX5I8o,1549351882,–ù–æ–≤–∞ –ø–æ—à—Ç–∞,4214,4214,-7600,-7600,980,0,0,1103030,False,P089-K215-870B-AM7B
8lYimr8P7uP4sxE,1549351851,–ù–∞–∫–ª–∞–¥–µ–Ω–∏–π –ø–ª–∞—Ç—ñ–∂ (–ù–æ–≤–∞ –ø–æ—à—Ç–∞),6538,6538,-226400,-226400,980,0,0,1110630,False,E5T8-88A7-9A34-M7P0
bpXoqWHwxQWywxc,1549351665,FOP PROBAChAY OM,742,742,-7500,-7500,980,0,0,1337030,False,3B05-BH06-KAH2-4AX0
s16BQ1vLCIK4iQ0,1549304675,–ê–ø—Ç–µ–∫–∞ –ù–∏–∑—å–∫–∏—Ö –¶—ñ–Ω,5912,5912,-21350,-21350,980,0,0,1344530,False,BHXK-7BA6-C13T-01BC
O5hFFdDNLDRk4Ho,1549296149,Lesya,üë∞,4829,4829,-800000,-800000,980,0,0,1365880,True,914K-K4P5-5HXC-7PP4
bLNUWhrrRB7FAz4,1549285403,414943****1916,4829,4829,-18700,-18700,980,0,0,2165880,True,4C29-06C4-K131-78M0
PErNf-mWSdipLG4,1549284593,–íi–¥: –ü–†–ò–•–û–î–¨–ö–û –ï.–í. –§–û–ü,4829,4829,2300000,2300000,980,0,0,2309580,True
7YF2_eVT5JrnCls,1549267441,PROGRESS CAFFE,5814,5814,-8000,-8000,980,0,0,9580,False,5BAA-1E47-8M51-1X42
k5z__KDb3D7sC7M,1549265664,Wayforpay,7832,7832,-12600,-12600,980,0,0,17580,False,H03E-XT9E-496K-1K4A
-9O0nimWRw0q7rM,1549260014,–ö–∏—ó–≤—Å—å–∫–∏–π –º–µ—Ç—Ä–æ–ø–æ–ªi—Ç–µ–Ω,4111,4111,-800,-800,980,0,0,30180,False,HB6K-A88K-2P78-AB94
Ar2PPsBTCzdA_u8,1549258022,–ö–∏—ó–≤—Å—å–∫–∏–π –º–µ—Ç—Ä–æ–ø–æ–ªi—Ç–µ–Ω,4111,4111,-800,-800,980,0,0,30980,False,HMH7-TM01-A8CK-42E5
-VnPuvXr3Cx-EOw,1549129728,–í–µ–ª–º–∞—Ä—Ç,5499,5499,-8600,-8600,980,0,86,31780,False,XPKC-T93E-PT50-1B2M
FuhC9hbn-Dzo1WM,1549129595,–í–µ–ª–º–∞—Ä—Ç,5499,5499,-49820,-49820,980,0,498,40380,False,5A0C-7HB2-8K35-60T5
IjppOjY7LuIubrM,1549123564,KL_KYIV_Preobr_1,5541,5541,-70016,-70016,980,0,0,40200,False,TBHX-T6AH-5127-X794
2vPqzi-rXs228bY,1549122639,FOPTischenko,742,742,-80000,-80000,980,0,0,110216,False,146A-B8BB-MM64-C359
OD21OqEBOBlaM6g,1549103346,Glovo,4215,4215,-20000,-20000,980,0,0,190216,False,2663-X6X6-BK23-2X7P
pX1gh_fZS2oYGIg,1549052135,–í—ñ–¥: –û–ª–µ—Å—è –°–∞—á–µ–Ω–∫–æ,4829,4829,100,100,980,0,0,210216,True
VngPmxEOoCxhKiE,1549052026,–í—ñ–¥—Å–æ—Ç–∫–∏ –∑–∞ —Åi—á–µ–Ω—å,4829,4829,2866,2866,980,0,0,210116,True
UE_qTMJuKjxLDEk,1549042336,516875****8993,4829,4829,-41000,-41000,980,0,0,207250,True,6AAC-60TH-14E9-1HB2
xezyenq9Llf2MAw,1553962467,LIQPAY*cipollino,5812,5812,-27050,-27050,980,0,0,62779,False,XB35-3210-T930-X8KA
aIG6iX33GiZYQhs,1553942445,FOP GUSAKOV VYu,5995,5995,-65770,-65770,980,0,0,89829,False,B089-PHPB-CKH5-PP6H
LkaoDcOjOnQrIhM,1553941910,–í—ñ–¥: –û–ª–µ—Å—è –°–∞—á–µ–Ω–∫–æ,4829,4829,20000,20000,980,0,0,55599,True
3LHqpMm0Z0y9FDk,1553940650,SHOP GLO,5993,5993,-99900,-99900,980,0,0,35599,False,34B8-1KB4-7KM1-074C
lPctK-Yuy1z3_W4,1553940030,Lesya,4829,4829,-200000,-200000,980,0,0,135499,True,MKMP-MP1C-7178-MC12
Mz7RE69eZfN7RBY,1553870270,–ü—Ä–∏–≤–∞—Ç24,6536,6536,13200,13200,980,0,0,335499,False
_XD044PZt2VLt-A,1553868812,–ü—Ä–∏–≤–∞—Ç24,6536,6536,10000,10000,980,0,0,322299,False
CBA9mjvBtHAw2lQ,1553865271,Glovo,4215,4215,-50000,-50000,980,0,0,312299,False,P7PE-A7X7-3B28-08XB
402aRWnjaNr4t_8,1553863196,Glovo,4215,4215,-14900,-14900,980,0,0,362299,False,0A05-0T8T-0049-M5TA
ZdWgm2Ny2L8_tJc,1553853956,Produkti,5499,5499,-10000,-10000,980,0,0,377199,False,X42E-PMMK-735K-B7E1
-OOGcjuV9we7kCg,1553843435,–°–∫–∞—Å—É–≤–∞–Ω–Ω—è. Wayforpay,4121,4121,4900,4900,980,0,0,387199,True
zX0d7aWD0G7Wf8E,1553841456,Wayforpay,4121,4121,-4900,-4900,980,0,0,382299,True
soE-FhQ7LEoBpm6EWiw,1553817707,–°–∫–∞—Å—É–≤–∞–Ω–Ω—è. Glovo,4215,4215,9000,9000,980,0,0,387199,True
OUFCWOMflGbj4Yo,1553780257,"–ü–∏—Ä—ñ–∂–∫–æ–≤–∞ ""–¢—ñ—Ç–∫–∞ –ö–ª–∞—Ä–∞""",5814,5814,-16000,-16000,980,0,0,378199,False,M026-5HTM-4461-K1MM
pz2axtC2bWxRs-o,1553760163,Glovo,4215,4215,-24000,-24000,980,0,0,394199,False
_uzEtD1Dx7SC6HY,1553698408,ProduktiSaks,5499,5499,-21900,-21900,980,0,0,418199,False,8BCA-8CC6-7E73-14PX
Hndg-_Bi-psrfZs,1553672573,–°–∫–∞—Å—É–≤–∞–Ω–Ω—è. Google,7399,7399,600,600,980,0,0,440099,True
9xuHzAKUyZ6NZGY,1553671698,portmone.com.ua,4814,4814,-20000,-20000,980,0,0,439499,False,C148-EKX7-44B1-ET28
l3mcQ0o6tAHhsDU,1553671667,Google,7399,7399,-600,-600,980,0,0,459499,True
mxvykKdFOqGPvaQ,1553636633,Taxi,4121,4121,-10500,-10500,980,0,0,460099,False,TM2A-4KMK-7372-CEH7
FAl3OpVYmhU5Zvs,1553630418,FOP PROBAChAY OM,742,742,-50400,-50400,980,0,0,470599,False,E4M8-C6TP-XKPA-89E8
zblEUrFywftpeKM,1553630253,Taxi,4121,4121,-10500,-10500,980,0,0,520999,False,3AHE-A200-MM45-P65H
CIb0Ed5dqn1sOhY,1553617797,SIMPL344,5814,5814,-6800,-6800,980,0,0,531499,False,E9XH-62K1-3852-28HA
T0wyhuuOKp91_F4,1553617671,PRODUKTI SYM PETLIURY,5411,5411,-18600,-18600,980,0,0,538299,False,BC5H-K1H9-1X5M-8P6H
TKjEyGZUmtNyAio,1553602962,"–ü–∏—Ä—ñ–∂–∫–æ–≤–∞ ""–¢—ñ—Ç–∫–∞ –ö–ª–∞—Ä–∞""",5814,5814,-32200,-32200,980,0,0,556899,False,A251-HBK9-X2PM-2KCB
yBvG3IrDNZQWAtM,1553601438,Glovo,4215,4215,-12000,-12000,980,0,0,589099,False,0925-E351-925C-K79T
NclhhtXQwyY4Fh4,1553589746,–ù–æ–≤–∞ –ø–æ—à—Ç–∞,4214,4214,-5400,-5400,980,0,0,601099,False,EBB3-4M53-E6TE-5T7B
55sAk0MgXwrqmv0,1553589053,–°–∫–∞—Å—É–≤–∞–Ω–Ω—è. Google,7399,7399,600,600,980,0,0,606499,True
hYCTexPo0YBFACo,1553588224,Wayforpay,5995,5995,-68000,-68000,980,0,0,605899,False,PK7K-P42K-AMBK-1PHP
PYQWdQsmZbK5gks,1553588151,Google,7399,7399,-600,-600,980,0,0,673899,True
elNx0QYWOSqprAo,1553585072,–ü–ª–∞—Ç—ñ–∂ COMFY,4829,4829,-137000,-137000,980,0,0,674499,True
95DdlmWeaAr040s,1553539756,–ù–∞ –¥–æ–ª–∞—Ä–æ–≤—É –∫–∞—Ä—Ç–∫—É,4829,4829,-32460,-1200,840,0,0,811499,True
DMp1YTNmiZv6MrI,1553536014,Glovo,4215,4215,-37900,-37900,980,0,0,843959,False,PPT8-PX3C-5T7X-K5EX
UYpDeWrR-tzYG1k,1553528554,–°–∫–∞—Å—É–≤–∞–Ω–Ω—è. Google,7399,7399,600,600,980,0,0,881859,True
bPlE9ShnlmrTE60,1553527703,Wayforpay,5995,5995,-104400,-104400,980,0,0,881259,False,7M71-E23M-958P-PT4T
smnsB1iwsXFnaSU,1553527653,Google,7399,7399,-600,-600,980,0,0,985659,True
GedMXmuHN1pAoT0,1553527417,–î–µ–Ω–∏—Å –ö–æ—Ç–æ–≤,–º–∞–∫,4829,4829,-9400,-9400,980,0,0,986259,True,42X5-4HC3-18T7-6KBH
8nsIyvZWl97q6WM,1553516083,–°–µ—Ä–≥–µ–π –ù–∞–∑–∞—Ä–æ–≤—Å–∫–∞—è 7,–∫–æ–º–º—É–Ω–∞–ª–∫–∞ —è–Ω–≤–∞—Ä—å üöø,4829,4829,-186600,-186600,980,0,0,995659,True,HA87-1TKE-E2M2-33A2
KXhxzCg_8s5ZQEM,1553516030,–°–µ—Ä–≥–µ–π –ù–∞–∑–∞—Ä–æ–≤—Å–∫–∞—è 7,–∞—Ä–µ–Ω–¥–∞ üè°,4829,4829,-1200000,-1200000,980,0,0,1182259,True,9674-B865-T4M6-4K6X
oucueKi1rCFQarM,1553515646,–íi–¥: –ü–†–ò–•–û–î–¨–ö–û –ï.–í. –§–û–ü,4829,4829,2200000,2200000,980,0,0,2382259,True
d6O-YeRfFrpDptA,1553505644,–í—ñ–¥–µ–Ω—Å—å–∫—ñ –±—É–ª–æ—á–∫–∏,5814,5814,-4800,-4800,980,0,0,182259,False,C2X2-31A1-K43A-T4X1
eyfw43vueHSXNT8,1553449007,Glovo,4215,4215,-49500,-49500,980,0,0,187059,False,88A3-P82H-367A-6B55
5w9xSu_17eqvUG4,1553446224,FOP PROBAChAY OM,742,742,-67700,-67700,980,0,0,236559,False,6883-80ME-CPB3-5K1B
a-Tt1tyBBN6bLAc,1553436377,APTECHN PUNKT 3,5912,5912,-21700,-21700,980,0,0,304259,False,AM73-2X0H-T7EA-86CT
NZ_TTWI0tohDnAI,1553427978,"–ü–∏—Ä—ñ–∂–∫–æ–≤–∞ ""–¢—ñ—Ç–∫–∞ –ö–ª–∞—Ä–∞""",5814,5814,-18100,-18100,980,0,0,325959,False,379P-6219-65E4-94MT
pDpV26hFRfKQRmc,1553427650,–õ–∞–ø-–£—Å–∏–∫,5995,5995,-8690,-8690,980,0,0,344059,False,2TMX-91X9-6CKC-2C88
ZJtzeM0EXK-Kc5U,1553427276,TOV ANC TM APTEKA 22,5912,5912,-13610,-13610,980,0,0,352749,False,79K9-6E31-M34M-3PT4
VnM3ffQ18om9raQ,1553426967,ProduktiSaks,5499,5499,-12850,-12850,980,0,0,366359,False,E4KC-M265-1C4A-6C06
4vuWcynG6xTg8t4,1553365654,–ë–∞–Ω–∫–æ–º–∞—Ç DN00 Saksahanskoho  st,6011,6011,-100500,-100500,980,500,0,379209,False,87PT-H93C-A0ET-ET91
e7ls5eUQ6HOcFrc,1553365355,APTEKADD00000000005915,5912,5912,-33530,-33530,980,0,0,479709,False,K0HT-6B20-4633-H0KE
xN7A2x9XUB-kiJ8,1553355782,"–ü–∏—Ä—ñ–∂–∫–æ–≤–∞ ""–¢—ñ—Ç–∫–∞ –ö–ª–∞—Ä–∞""",5814,5814,-10400,-10400,980,0,0,513239,False,72KP-105E-ECHB-KT6C
4qvd53s0o4GA7Fc,1553342384,Wayforpay,4121,4121,-5000,-5000,980,0,0,523639,False,HH04-1HE6-65B6-7KEM
ivEN_Svk2aGC7Gc,1553331123,Wayforpay,4121,4121,-5500,-5500,980,0,0,528639,False,A5EB-01BC-3359-6XXC
KAj7uZPkIOwzVj8,1553280979,Wayforpay,4121,4121,-10000,-10000,980,0,0,534139,False,KT2X-8K41-E66B-X237
3ZZbUJS1kTDQqcE,1553277659,Taxi,4121,4121,-10500,-10500,980,0,0,544139,False,CT59-2KMK-AA1P-845B
KfCzHcwTs_zG1lo,1553254878,–°–∫–∞—Å—É–≤–∞–Ω–Ω—è. Google,7399,7399,600,600,980,0,0,554639,True
oHHHbS6cZxGnlCI,1553254020,Wayforpay,5995,5995,-40100,-40100,980,0,0,554039,False,284M-9870-9016-M756
bxQk92FYamKv0To,1553253971,Google,7399,7399,-600,-600,980,0,0,594139,True
1OM7sIdCXwD_4kI,1553252216,Wayforpay,4121,4121,-6000,-6000,980,0,0,594739,False,27ME-KP4E-TTC7-E67P
9eI1aJseOlSTHeY,1553247807,Pastateca,5812,5812,-32000,-32000,980,0,0,600739,False,E436-68MH-C166-03K4
9n8vmkzeacCmd2I,1553245267,MED TSENTR OMEGA-KYIIV,8099,8099,-216000,-216000,980,0,0,632739,False,492C-6479-6CAP-B153
mEf-YV109cfo6Oc,1553241782,–í—ñ–¥: –ú–∞–∫—Å–∏–º –§–µ—â–µ–Ω–∫–æ,—è–±–ª—É—á–Ω–∏–π —Å—ñ–∫,4829,4829,2500,2500,980,0,0,848739,True
Y-Bd0l246dtRMKc,1553200304,–í—ñ–¥: –û–ª–µ–∫—Å—ñ–π –í–∏–∫–∞–ª—é–∫,—Ç–∏ –º–µ–Ω—ñ –¥–∞–±–ª –Ω–∞ –¥–Ω—è—Ö –∫—É–ø—É–≤–∞–≤,4829,4829,4600,4600,980,0,0,846239,True
Epny2wVcUE7hOcE,1553196905,RESTAURANT KHMILNYY KN,5812,5812,-30500,-30500,980,0,0,841639,False,PP4A-7K61-ACAX-19XP
00jYBzDy2v06IHQ,1553196876,RESTORAN KHMILNYY KNYA,5812,5812,-38000,-38000,980,0,0,872139,False,A5H1-A865-C4B7-BA24
O_6wXJhMcyDd2dc,1553196658,–í—ñ–¥: –û–ª–µ–∫—Å—ñ–π –í–∏–∫–∞–ª—é–∫,üçªüôè,4829,4829,25000,25000,980,0,0,910139,True
P_gWY-E8CMGzm1w,1553176825,–ê–ª–µ–∫—Å–µ–π –í—ã–∫–∞–ª—é–∫ BCD,3 —Å–æ—Å–∏—Å–∫–∏ üå≠,4829,4829,-7500,-7500,980,0,0,885139,True,K920-KEP1-HE72-ACX3
gI579xsAL_UXnQQ,1553175703,PRODUKTI,5499,5499,-5200,-5200,980,0,0,892639,False,AK66-KBT8-M877-1KT8
1prZumoHZ-xgmFk,1553174226,"–ü–∏—Ä—ñ–∂–∫–æ–≤–∞ ""–¢—ñ—Ç–∫–∞ –ö–ª–∞—Ä–∞""",5814,5814,-1800,-1800,980,0,0,897839,False,K5MH-1290-5C57-MXH7
-nWSF-3uNLQAM0Q,1553152824,Lesya,4829,4829,-500000,-500000,980,0,0,899639,True,0H04-5HM6-TE87-AXT2
W-zcl7gkB9EUTbg,1553113954,VARVAR BAR,5812,5812,-16000,-16000,980,0,0,1399639,False,HHX5-9T3H-9H60-9X0A
XCiA1TSx3LMsxNU,1553101926,Lesya,4829,4829,-20000,-20000,980,0,0,1415639,True,CP2T-5M62-5BX6-2KHC
zgXLhjcnTqtAnF4,1553100202,–ù–∞ –¥–æ–ª–∞—Ä–æ–≤—É –∫–∞—Ä—Ç–∫—É,4829,4829,-41134,-1500,840,0,0,1435639,True
KLJffpw6UlqpKtE,1553095885,–íi–¥: –ü–†–ò–•–û–î–¨–ö–û –ï.–í. –§–û–ü,4829,4829,1500000,1500000,980,0,0,1576773,True
xil-C-_fj57t4AY,1553090565,Glovo,4215,4215,-30000,-30000,980,0,0,76773,False,5A15-557H-52EK-MEH9
jZ14dSz817DL_ww,1553066317,"–ü–∏—Ä—ñ–∂–∫–æ–≤–∞ ""–¢—ñ—Ç–∫–∞ –ö–ª–∞—Ä–∞""",5814,5814,-5600,-5600,980,0,0,6773,False,2744-PPEH-213H-1K7A
lecQvnhDg-pBjDc,1553006249,Lesya,4829,4829,-20000,-20000,980,0,0,12373,True,11B8-2H9X-9TP5-TEP7
ty18356Vc2f9uZQ,1552997489,Produktova Lavka,5499,5499,-2400,-2400,980,0,0,32373,False,25BC-ECCC-49P2-KATE
8BH2GhLPEv4crDo,1552996883,"–ü–∏—Ä—ñ–∂–∫–æ–≤–∞ ""–¢—ñ—Ç–∫–∞ –ö–ª–∞—Ä–∞""",5814,5814,-19600,-19600,980,0,0,34773,False,8T3E-A206-9XEB-7P52
armkIiwLck9gHFc,1552912982,STEYKHAUS1,5812,5812,-1800,-1800,980,0,0,54373,False,67MP-6T9E-T5A5-89EX
sG997oMjLsvjaaw,1552912898,STEYKHAUS1,5812,5812,-8000,-8000,980,0,0,56173,False,XAXK-39C5-7E0K-HBP1
6pA9GZ8cVQLxBj8,1552894084,Lesya,–Ω–∞ –ø–∏–¥–∞—Ä—É–Ω–∫–∏!!! üòçüòçüòçüòãüòãüòãüòäüòäüòäüòÄüòÅ,4829,4829,-300000,-300000,980,0,0,64173,True,6CB7-T1M5-6C07-T8E8
43a2-5qo2KBoUXk,1552847981,–í–µ–ª–º–∞—Ä—Ç,5499,5499,-57410,-57410,980,0,0,364173,False,9PM9-K082-MEME-X1B5
Ywfpb2V8PeU6LXg,1552847909,Lesya,4829,4829,-15000,-15000,980,0,0,421583,True,10XP-A6X4-AA3E-14BB
r_gi5Iq3-RKf7fA,1552822444,Salon czvetochnogo diz,5992,5992,-7900,-7900,980,0,0,436583,False,3050-3MCC-MCMH-P5M4
BfWdwGDh5nVIhCY,1552818636,Kavun,5814,5814,-21000,-21000,980,0,0,444483,False,B6A5-1X2E-H43C-54BH
Q-rbzk1hOL9NqoU,1552815240,KGR RELAX PARK VERHOLY,5812,5812,-76601,-76601,980,0,0,465483,False,BTCX-HAC1-X53M-1EEE
fql45R-a_QoiU6A,1552815180,KGR RELAX PARK VERHOLY,5812,5812,-310500,-310500,980,0,0,542084,False,23P9-P14B-9ET1-204P
9pQKV4Uu3ThBWiw,1552766521,FOODANDFOREST,5812,5812,-54500,-54500,980,0,0,852584,False,87EA-2114-HXMT-AXX3
OZHPCL8KSsH6RE4,1552766476,FOOD AND FOREST,5812,5812,-132070,-132070,980,0,0,907084,False,A7A7-7457-6C8H-XH05
PLhmTSA37QA4ugY,1552648018,FOOD AND  FOREST,5812,5812,-28300,-28300,980,0,0,1039154,False,P19B-0866-7329-91C1
Sg-4Vo9sf_tOVuQ,1552647988,Food and  Forest,5812,5812,-22400,-22400,980,0,0,1067454,False,5A3P-135C-H5T9-P62P
Y7GOF11olLpnOwU,1552638105,Kavun,5814,5814,-21000,-21000,980,0,0,1089854,False,TX0C-K71X-M20E-A1B2
1igqkEAZoXoG8wQ,1552566945,–ù–∞ –¥–æ–ª–∞—Ä–æ–≤—É –∫–∞—Ä—Ç–∫—É,4829,4829,-40465,-1500,840,0,0,1110854,True
sp5sTFIBvGECtF0,1552561404,–íi–¥: –ü–†–ò–•–û–î–¨–ö–û –ï.–í. –§–û–ü,4829,4829,1000000,1000000,980,0,0,1151319,True
uAn_TQcZrsGMz5c,1552559364,Glovo,4215,4215,-36850,-36850,980,0,0,151319,False,MAPK-4A15-BKX7-876H
cQgvnPcZpbKB5FM,1552552009,"–ü–∏—Ä—ñ–∂–∫–æ–≤–∞ ""–¢—ñ—Ç–∫–∞ –ö–ª–∞—Ä–∞""",5814,5814,-12700,-12700,980,0,0,188169,False,K2C4-PM25-X3X6-X5K8
EWn-6Q4_4kdCrnk,1552499839,PROGRESS CAFFE,5814,5814,-7000,-7000,980,0,0,200869,False,E2CE-E436-1E3P-2PHH
Px3mgJafFccVfxk,1552416912,VARVAR BAR,5812,5812,-16000,-16000,980,0,0,207869,False,2H04-P1BA-08B4-A25H
_jrZB29f8cX98XQ,1552390277,–í–ª–∞–¥–∏—Å–ª–∞–≤ –ì—É—Ä–æ–≤,4829,4829,-6700,-6700,980,0,0,223869,True,BCCP-TK5B-8PPB-85AA
avUI2-ZvzSUEzHw,1552387502,FABRIKANT,5812,5812,-30300,-30300,980,0,0,230569,False,00X1-ATAK-099C-X87E
y1TPOnkJ_FrAe6E,1552374293,–í—ñ–¥: –í–ª–∞–¥–∏—Å–ª–∞–≤ –ß–æ—Ä–Ω–∏–π,–º–∞—Ä—à—Ä—É—Ç–∫–∞ –≤ —É–º–∞–Ω—å,4829,4829,18000,18000,980,0,0,260869,True
-MUb4Q6f4ZaB3i4,1552331980,Wayforpay,4121,4121,-7000,-7000,980,0,0,242869,False,0131-T1BT-P393-PEH0
HDUHm5sEOFu9Wak,1552331787,Riccio,5812,5812,-118001,-118001,980,0,0,249869,False,MBA6-3T56-A4A7-B62A
kaPVmzoigJXzaiM,1552326424,–ö–∏—ó–≤—Å—å–∫–∏–π –º–µ—Ç—Ä–æ–ø–æ–ªi—Ç–µ–Ω,4111,4111,-800,-800,980,0,0,367870,False,C327-X09P-4M72-4HC3
BQ_IeiDoAAPu138,1552325700,Wayforpay,4121,4121,-7000,-7000,980,0,0,368670,False,CAA7-8CMA-T861-X53X
k9hRqyJOrHR-YRw,1552321556,–ö–æ—Å—Ç—è–Ω—Ç–∏–Ω –ê—Ñ–∞–Ω–∞—Å—å—î–≤,üå∑,4829,4829,-70000,-70000,980,0,0,375670,True,2749-317K-9KEM-7KKK
BUk1ZxRqyZUKQEs,1552319761,Miniso,5200,5200,-7800,-7800,980,0,0,445670,False,8013-998A-ACX8-M405
O_cgRyCMoVgngVY,1552312108,"–ü–∏—Ä—ñ–∂–∫–æ–≤–∞ ""–¢—ñ—Ç–∫–∞ –ö–ª–∞—Ä–∞""",5814,5814,-20200,-20200,980,0,0,453470,False,KK59-3MPT-8847-8140
issOEKfTMRdn0Zc,1552304599,Lesya,4829,4829,-1100000,-1100000,980,0,0,473670,True,KT4H-1E07-B8EX-HMHH
dPaLKCt-d_7HowE,1552303037,–ù–∞ –¥–æ–ª–∞—Ä–æ–≤—É –∫–∞—Ä—Ç–∫—É,4829,4829,-53234,-2000,840,0,0,1573670,True
qLMR0atYam71AC4,1552300969,–íi–¥: –ü–†–ò–•–û–î–¨–ö–û –ï.–í. –§–û–ü,4829,4829,1700000,1700000,980,0,0,1826904,True
Gnk2F-Z9eIPdBKk,1552233129,–ü–ª–∞—Ç—ñ–∂ COMFY,4829,4829,-135234,-135234,980,0,0,126904,True
qAGjZiRSq7IWI0A,1552230926,WOG,5541,5541,-50018,-50018,980,0,0,62138,False,T0XC-9E3M-CE88-6MEM
x_VfG7pddbdbjHY,1552223302,–§–æ—Ä–∞,5499,5499,-26750,-26750,980,0,0,112156,False,THEA-13HA-5E87-XMC1
WYPvN3k-PQ-4XNc,1552220833,McDonald's,5814,5814,-8100,-8100,980,0,0,138906,False,9BBC-8H1X-HHM8-T45A
d0NyrChzpDFyHIs,1552219988,McDonald's,5814,5814,-14600,-14600,980,0,0,147006,False,M2T4-A4E0-148K-CTB7
zJnmykDjc0CzWCY,1552157055,Lesya,4829,4829,-50000,-50000,980,0,0,161606,True,H6HT-41P6-BEXA-T8TA
CztKqpaQ8-c6mUc,1552136552,"–ü–∏—Ä—ñ–∂–∫–æ–≤–∞ ""–¢—ñ—Ç–∫–∞ –ö–ª–∞—Ä–∞""",5814,5814,-23400,-23400,980,0,0,211606,False,B3K0-HB30-B6X1-A835
TVp9GvENGYqzkTc,1552135854,–ù–æ–≤–∞ –ø–æ—à—Ç–∞,4214,4214,-4200,-4200,980,0,0,235006,False,65C6-K56T-XA70-3TXX
PUelVODTvCoTRg0,1552053533,Lesya,4829,4829,-75000,-75000,980,0,0,239206,True,ME95-94BM-MX09-2H93
URsr3RMd9LGxTk4,1552053494,–í–∏–≤–µ–¥–µ–Ω–Ω—è –∫–µ—à–±–µ–∫—É 500.00‚Ç¥,4829,4829,40250,40250,980,0,0,314206,True
Emd2BSglc5dMiaY,1552050885,Biokon,5912,5912,-6990,-6990,980,0,0,273956,False,EM86-0KB1-0P6B-HMX3
7o7S7PdykbRygCo,1552050090,restoranChIChIKO1,5812,5812,-208706,-208706,980,0,4446,280946,False,9B96-X130-7BB4-853X
-w2Rrb9Hn1aw7fA,1552050061,restoran ChIChIKO,5812,5812,-79500,-79500,980,0,2385,489652,False,4845-3M56-3395-44M5
eiZUzl5I0oaIwjg,1552039554,–ö–∏—ó–≤—Å—å–∫–∏–π –º–µ—Ç—Ä–æ–ø–æ–ªi—Ç–µ–Ω,4111,4111,-800,-800,980,0,0,569152,False,MCK8-HM3T-58HT-0XBM
iUkpV-udmSenujk,1552039273,Rozetka,5732,5732,-45000,-45000,980,0,0,569952,False,4H0A-40CB-XA1B-3MB6
JyDkeJy9xWsNe_o,1552038224,Wayforpay,4121,4121,-5900,-5900,980,0,0,614952,False,7P70-8PA9-H17M-8C0E
bHEEn2YciMYnd9k,1551987382,PROGRESS CAFFE,5814,5814,-8000,-8000,980,0,240,620852,False,0HAA-C70X-XCA2-TT2K
3OSJ6zfs7szWICQ,1551970273,–í—ñ–¥: –í–ª–∞–¥–∏—Å–ª–∞–≤ –ß–æ—Ä–Ω–∏–π,4829,4829,7900,7900,980,0,0,628852,True
0x3Qejvw-T2k_J4,1551966687,Glovo,4215,4215,-40500,-40500,980,0,0,620952,False,7P7T-CE70-3PM8-C2H6
eVTZM6sC9gu8Cp0,1551889443,Glovo,4215,4215,-14700,-14700,980,0,0,661452,False,B40P-C98A-8PHA-6705
ztCKmoYMBv5nq5A,1551865145,Urban Space 500,5812,5812,-25000,-25000,980,0,750,676152,False,HC26-HBEC-45M3-A0B2
G7eDul7oN0y9IEk,1551803546,Lesya,4829,4829,-400000,-400000,980,0,0,701152,True,HTAT-XB0K-85B2-92AB
M7MA1-_UtZLoe9Q,1551791572,–íi–¥: –ü–†–ò–•–û–î–¨–ö–û –ï.–í. –§–û–ü,4829,4829,1100000,1100000,980,0,0,1101152,True
rg_uuYVrSHdpZO8,1551790439,Lesya,4829,4829,-10000,-10000,980,0,0,1152,True,XCPP-9C55-H9K9-AMXT
4-mT6Gk1PM5L2H0,1551789526,PROGRESS CAFFE,5814,5814,-12500,-12500,980,0,375,11152,False,1HK4-M6K4-C1E7-3301
QmPty1ipg_5L7Mg,1551786967,Lesya,4829,4829,-20000,-20000,980,0,0,23652,True,8TX7-XHB2-66T2-122E
DQ1eNMk2YtR1PQE,1551779150,Fotovramke,5946,5946,-9500,-9500,980,0,0,43652,False,4240-8X09-BBBT-A5C6
cmaxqtrq_xgx6fc,1551774416,–°–∫–∞—Å—É–≤–∞–Ω–Ω—è. Google,7399,7399,600,600,980,0,0,53152,True
Cn6zic8fD-_g9yU,1551773623,Wayforpay,5995,5995,-53200,-53200,980,0,0,52552,False,2HMK-EC40-XX63-CX3M
IFuefSrJqrTpDEw,1551773514,Google,7399,7399,-600,-600,980,0,0,105752,True
7Q6_gBi8PRYu3mE,1551765945,Wayforpay,4121,4121,-1000,-1000,980,0,0,106352,False,7749-5T56-8HTC-BTHT
Auo64nyAkeGltpY,1551732898,Wayforpay,4121,4121,-5900,-5900,980,0,0,107352,False,BA4T-PM6E-17KA-01B4
JP8bXWvPC9zPNZ4,1551718989,"–ü–∏—Ä—ñ–∂–∫–æ–≤–∞ ""–¢—ñ—Ç–∫–∞ –ö–ª–∞—Ä–∞""",5814,5814,-3000,-3000,980,0,90,113252,False,8XP4-625B-X868-4M97
jiEJ2kKVfl8zMx8,1551717181,–°–∫–∞—Å—É–≤–∞–Ω–Ω—è. Wayforpay,4121,4121,7400,7400,980,0,0,116252,True
o-euTzsMRuaQLSk,1551715328,Wayforpay,4121,4121,-7400,-7400,980,0,0,108852,True
yWXSgu_aPDwe_l8,1551707758,–ü—Ä–∏–≤–∞—Ç24,6536,6536,70000,70000,980,0,0,116252,False
S650NqiSG805baA,1551707385,Floristicheskayastudiy,5992,5992,-70000,-70000,980,0,14000,46252,False,T420-63XT-HM3E-03AM
7sgaA6yQPKjbT7U,1551707179,–í—ñ–¥: –û–ª–µ—Å—è –°–∞—á–µ–Ω–∫–æ,4829,4829,40000,40000,980,0,0,116252,True
f67D-2eoSW597Ig,1551685944,Wayforpay,4121,4121,-7300,-7300,980,0,0,76252,False,3PA0-00T3-4XBK-EP4C
7dB3r5SSeO7e2to,1551685597,Salateira,5814,5814,-8501,-8501,980,0,255,83552,False,4B81-AHM9-577X-35K4
rIKsJ0I_hhBMK3s,1551635690,des fleurs,5992,5992,-50000,-50000,980,0,10000,92053,False,K613-TX3B-9CA7-E719
SeRxJ_QktvZWvtE,1551612507,STATION,5814,5814,-54500,-54500,980,0,1635,142053,False,2KE9-B7TM-6TH4-T68P
uPEhKs4-y8cJ2Pk,1551612454,Baker Street,5441,5441,-64200,-64200,980,0,0,196553,False,0XM9-1KCA-XPM3-5M5H
L8UU2KMzl_-OKlw,1551610729,–í–µ–ª–º–∞—Ä—Ç,5499,5499,-52482,-52482,980,0,0,260753,False,4PX0-CCH9-39C7-P68K
dDl3J2sHiaGa_to,1551603474,ProduktiSaks,5499,5499,-16800,-16800,980,0,0,313235,False,7P0E-6T8T-A5A8-E757
3wdmzAKpigElRT4,1551542664,VARVAR BAR,5812,5812,-18500,-18500,980,0,555,330035,False,2088-E8AA-P5H7-5AC5
lDnXLWduFXMA9ac,1551539918,Magazin,5499,5499,-189554,-189554,980,0,0,348535,False,A0H7-X7C3-K645-PT15
ipLS1OP8mRoX-OA,1551445522,Floristicheskayastudiy,5992,5992,-70000,-70000,980,0,14000,538089,False,AE6T-MM66-TKM3-KB42
Yg1VhV6bB0U7hz8,1551444881,CafeBlueCup,5814,5814,-7800,-7800,980,0,234,608089,False,A3TC-CCC6-TMP6-XKET
2SIALTRt5NLKF8I,1551444282,Urban Space 500,5812,5812,-34500,-34500,980,0,1035,615889,False,35TT-M6EH-XM63-HHT8
JAVSNRHYucivNUE,1551444064,–í—ñ–¥: –û–ª–µ—Å—è –°–∞—á–µ–Ω–∫–æ,üå∏,4829,4829,70000,70000,980,0,0,650389,True
lIu33qKT_Gi5OfI,1551436472,–í–∏–≤–µ–¥–µ–Ω–Ω—è –∫–µ—à–±–µ–∫—É 266.47‚Ç¥,4829,4829,21450,21450,980,0,0,580389,True
SucV_tLwEFCrXvU,1551423608,–í—ñ–¥—Å–æ—Ç–∫–∏ –∑–∞ –ª—é—Ç–∏–π,4829,4829,1944,1944,980,0,0,558939,True
jUppCXhLrI0Bq58,1556564006,Taxi,4121,4121,-7000,-7000,980,0,0,654021,False,B8H0-X53C-3C8B-8X9E
B3IgBqU3U19Eidc,1556561094,ArtPabShKAF,5814,5814,-49300,-49300,980,0,0,661021,False,3HHM-5EK9-X9TE-0XHT
gyxydzaoG5LsqaU,1556539126,ABSOLYT 1,5499,5499,-4100,-4100,980,0,0,710321,False,73MB-HH24-4M92-MMH7
veaAPF9XfHanHqU,1556532784,Foundation Coffee Roasters,5814,5814,-37400,-37400,980,0,0,714421,False,1PPT-8B9E-28A1-TAMX
xgSmkV9hcZ6s_MU,1556483569,BAR GAMBRINUS,5813,5813,-60000,-60000,980,0,0,751821,False,XXB5-5PH4-14A1-39T6
8iNQp9w9390tpSQ,1556483549,BAR GAMBRINUS,5813,5813,-4625,-4625,980,0,0,811821,False,07XK-110B-565K-M8M7
knS8r-p7tM3TNKM,1556483521,BAR GAMBRINUS,5813,5813,-32500,-32500,980,0,0,816446,False,2967-BEA8-A337-4X33
xZZJtP9Gizk0WSU,1556473593,PASAZHYRSKI KASSA N11,4112,4112,-194601,-194601,980,0,0,848946,False,AK42-93XE-7T02-C9EE
h2pt9-RfljLTJgo,1556470273,–ö–æ–º–ø–æ—Ç,5812,5812,-65900,-65900,980,0,0,1043547,False,E5PB-KC94-086X-EACE
mvJrQeq71v3e1OU,1556466420,SHOP GURMAN,5499,5499,-8600,-8600,980,0,0,1109447,False,HM1P-H9E0-39AT-80B8
OjofZ9nt2ME4VFQ,1556454678,Bolt,4121,4121,-1800,-1800,980,0,0,1118047,False,3AA3-86TP-T814-P5X9
Gy9kGt8DuAkcr40,1556453049,FOP PUSTOVIT L.R.,5814,5814,-27000,-27000,980,0,0,1119847,False,294X-23AC-THB2-2HA0
hXHmnXdg8bQySJw,1556451484,PERFETTOArkadija,5814,5814,-16035,-16035,980,0,0,1146847,False,BBT1-BB9K-8T43-0KE9
wQKkPB4i4KepbRU,1556444882,Taxi,4121,4121,-9600,-9600,980,0,0,1162882,False,K9AC-9CEC-P3AA-B57A
eATnnDpWL_TQ9aM,1556444292,WALKER,5661,5661,-22000,-22000,980,0,0,1172482,False,B4KT-65HT-1A61-ACC0
1t_ys8pP65pSpio,1556438755,YIDALNYA CHERNOSLYV 1,5814,5814,-15957,-15957,980,0,0,1194482,False,9XP6-8AMA-2PBX-PE81
V_w39KzQuHnkQ5c,1556438137,Wayforpay,4121,4121,-15900,-15900,980,0,608,1210439,False,EKBC-901P-T8CA-XB81
3qtC1VkJaXVA_zg,1556436051,EVA,5977,5977,-15200,-15200,980,0,0,1226339,False,T798-TPX1-CBMB-AC3K
HJ_eMhiEJ7WmwDc,1556425129,TRAVELERS KAFE,5812,5812,-42240,-42240,980,0,1267,1241539,False,E34A-34PX-B72M-K37M
eLjqI5XEBKIBNbk,1556381870,Wayforpay,4121,4121,-16000,-16000,980,0,1600,1283779,False,9XM7-8KEE-CKKE-T603
n73CYIT-rkqDsUc,1556363857,BEZ DVEREJ,5814,5814,-20000,-20000,980,0,600,1299779,False,A8M0-7T4A-62P8-4X8X
ArBYkZ8XYdGZ01Y,1556363216,–ë–∞–Ω–∫–æ–º–∞—Ç ATM2531 PRX032KYIV,6011,6011,-50250,-50250,980,250,0,1319779,False,8P03-7CBM-378M-1H21
eRD0L-qT7kH-c1E,1556345947,Lesya,4829,4829,-400000,-400000,980,0,0,1370029,True,K70X-011A-4EAM-693X
viZ-p303BdWvbFk,1556303630,–í—ñ–¥: –í–ª–∞–¥–∏—Å–ª–∞–≤ –ß–æ—Ä–Ω–∏–π,4829,4829,1100,1100,980,0,0,1770029,True
9KdLUyO1xF16whg,1556303325,"–ö–∏—ó–≤—Å—Ç–∞—Ä
+380681354084",4812,4812,-1100,-1100,980,0,0,1768929,True,B67E-7E7H-K9AH-0AXE
RiMhuB0muwg1uGg,1556275224,–íi–¥: –ü–†–ò–•–û–î–¨–ö–û –ï.–í. –§–û–ü,4829,4829,1000000,1000000,980,0,0,1770029,True
lGYSqqdVRpgP4xQ,1556270485,Bolt,4121,4121,-6200,-6200,980,0,620,770029,False,63T3-492H-60HC-38PK
0p9qqpzXmTC6f58,1556259821,–ü–ª–∞—Ç—ñ–∂ COMFY,4829,4829,-137000,-137000,980,0,0,776229,True
AInXtMkrBZsWdHs,1556258899,Wayforpay,4121,4121,-6000,-6000,980,0,600,913229,False,875K-2K18-BH78-P529
-iSV0hMTzTF87BA,1556256038,Wayforpay,4121,4121,-6000,-6000,980,0,600,919229,False,1MEC-0C5P-095P-AMP2
1Rz07qQa2yT8vnw,1556215107,MolokovidPHermera,5451,5451,-26907,-26907,980,0,0,925229,False,6M02-624T-3BB8-H347
HnYOYDHhkzXiLg0,1556209947,Lesya,4829,4829,-200000,-200000,980,0,0,952136,True,6KHT-1X73-5B17-H9CT
_FbN-6zS2-btwJI,1556186848,Glovo,5814,5814,-43690,-43690,980,0,1310,1152136,False,C2K0-9A0C-EEP9-6BTK
UpNTfb8aSPXxgHxKz-xR,1556148642,"–°–∫–∞—Å—É–≤–∞–Ω–Ω—è. MANGO KHRESHATIK 21, 21 KHRESCHATYK, KYIV, UA",5691,5691,79900,79900,980,0,0,1195826,False
ZhIcEIcXrQO2Gzc,1556117231,Lesya,4829,4829,-50000,-50000,980,0,0,1115926,True,29KX-AHA8-85KP-8AX3
y02xoBKcyH60rX0,1556116621,–ê–ª–µ–∫—Å–µ–π –í—ã–∫–∞–ª—é–∫ BCD,—Ü–∏–ø–∞ üêî,4829,4829,-50000,-50000,980,0,0,1165926,True,0HAE-TKM5-E218-5TTB
PXjEdtFhYn76AFo,1556103879,Wayforpay,4121,4121,-6000,-6000,980,0,600,1215926,False,2HE8-2M62-X6AP-C39A
tZ0UyYzf4GnTZ28,1556090515,SIGARNIY DIM FORTUNA,5993,5993,-21500,-21500,980,0,0,1221926,False,BTTT-HXXX-K6E8-5B3B
BBb7q2Vrw9cUrqY,1556089372,Portugeza,5814,5814,-8500,-8500,980,0,255,1243426,False,C3K6-M0T3-KC39-20B0
u9-e8L2E0D8jBAE,1556088162,–íi–¥: –ü–†–ò–•–û–î–¨–ö–û –ï.–í. –§–û–ü,4829,4829,1000000,1000000,980,0,0,1251926,True
Bv9fTtyLLouw848,1556087424,RightCoffeeBar,5814,5814,-18000,-18000,980,0,540,251926,False,87H7-X1AB-355C-8289
9bkj8FZpAruR848,1556039790,Lesya,4829,4829,-100000,-100000,980,0,0,269926,True,63A6-7190-7083-CX2E
n5K7DE6_sXOvC2Q,1556022768,PROGRESS CAFFE,5814,5814,-11000,-11000,980,0,330,369926,False,5H9H-03A1-1353-6BC6
eLegmwomFLifrGw,1556008890,–°–∫–∞—Å—É–≤–∞–Ω–Ω—è. Google,7399,7399,600,600,980,0,0,380926,False
F59W9U9RDX0nuNQ,1556008019,portmone.com.ua,4814,4814,-17700,-17700,980,0,0,380326,False,B831-67T9-3A6H-9KK4
K8pjEMOlQP1KLNc,1556007988,Google,7399,7399,-600,-600,980,0,0,398026,False
pv1J5fHTEHn3CdA,1556005182,The Blue Cup,5814,5814,-7800,-7800,980,0,234,398626,False,B88X-B04X-TET4-E84K
G4ffdQZTjsSWXt4,1556002154,Wayforpay,4121,4121,-6000,-6000,980,0,600,406426,False,CTET-5E5X-T1TC-B491
FckayL69zdZv9fg,1556001784,RightCoffeeBar,5814,5814,-15500,-15500,980,0,465,412426,False,3XXH-CC4M-CTT2-1E0C
Pt27jvOxE3dvXwE,1555953530,McDonalds,5814,5814,-12100,-12100,980,0,363,427926,False,ATBA-8MH6-K2P4-TPBA
6M8OQS9tzisg8W8,1555953235,MANGO KHRESHATIK 21,5691,5691,-159800,-159800,980,0,0,440026,False
JaTEmlF374ci8R0,1555928717,–í–ª–∞–¥–∏—Å–ª–∞–≤ –ß–æ—Ä–Ω–∏–π,–º–∞–∫,4829,4829,-10300,-10300,980,0,0,599826,True,28K6-HH8A-HH39-TK03
iI65ZmkXRGJvkqw,1555912696,Lesya,4829,4829,-100000,-100000,980,0,0,610126,True,23KH-K6T4-1B68-6C22
rxwS_GS0il5gryw,1555912456,Wayforpay,4121,4121,-6000,-6000,980,0,600,710126,False,6900-67EE-TP77-AXA8
uEWTPUGUCdVgmVg,1555849332,–ù–∞ –¥–æ–ª–∞—Ä–æ–≤—É –∫–∞—Ä—Ç–∫—É,4829,4829,-38029,-1400,840,0,0,716126,True
y8p_hAZibUEknho,1555839985,1044_A,5912,5912,-7772,-7772,980,0,0,754155,False,98PB-5TH8-C4K4-MC1T
SZK3kHVMQcOGNQQ,1555837278,Taxi,4121,4121,-9500,-9500,980,0,950,761927,False,T064-43M9-PMXH-74A4
d4gJfmt06G1OHqM,1555836807,Bolt,4121,4121,-4300,-4300,980,0,430,771427,False,5TXA-7HTM-1A9B-28K2
9TTuk1YBcE6ud44,1555779990,–°—ñ–ª—å–ø–æ,5411,5411,-36232,-36232,980,0,0,775727,False,7B6P-K2PC-575X-4P7T
6mtfUn-0vEF9oVI,1555779007,–°—ñ–ª—å–ø–æ,5411,5411,-12900,-12900,980,0,0,811959,False,1M83-7CAP-MTC6-1ACA
f0lHynGqwflYX1Q,1555761018,Bolt,4121,4121,-7100,-7100,980,0,710,824859,False,X526-HXM9-68H4-2132
7zI7micjXHyGImc,1555759446,Riccio,5812,5812,-77001,-77001,980,0,2310,831959,False,5TH7-65XX-TH9B-AP58
rQV7LktDxh749wc,1555750553,RESTAURANT BELYY SHUM,5812,5812,-12000,-12000,980,0,360,908960,False,EME9-1KX5-38XB-1BE1
K8mvI3G1NxQo9us,1555749370,RESTAURANT BELYY SHUM,5812,5812,-10000,-10000,980,0,300,920960,False,X8X3-K613-6C53-PCMK
IGeoU1YpCcFOInw,1555707830,Bolt,4121,4121,-6300,-6300,980,0,630,930960,False,M1H4-AE40-026H-E835
xxV5f6n7GpcTEmY,1555699184,Bolt,4121,4121,-12500,-12500,980,0,1250,937260,False,MT36-P863-0217-HH02
fuPCYOrMSsisxng,1555682382,Bolt,4121,4121,-10500,-10500,980,0,1050,949760,False,08HM-KH63-EB1P-B10B
UXfTR7xIThirZls,1555665541,–í—ñ–¥: –ö–æ—Å—Ç—è–Ω—Ç–∏–Ω –ê—Ñ–∞–Ω–∞—Å—å—î–≤,4829,4829,16000,16000,980,0,0,960260,True
wiV93LlUw-Z1XUg,1555660851,RightCoffeeBar,5814,5814,-21000,-21000,980,0,630,944260,False,BE53-522C-EP7M-5547
_7ToEscPe9wtG8o,1555603845,–í—ñ–¥: –í–ª–∞–¥–∏—Å–ª–∞–≤ –ß–æ—Ä–Ω–∏–π,—Ö–æ—Ç–¥–æ–≥,4829,4829,7700,7700,980,0,0,965260,True
ksCEsqDh89rPz3Y,1555599398,Glovo,5814,5814,-65500,-65500,980,0,1965,957560,False,M2C8-E2T5-35B2-2MTP
0ebI0oH3R_gj-XM,1555576693,–ú–∞–∫—Å–∏–º –ó–∞–±–æ–ª–æ—Ç–Ω—ã–π BCD,—Å–æ—Å–∏—Å–∫–∞,4829,4829,-2500,-2500,980,0,0,1023060,True,E64H-H89K-9P81-TBMA
F-s7bbM3ndkv6Ek,1555575296,–ù–æ–≤–∞ –ø–æ—à—Ç–∞,4214,4214,-10800,-10800,980,0,0,1025560,False,C823-1K90-K1B3-MP9K
tTsY6bAm2o2qSjM,1555527438,–°—ñ–ª—å–ø–æ,5411,5411,-55937,-55937,980,0,0,1036360,False,94KA-9XAK-XC11-0MCX
m5dwblpRZMshkIg,1555522537,–í—ñ–¥: –ú–∞–∫—Å–∏–º –§–µ—â–µ–Ω–∫–æ,–ø–∏–≤–æ,4829,4829,21000,21000,980,0,0,1092297,True
IDV-KCepnm1v_UQ,1555522479,PabTrallebus,5814,5814,-40200,-40200,980,0,1206,1071297,False,0BBE-HB1M-P44C-H5B5
UI8vDGmyCgb9ggM,1555488990,LTD SWEET FRESH 1,5812,5812,-44300,-44300,980,0,1329,1111497,False,2296-C908-46H2-0MX8
-XHvPDeNfKf0iqY,1555433862,–°–∫–∞—Å—É–≤–∞–Ω–Ω—è. Glovo,5814,5814,23200,23200,980,0,-696,1155797,False
F-U76MkmL-pDvkQ,1555432899,Glovo,5814,5814,-23200,-23200,980,0,696,1132597,False
Z5PJmXnMVF9v2H4,1555413033,–ù–∞ –¥–æ–ª–∞—Ä–æ–≤—É –∫–∞—Ä—Ç–∫—É,4829,4829,-32333,-1200,840,0,0,1155797,True
WFCQfFPpAH4NovE,1555413009,–ú–∞–∫—Å–∏–º –ó–∞–±–æ–ª–æ—Ç–Ω—ã–π BCD,—Å–æ—Å–∏—Å–∫–∞ üå≠,4829,4829,-2500,-2500,980,0,0,1188130,True,AMPK-EE90-7H04-82TC
4FBFM0mXSlVGQDE,1555405340,Glovo,5814,5814,-3850,-3850,980,0,115,1190630,False,KB9A-CE7H-HT8H-CMPH
3_8zr5nv_5x6uYw,1555403925,McDonalds,5814,5814,-8400,-8400,980,0,252,1194480,False,K062-073T-THK1-E5XP
HkLAUfy6J8vM_Xw,1555403642,Rozetka,5399,5399,-16900,-16900,980,0,0,1202880,False,91PX-MTM9-P759-0P7E
reqWrxUhO9XLPo8,1555397075,Bolt,4121,4121,-4500,-4500,980,0,450,1219780,False,1549-TEE8-2B64-P7P4
CzmMOHl41mnbjdI,1555348766,MolokovidPHermera,5451,5451,-13173,-13173,980,0,0,1224280,False,7P8X-X8KE-684P-K67T
er9z6Tw0CYdge9U,1555348443,BeerMarket,5921,5921,-8747,-8747,980,0,0,1237453,False,3975-94BK-026X-C4A5
xwpo9VkAf1pvVa4,1555331207,–í—ñ–¥: –ú–∞–∫—Å–∏–º –§–µ—â–µ–Ω–∫–æ,–º–∞–∫,4829,4829,5500,5500,980,0,0,1246200,True
gHNFrGUUlKtsWoo,1555329666,Glovo,5814,5814,-33700,-33700,980,0,1011,1240700,False,HBHE-X05E-038H-AKMX
yFUtAjjiTlJRa-M,1555329177,Lesya,4829,4829,-800000,-800000,980,0,0,1274400,True,CA8C-A6AA-2H23-2KPT
Qg3FuNBkt7XuUlc,1555328285,–íi–¥: –ü–†–ò–•–û–î–¨–ö–û –ï.–í. –§–û–ü,4829,4829,2200000,2200000,980,0,0,2874400,True
RGAAIo6vjVXh-BE,1555311557,PROGRESS CAFFE,5814,5814,-5000,-5000,980,0,50,674400,False,8C4C-AHHK-3C1C-HMTE
v4H0y26LRmF0-CU,1555250920,Epicenter,5211,5211,-121039,-121039,980,0,0,679400,False,M118-KMMK-287X-BE3P
uLgAwvlrqG3bDYA,1555236461,Wayforpay,4121,4121,-5500,-5500,980,0,550,800439,False,E34A-K0AB-C59P-62MC
RYJ3vAEfKuFtblg,1555235222,Lesya,4829,4829,-460000,-460000,980,0,0,805939,True,H490-PC6E-8PBP-XMCT
sWsK_hvVUQPpqPs,1555232599,–í—ñ–¥: –°–µ—Ä–≥—ñ–π –ö—Ä–∞–≤—Ü–æ–≤,4829,4829,865000,865000,980,0,0,1265939,True
UzLX2hI9lVXQ7uI,1555178287,RESTORANBAR TAPHAUZ CI,5812,5812,-17900,-17900,980,0,179,400939,False,MCB6-E070-B7XM-58A0
Alckn24BNPwg4o4,1555172165,ProduktiJArVal19,5499,5499,-1100,-1100,980,0,0,418839,False,7M4A-P7M5-ECK0-27XE
GtTQijsdGyQiVmc,1555168933,–°—ñ–ª—å–ø–æ,5411,5411,-8600,-8600,980,0,0,419939,False,C8PT-M9P1-1BXC-3TTH
9qW59YjGtS-jkrI,1555168870,–°—ñ–ª—å–ø–æ,5411,5411,-35247,-35247,980,0,0,428539,False,C07E-8CMP-PB10-M3T1
Y4iiH6Pv-rYEr28,1555161129,Glovo,5814,5814,-32400,-32400,980,0,324,463786,False,6KKP-4PTB-EK4T-M2T1
Z_keqwCIShrZ5Hw,1555090578,MolokovidPHermera,5451,5451,-4644,-4644,980,0,0,496186,False,5935-3751-93CH-MK7B
O3yF5824GdmuoBw,1555089944,EVA,5977,5977,-8697,-8697,980,0,0,500830,False,T366-KP54-A173-MHAP
d7tiYd7h6rWDeiE,1555084514,Wayforpay,4121,4121,-10300,-10300,980,0,103,509527,False,2BMA-6TAE-B4BE-AX98
zlrvGkHirNfvBRk,1555084466,LIQPAY*cipollino,5812,5812,-38800,-38800,980,0,388,519827,False,A19B-EE8K-513B-PX3B
GeOZkIOKtRqNbhY,1555082231,Wayforpay,4121,4121,-7500,-7500,980,0,75,558627,False,T0M1-9EBC-1ETM-3BCK
L3m98XRHGWw86Vk,1555070850,–°–∫–∞—Å—É–≤–∞–Ω–Ω—è. Wayforpay,4121,4121,5400,5400,980,0,-54,566127,False
4ya5aD6_ZbFr5n8,1555068927,Wayforpay,4121,4121,-5400,-5400,980,0,54,560727,False
lX67FI0ag47aih0,1555058008,Portugeza,5814,5814,-15500,-15500,980,0,155,266127,False,B88C-93A3-HPXC-26EA
OO6oF2fzMeqbDYE,1555014923,Produktova Lavka,5499,5499,-4600,-4600,980,0,0,281627,False,T5KP-06K2-1ABK-181K
wOQvxYeq41PLdcM,1554982838,PRODUKTI,5411,5411,-4800,-4800,980,0,0,286227,False,4K7B-806E-5PBB-PA6B
kKnYRchk-90yCto,1554982147,–ö–∏—ó–≤—Å—å–∫–∏–π –º–µ—Ç—Ä–æ–ø–æ–ªi—Ç–µ–Ω,4111,4111,-800,-800,980,0,0,291027,False,7M6A-P1K3-3TK2-T806
oRIFgQJ68I19GkY,1554981889,"–ü–∏—Ä—ñ–∂–∫–æ–≤–∞ ""–¢—ñ—Ç–∫–∞ –ö–ª–∞—Ä–∞""",5814,5814,-14000,-14000,980,0,140,291827,False,8TB8-H1M1-C3XP-8P65
oa9P-ttaESHUWyc,1554963681,Wayforpay,4121,4121,-7000,-7000,980,0,70,305827,False,64XM-34X6-656M-E835
ItAXts4GHdB9fpg,1554917905,"–ü–∏—Ä—ñ–∂–∫–æ–≤–∞ ""–¢—ñ—Ç–∫–∞ –ö–ª–∞—Ä–∞""",5814,5814,-4800,-4800,980,0,48,312827,False,BE1H-17BH-M4P2-85KH
4Ij2KdUsRGi0l1M,1554911015,PROGRESS CAFFE,5814,5814,-16000,-16000,980,0,160,317627,False,4CM5-P90T-C058-3129
MQDNETDqOgfbHpU,1554896902,PROGRESS CAFFE,5814,5814,-12000,-12000,980,0,120,333627,False,MK08-251H-PH19-KTP0
8e2J8YUZK-0hBSI,1554877683,–ü–ª–∞—Ç—ñ–∂ COMFY,4829,4829,-135234,-135234,980,0,0,345627,True
UhrdPREX7czWQfc,1554798214,SIGARNIY DIM FORTUNA,5993,5993,-8600,-8600,980,0,0,480861,False,28AK-01H6-64T6-XA11
2FqStXntNUSuMQY,1554747365,–ö–∏—ó–≤—Å—å–∫–∏–π –º–µ—Ç—Ä–æ–ø–æ–ªi—Ç–µ–Ω,4111,4111,-800,-800,980,0,0,489461,False,CA20-2BAH-H0CH-52XE
ImihZdG_5lE4MxA,1554746995,Rukkola,5814,5814,-9000,-9000,980,0,90,490261,False,M2A7-276H-7HC4-63H9
c4nCVmSO6tWta-U,1554740484,–ö–∏—ó–≤—Å—å–∫–∏–π –º–µ—Ç—Ä–æ–ø–æ–ªi—Ç–µ–Ω,4111,4111,-800,-800,980,0,0,499261,False,X5KM-BAK0-4762-0P13
8ClrbHWqwhBZCbY,1554730549,516798****8598,4829,4829,-755700,-755700,980,0,0,61,True,807M-EK10-TK40-K88E
T22PNVCXrSRzGgw,1554730476,–ó –¥–æ–ª–∞—Ä–æ–≤–æ—ó –∫–∞—Ä—Ç–∫–∏,4829,4829,258990,258990,980,0,0,755761,True
mKXxneeylf25PxA,1554725486,–í—ñ–¥: –û–ª–µ–∫—Å—ñ–π –í–∏–∫–∞–ª—é–∫,üçîüôè,4829,4829,5000,5000,980,0,0,496771,True
l6LxTItwOS9u10A,1554725460,–í—ñ–¥: –î–µ–Ω–∏—Å –ö–æ—Ç–æ–≤,4829,4829,14200,14200,980,0,0,491771,True
kKFgFXcWpSow1sc,1554722597,Glovo,5814,5814,-89400,-89400,980,0,2682,477571,False,3EC2-A92X-MEH4-M0XA
7aWxgjwxy5YFB1k,1554709240,SIGARNIY DIM FORTUNA,5993,5993,-12900,-12900,980,0,0,566971,False,M6P8-KEK1-X958-68X8
ZXcX8n8al18JPo8,1554652335,Lesya,4829,4829,-200000,-200000,980,0,0,579871,True,6B1H-08EH-C5B9-9H82
vgMzCl5gYZZOWh4,1554650806,IDEYa ShOP,5947,5947,-19800,-19800,980,0,0,779871,False,2289-XA14-CAKT-7170
tw4269uUmjxxhaQ,1554648490,PEChENA KARTOPLYa,5814,5814,-9200,-9200,980,0,276,799671,False,E1B7-709B-K475-7MPT
t8HQYuck_N2JEHE,1554647996,–°—ñ–ª—å–ø–æ,5411,5411,-16411,-16411,980,0,0,808871,False,9BCC-T46E-K4AX-H8BB
FFi7YmyAE2rjIDY,1554646584,–°—ñ–ª—å–ø–æ,5411,5411,-8600,-8600,980,0,0,825282,False,B4AX-1M11-BT92-85PA
ArGErkhHpo8OC_w,1554645920,Komfi,5722,5722,-31700,-31700,980,0,0,833882,False,788C-336T-H01P-85E9
URay2HBs3X8KeuM,1554641444,BEZ DVEREJ,5814,5814,-15000,-15000,980,0,450,865582,False,85M7-5K06-T334-CX88
AlcknGwEN_8i6oA,1554638014,"–ü–∏—Ä—ñ–∂–∫–æ–≤–∞ ""–¢—ñ—Ç–∫–∞ –ö–ª–∞—Ä–∞""",5814,5814,-15900,-15900,980,0,477,880582,False,P595-6MMK-PPE6-H3T0
3kk6HS_YJb5deW4,1554568804,Nighniy val,5499,5499,-3900,-3900,980,0,0,896482,False,A8AX-910P-1B94-0C4E
I5t6bwAF-7XjkqE,1554568770,Nighniyval1,5499,5499,-21000,-21000,980,0,0,900382,False,5M55-6EB3-M9HP-A119
GKqAz_lphxoIWEM,1554553384,–ß–µ—Ä–Ω–æ–º–æ—Ä–∫–∞,5814,5814,-214755,-214755,980,0,6442,921382,False,08T7-580B-AB58-79M7
r8-457vE_mcOqEA,1554553347,–ß–µ—Ä–Ω–æ–º–æ—Ä–∫–∞,5814,5814,-52300,-52300,980,0,1569,1136137,False,PC95-CX95-047E-BK43
q44DosI44dHTyz8,1554544317,FOP Zelenyak Lyudmila,5992,5992,-27000,-27000,980,0,0,1188437,False,94A1-2KAH-E8CT-8B76
2J8gCNCazZrUIC0,1554544206,Wayforpay,4121,4121,-5000,-5000,980,0,500,1215437,False,B8T2-72XT-2209-PEBX
j0ZMet-pTQFETxE,1554480326,PANTOMAT6,5499,5499,-3350,-3350,980,0,0,1220437,False,PHC1-9MM7-9M5H-H295
esJrkkk4YBN6aGA,1554466218,414943****9885,4829,4829,-250000,-250000,980,0,0,1223787,True,6703-8214-PX56-7KT2
OMHkWBifxqceRvc,1554465561,–í—ñ–¥: –°–µ—Ä–≥—ñ–π –ö—Ä–∞–≤—Ü–æ–≤,4829,4829,1200000,1200000,980,0,0,1473787,True
ljELLAa7iWtglbM,1554465170,–°—ñ–ª—å–ø–æ,5411,5411,-48292,-48292,980,0,0,273787,False,5A6K-M7PP-3TE5-012C
zkmwHpkF6xuF1v4,1554463163,Portugeza,5814,5814,-8500,-8500,980,0,255,322079,False,B5E2-879T-5A41-4A1P
RkdH5kWSmGjbpaM,1554457188,–ö–æ—Å–∞—Ç–∫–∞,5814,5814,-33600,-33600,980,0,1008,330579,False,M4XC-HK88-C372-1C22
vXXbLu3ek1reGGg,1554449721,–ö–∏—ó–≤—Å—å–∫–∏–π –º–µ—Ç—Ä–æ–ø–æ–ªi—Ç–µ–Ω,4111,4111,-800,-800,980,0,0,364179,False,928B-3BEC-3XAE-CKP0
zPXSAPjLSz7zkbw,1554446946,–ö–∏—ó–≤—Å—å–∫–∏–π –º–µ—Ç—Ä–æ–ø–æ–ªi—Ç–µ–Ω,4111,4111,-800,-800,980,0,0,364979,False,KE42-B793-A76A-M61X
FkBwxbG7-ValEv4,1554401810,VARVAR BAR,5812,5812,-35000,-35000,980,0,1050,365779,False,AP85-2473-KAT5-7B77
9ZNfKJqL0oz7x0Q,1554401543,Produkty,5499,5499,-2200,-2200,980,0,0,400779,False,EP57-7H79-MAHB-8377
l_9QP8M6oPSIg-c,1554400733,Lesya,4829,4829,-90000,-90000,980,0,0,402979,True,1B96-MM7H-BPHA-7584
_vWyh_jMXw6DvlY,1554377373,SIGARNIY DIM FORTUNA,5993,5993,-8600,-8600,980,0,0,492979,False,34X2-A4E7-K5A7-6M39
Z5lT-nLFe3zkE6Y,1554376979,STEYKHAUS1,5812,5812,-11400,-11400,980,0,342,501579,False,8976-36HM-E2EA-0KHK
EXG5BnuFcetv1js,1554304557,SIGARNIY DIM FORTUNA,5993,5993,-17200,-17200,980,0,0,512979,False,XA69-27X0-BA6B-P7KC
m3bO99zr1ZBXn8E,1554296476,–°–∫–∞—Å—É–≤–∞–Ω–Ω—è. Google,7399,7399,600,600,980,0,0,530179,False
fF4RCHQ0UGeE90I,1554295601,METRO,5411,4215,-129402,-129402,980,0,0,529579,False,EX0M-17A1-14A2-EXP7
7U_N0Vn55UOSJFM,1554295571,Google,7399,7399,-600,-600,980,0,0,658981,False
A1-0FdzPdFvmcM4,1554273011,–ü–∏—Ä–æ–≥–∏ —Ç–∞ –¥—Ä—É–∑—ñ,5814,5814,-27400,-27400,980,0,822,659581,False,3X4T-C8CM-2C5H-0070
HWW3xeMxOo_NokA,1554229837,FOP  DEREVYaNKO A V,5812,5812,-32800,-32800,980,0,984,686981,False,XP97-46ET-63CX-92ET
CRzcE7lIBNQOIwc,1554227739,Pasteca,5814,5814,-26000,-26000,980,0,780,719781,False,472H-HC82-M4XK-C1HA
wVxG9gL-nYo4QNQ,1554227712,Pastateca,5814,5814,-10000,-10000,980,0,300,745781,False,175B-XM2X-CH20-9M40
L01mmBZjJkQT93o,1554204887,Wayforpay,4121,4121,-5000,-5000,980,0,500,755781,False,TH89-MHM7-XMBT-2PEK
aKZm7eMLo6EyyR0,1554203885,–ù–∞ –¥–æ–ª–∞—Ä–æ–≤—É –∫–∞—Ä—Ç–∫—É,4829,4829,-30000,-1100,840,0,0,760781,True
WhQyCDwCDdeCYmE,1554203874,Lesya,4829,4829,-900000,-900000,980,0,0,790781,True,1853-1345-037P-HHPA
w3m3bsTqKa1KKrg,1554197262,Milk Bar,5812,5812,-54800,-54800,980,0,1644,1690781,False,47AA-X683-HATB-PMKX
BgRHo3iUOxaSmik,1554187450,–íi–¥: –ü–†–ò–•–û–î–¨–ö–û –ï.–í. –§–û–ü,4829,4829,1200000,1200000,980,0,0,1745581,True
yQ0ApQPnRtStTUY,1554187374,–ù–æ–≤–∞ –ø–æ—à—Ç–∞,4214,4214,-13332,-13332,980,0,0,545581,False,PCB5-A947-4TBA-HBP2
6G8GorwRu11uV2LrVls,1554167816,Wayforpay,4121,4121,-22200,-22200,980,0,0,658913,True
vdJIBMScmeaTX8wv02uLker6,1554167816,–°–∫–∞—Å—É–≤–∞–Ω–Ω—è. Wayforpay,4121,4121,22400,22400,980,0,0,681113,True
htHz1Nwr__iitWc,1554147493,Wayforpay,5499,5499,-16720,-16720,980,0,0,658713,False,2993-3K57-7K4A-8896
n-fcv327TU25Tac,1554142390,RESTAURANT KHMILNYY KN,5812,5812,-17000,-17000,980,0,510,675433,False,KTP1-46XC-67A4-6M3B
yecQwWYynhDqOg0,1554142365,RESTORAN KHMILNYY KNYA,5812,5812,-22000,-22000,980,0,660,692433,False,P815-K5K7-05CP-B894
lhlzhKVRqMPpz3g,1554116152,Lesya,4829,4829,-60000,-60000,980,0,0,714433,True,4H73-H9EB-3312-1H34
aVyfwfyORsUp6Q0,1554115579,–ù–∞ –¥–æ–ª–∞—Ä–æ–≤—É –∫–∞—Ä—Ç–∫—É,4829,4829,-38392,-1400,840,0,0,774433,True
Czajo_jDa6EOPEo,1554114056,–íi–¥: –ü–†–ò–•–û–î–¨–ö–û –ï.–í. –§–û–ü,4829,4829,800000,800000,980,0,0,812825,True
U2ojEgH-mhWJhJc,1554107057,procoffee,5814,5814,-8000,-8000,980,0,80,12825,False,TKEH-7M45-5KTC-E76K
A6gWfylae1MBi4U,1554103868,–í—ñ–¥—Å–æ—Ç–∫–∏ –∑–∞ –±–µ—Ä–µ–∑–µ–Ω—å,4829,4829,2046,2046,980,0,0,20825,True
IJFP3_R7tS80SeE,1554100498,"–ü–∏—Ä—ñ–∂–∫–æ–≤–∞ ""–¢—ñ—Ç–∫–∞ –ö–ª–∞—Ä–∞""",5814,5814,-7700,-7700,980,0,77,18779,False,K4TB-2ECT-BB02-7PMT
IdIAZemozLFrwTs,1559248923,Steam,5816,5816,-4400,-4400,980,0,0,398969,False,27A7-53XP-5K1B-33CK
ae5C21mAbIicnFM,1559223106,"–ü–∏—Ä—ñ–∂–∫–æ–≤–∞ ""–¢—ñ—Ç–∫–∞ –ö–ª–∞—Ä–∞""",5814,5814,-16600,-16600,980,0,0,403369,False,TPKP-HT84-2X07-K2AC
wI9GxV1qegbmSnQ,1559145556,Wayforpay,4121,4121,-8000,-8000,980,0,0,419969,False,1HXA-T7AK-HA93-5B7M
kN9crzxjvhi_aF8,1559111944,Lesya,4829,4829,-200000,-200000,980,0,0,427969,True,C3B6-C0AA-C0M7-69M4
laue5AF8eRlazG8,1559046116,–í—ñ–¥: –í–ª–∞–¥–∏—Å–ª–∞–≤ –ß–æ—Ä–Ω–∏–π,—Å–ø–ª–∏—Ç–≤–∞–π–∑ –∏ –¥–∞–±–ª—á–∏–∑,4829,4829,25000,25000,980,0,0,627969,True
U2kvhu9HIPLUHGM,1559044275,–ù–∞ –¥–æ–ª–∞—Ä–æ–≤—É –∫–∞—Ä—Ç–∫—É,4829,4829,-29088,-1100,840,0,0,602969,True
MWy-t_D7f0i9Cpg,1559043138,Glovo,5814,5814,-21100,-21100,980,0,0,632057,False,88HA-M21C-T4AC-5K57
ZmJo4izTr6luns4,1558970805,Bolt,4121,4121,-10100,-10100,980,0,0,653157,False,T564-256M-C1C4-4XCB
bIbFi7FHvrp7ric,1558959627,SMOLL TOKING,5814,5814,-16600,-16600,980,0,0,663257,False,X2XX-2APA-1PC3-B2M6
HzGw5KLCWs1WCFg,1558954336,Bolt,4121,4121,-10300,-10300,980,0,0,679857,False,PXB3-6AXX-X8AC-343C
vfzqGrWfUwrvQhw,1558953593,Lesya,4829,4829,-200000,-200000,980,0,0,690157,True,M191-KTXA-9CEC-90XT
pDRaCV43s5YqzEs,1558951949,–íi–¥: –ü–†–ò–•–û–î–¨–ö–û –ï.–í. –§–û–ü,4829,4829,1000000,1000000,980,0,0,890157,True
JJRy7OXlBbLAmzs,1558851198,–ü–ª–∞—Ç—ñ–∂ COMFY,4829,4829,-137000,-137000,980,0,0,-109843,True
koEFbhKKdK0PS8E,1558807746,BUDMO,5499,5499,-2275,-2275,980,0,0,27157,False,28PH-6XEK-5B97-K2M0
EQFHY7B0IUo2lGM,1558799006,Wayforpay,4121,4121,-7500,-7500,980,0,0,29432,False,MMT8-64E3-P26H-E36C
TPdgI2zLPWcpiZc,1558798868,–°—ñ–ª—å–ø–æ,5411,5411,-21659,-21659,980,0,0,36932,False,99XE-16P0-P9CX-5C00
gMwPaE6y1NvyQBI,1558797655,Hmeli Suneli,5812,5812,-76900,-76900,980,0,0,58591,False,6CH7-42A8-KT38-TCMC
194EpfYBbA740PE,1558784622,–°–∫–∞—Å—É–≤–∞–Ω–Ω—è. Taxi,4121,4121,6000,6000,980,0,0,135491,False
HG2h3QG-5rCjHfg,1558782941,Bolt,4121,4121,-6700,-6700,980,0,0,129491,False,XCKH-85MC-B7B8-XH7A
NHlvmrff3XH4ziI,1558782743,Taxi,4121,4121,-6000,-6000,980,0,0,136191,False
idi6nU2zA-dRVho,1558782683,FOP PROBAChAY OM,742,742,-20000,-20000,980,0,0,142191,False,H97H-2XK6-BA2M-TA24
QclPKNIHGMxfw3c,1558779953,Bolt,4121,4121,-6800,-6800,980,0,0,162191,False,PT17-T76E-3AT4-5788
J9CF_i8ioUV_5dw,1558773353,MolokovidPHermera,5451,5451,-13192,-13192,980,0,0,168991,False,67C5-8409-P8HA-2AX9
2ZSaGgp2EtKS5d8,1558772933,–°–æ–∫—Ä–∞—Ç,5943,5943,-10670,-10670,980,0,0,182183,False,A53T-AB7X-X0M7-79BB
saIanhnwEcX3U6M,1558730964,Steam,5816,5816,-9100,-9100,980,0,0,192853,False,E36C-28AX-5X54-351C
NZzOueB3R0ybIY4,1558730294,Lesya,4829,4829,-30000,-30000,980,0,0,201953,True,612E-X8PX-KX32-28TK
ADOp-ZiTuFakgTc,1558717667,–í–∏–≤–µ–¥–µ–Ω–Ω—è –∫–µ—à–±–µ–∫—É 500.00‚Ç¥,4829,4829,40250,40250,980,0,0,231953,True
FFFwjz_lcTiH6Vc,1558715572,Flower Time,5992,5992,-50000,-50000,980,0,4123,191703,False,H479-BP13-EA6B-4KKP
IH--d6PJaJukLhU,1558710641,Glovo,5814,5814,-19090,-19090,980,0,0,41703,False,T04C-TC0K-XHA1-19C2
DzjmlGEjf34Ne-g,1558701282,Wayforpay,5995,5995,-244000,-244000,980,0,0,60793,False,CXA0-721P-06CT-MKCM
1KpxUMFjcgyxmRw,1558691492,–í—ñ–¥: –û–ª–µ—Å—è –°–∞—á–µ–Ω–∫–æ,ü§ëü§ëü§ëü§ëü§ëü§ëü§ëü§ëü§ëü§ë,4829,4829,250000,250000,980,0,0,304793,True
BvEjAlWhya6NCpc,1558688103,"–ü–∏—Ä—ñ–∂–∫–æ–≤–∞ ""–¢—ñ—Ç–∫–∞ –ö–ª–∞—Ä–∞""",5814,5814,-12800,-12800,980,0,0,54793,False,H285-6E32-2A5A-MT9B
gPQreauDQDEcjH0,1558686749,–í—ñ–¥: –û–ª–µ—Å—è –°–∞—á–µ–Ω–∫–æ,–Ω–∞ –ø–∏—Ä–æ–∂–∫–∏,4829,4829,50000,50000,980,0,0,67593,True
EYXGDvIDClDAhM8,1558653846,Bolt,4121,4121,-9800,-9800,980,0,0,17593,False,B0M9-0H24-H1TA-CC08
I-Fw3NrsY-WayOk,1558634526,–î–µ–Ω–∏—Å –ö–æ—Ç–æ–≤,4829,4829,-8000,-8000,980,0,0,27393,True,069E-1EA8-6XTP-2E35
Uonhq7WK3dmtsao,1558629175,Bolt,4121,4121,-5700,-5700,980,0,0,35393,False,A595-C8A3-P9K2-B0C0
jZfKZM37RfPfsqs,1558600155,portmone.com.ua,4814,4814,-22000,-22000,980,0,0,41093,False,2061-5T3X-4EH9-17H4
SqDtQLz9Ovi_Yyg,1558591820,Wayforpay,4121,4121,-15000,-15000,980,0,0,63093,False,0T5E-KM3P-MBEB-32K5
84mmQ5-P8mslnIM,1558555035,Lesya,4829,4829,-250000,-250000,980,0,0,78093,True,4271-TPEB-69KT-61TB
1moYtsRvtPdEU14,1558551287,536354****0491,4829,4829,-38000,-38000,980,0,0,328093,True,KA30-5T2A-684H-A53H
9k8ivwrfQXZIeZg,1558541783,MagazinZooli03,5995,5995,-32800,-32800,980,0,0,366093,False,E01P-1HHC-988T-93K4
tjamhLYZPvqea1A,1558541496,"–ü–∏—Ä—ñ–∂–∫–æ–≤–∞ ""–¢—ñ—Ç–∫–∞ –ö–ª–∞—Ä–∞""",5814,5814,-2200,-2200,980,0,0,398893,False,9M5K-PPP8-8AC2-HXBT
pFV775ofT1jXLfQ,1558536658,–í—ñ–¥: –ú–∞–∫—Å–∏–º –ó–∞–±–æ–ª–æ—Ç–Ω–∏–π,–°–æ—Å–∏—Å–∫–∞),4829,4829,2500,2500,980,0,0,401093,True
pecVaoNBI7FgXMM,1558531889,Bolt,4121,4121,-6200,-6200,980,0,0,398593,False,3B4A-C33P-051P-3T2M
w_De26aeczM0FYE,1558523474,"–ü–∏—Ä—ñ–∂–∫–æ–≤–∞ ""–¢—ñ—Ç–∫–∞ –ö–ª–∞—Ä–∞""",5814,5814,-17600,-17600,980,0,0,404793,False,EAM0-0EX0-M2K3-3M2B
SI9tpx8JQLWV3kw,1558511181,Taxi,4121,4121,-7800,-7800,980,0,0,422393,False,86HE-ATET-8K3T-4779
BYuuUHZQR5ymock,1558511093,VETERENARNYY GOSPITAL,742,742,-7000,-7000,980,0,0,430193,False,3CK9-9P6B-XCTT-77CT
PnX7BnD9dAPaJ44,1558508281,Taxi,4121,4121,-8000,-8000,980,0,0,437193,False,XKTK-031E-8476-B5P7
uV8uCxIlS0wSuEw,1558440136,Magazin,5499,5499,-3600,-3600,980,0,72,445193,False,0377-6P68-PEC6-29M3
oV5XLIFf-_FxNjs,1558440027,"–ü–∏—Ä—ñ–∂–∫–æ–≤–∞ ""–¢—ñ—Ç–∫–∞ –ö–ª–∞—Ä–∞""",5814,5814,-22900,-22900,980,0,0,448793,False,53H2-P4P7-EAC4-0EBC
QqZstruJwUoLkmY,1558435456,–ù–∞ –¥–æ–ª–∞—Ä–æ–≤—É –∫–∞—Ä—Ç–∫—É,4829,4829,-31566,-1200,840,0,0,471693,True
lZGaLgu6CGFqXaY,1558435446,Lesya,4829,4829,-600000,-600000,980,0,0,503259,True,CMBB-6PK6-KPE1-636A
6UXcP0OkJbA5ecQ,1558427239,–íi–¥: –ü–†–ò–•–û–î–¨–ö–û –ï.–í. –§–û–ü,4829,4829,1100000,1100000,980,0,0,1103259,True
9Nm-YlZd9a0Qvkw,1558420194,Wayforpay,4121,4121,-8000,-8000,980,0,0,3259,False,C76X-EEMM-PH6K-C30E
6EkjG_NLxjVJjx4,1558365119,Wayforpay,4121,4121,-8100,-8100,980,0,0,11259,False,5T4X-84X1-XAXB-8M0H
-E4AIrum366K5Pg,1558299288,Taxi,4121,4121,-11500,-11500,980,0,0,19359,False,C344-K4C8-X24E-44B1
QMQLEGIaMfbQfwQ,1558292614,–í—ñ–¥: –û–ª–µ—Å—è –°–∞—á–µ–Ω–∫–æ,4829,4829,30000,30000,980,0,0,30859,True
bvbnmtHR_xWfJ0g,1558255891,–ë–∞–Ω–∫–æ–º–∞—Ç BRANCH 10026-0159,6011,6011,-20100,-20100,980,100,0,859,False,2CE9-365E-9KXA-EEKK
NiJUGaY1fto0WliW9g,1558221807,"CTY TNHH NOVA PHAN THI, 12A NGUYEN DINH CHIEU HAM TIEN, BINH THUAN, VN",7011,7011,-565898,-500000000,704,0,0,20959,True
KKIEjp2yYZISVl8,1558204221,Right Coffee Bar,5814,5814,-7500,-7500,980,0,0,586857,False,032A-BHK2-6A86-ACAX
oKTOFUGhG4eGLPQ,1558180329,Right Coffee Bar,5814,5814,-24000,-24000,980,0,0,594357,False,4AH6-B07B-54A0-4PM4
C2_spwbYtk5JPm0,1558173290,"–ö–∏—ó–≤—Å—Ç–∞—Ä
+380978495150",4812,4812,-10000,-10000,980,0,0,618357,True,BHT4-93M5-B284-8CK3
vr-Jf_6nIzLvpdc,1558173253,Lesya,4829,4829,-10000,-10000,980,0,0,628357,True,32TC-E1KX-70MK-8T5C
b9A2Imm-4FwG1QZ8YS532VsQ,1558138849,–°–∫–∞—Å—É–≤–∞–Ω–Ω—è. CTY TNHH NOVA PHAN THI,7011,7011,573184,500000000,704,0,0,1211541,False
54KgEUwkFcDS6Dg,1558135660,QATAF CAFE - HAMAD INT,5812,5812,-68410,-2587,840,0,0,638357,False,CX1X-5MA1-3B9P-T01M
sX67Wqm7BLMdCKA,1558125159,QDF CORE L T F C - HIA,5309,5309,-43579,-6000,634,0,0,133583,False,E7P8-0B1X-493T-960B
1wgnAwHb6-pPt5g,1558090590,"QBD-HL TANG 2, CACH LY",5691,5691,-5289,-4672000,704,0,0,177162,False,BHBH-6EM8-T3XC-0375
pSeIH2XFM_N71sc,1558086532,PURO GUSTO E1,5814,5814,-32314,-28500000,704,0,0,182451,False,5TPK-BX9K-H65M-MT72
bGQgO1f7Zu0XeXM,1557999459,MIA RESORT,7011,7011,-219457,-194040000,704,0,0,214765,False,T465-5A99-BBE2-HTBH
ABCUNHYbe2VIrtY,1557999417,–í—ñ–¥: –û–ª–µ—Å—è –°–∞—á–µ–Ω–∫–æ,4829,4829,300000,300000,980,0,0,434222,True
30Ns2Rnd7Sz44Qg,1557912909,MIA RESORT,7011,7011,-138116,-121852500,704,0,0,134222,False,H19K-B781-EX5K-B7C5
irc244_vQZdwWW4,1557885159,–ë–∞–Ω–∫–æ–º–∞—Ç BIDV,6011,6011,-110136,-95500000,704,2160,0,272338,False,90BP-PX31-8CT5-E4KH
XXhpE1p2FesM9Vc,1557838275,HO KD MUI NE 1001,5499,5499,-14690,-13000000,704,0,293,382474,False,MA10-95AK-3EPE-7XBX
1pCZMdvplHigYy4,1557837330,MIA RESORT,7011,7011,-108292,-95865000,704,0,0,397164,False,M36E-0PBA-00PP-1418
nQBpBTAPfalozCo,1557832922,THUONG THAO RESTAURANT,5812,5812,-10154,-9000000,704,0,0,505456,False,6718-KXXT-PAM6-XMH6
lieB9ZmdNXiNnD4,1557745074,–û–ª–µ—Å—è –°–∞—á–µ–Ω–∫–æ,4829,4829,-100000,-100000,980,0,0,515610,True,E6PC-05AH-PE13-4HB4
nLL-lMILpai9Qa8,1557662048,GOLDSCHMIEDE THINH,5944,5944,-74955,-66000000,704,0,0,615610,False,XTP9-PEBM-C0TX-E9BB
Nbce4uDZz8F4P0w,1557659352,–ë–∞–Ω–∫–æ–º–∞—Ç SAI GON MUI NE RESORT,6011,6011,-78780,-68000000,704,1545,0,690565,False,36EC-TB12-X6T6-33P0
xbBOza9_ETOQ3mc,1557572783,HKD THE GIOI HANG VIET,5411,5411,-33991,-30000000,704,0,679,769345,False,28BT-8K42-4629-BB7A
BLXL2svZK0Nhw_0,1557571433,MAT KINH MINH HUNG,8043,8043,-17552,-15500000,704,0,0,803336,False,PC3C-B9P3-1EXB-8K0E
hi50RFyzWqxRoFY,1557469402,–ü–ª–∞—Ç—ñ–∂ COMFY,4829,4829,-135232,-135232,980,0,0,820888,True
kvlFaeTF6_dOJrs,1557228785,DE ZA VU,7011,7011,-45964,-40200000,704,0,0,956120,False,32HH-EM46-CX0X-PKAH
9y1hV-IBbRq3UVs,1557214197,CTY TNHH NOVA PHAN THI,7011,7011,-573184,-500000000,704,0,0,1002084,False
zbuF1-pzPijhoPw,1557159259,W H SMITH - QDF HIA,5309,5309,-22023,-3000,634,0,0,1575268,False,1341-C53K-H631-E832
tZF3ipYNuiSh4js,1557146991,–°–∫–∞—Å—É–≤–∞–Ω–Ω—è. Bolt,4121,4121,36800,36800,980,0,0,1597291,False
HAMpoQW0xYEp_yE,1557146941,Bolt,4121,4121,-37200,-37200,980,0,0,1560491,False,C1HM-8C21-9PAT-6X8H
QfqXfDBFCsyKHc4,1557132919,TOV SHOKOLADNITZA-UKR,5812,5812,-24000,-24000,980,0,0,1597691,False,7HC4-TXH6-B135-CB70
SwjQUfA5BO67Bg4,1557129167,–íi–¥: –ü–†–ò–•–û–î–¨–ö–û –ï.–í. –§–û–ü,4829,4829,1400000,1400000,980,0,0,1621691,True
ZwBkS0dymQX09Qg,1557126994,Bolt,4121,4121,-36800,-36800,980,0,0,221691,False
97VKUAMdqf7nl7M,1557123001,Right Coffee Bar,5814,5814,-17500,-17500,980,0,0,258491,False,BB2K-3KXM-AH5B-4XTH
zh5Gx8gLiaKHGc4,1557054941,Bolt,4121,4121,-9600,-9600,980,0,0,275991,False,B1T8-MK39-339E-8ME4
wePJG55_SwHox2Y,1557053282,Glovo,5814,5814,-15000,-15000,980,0,0,285591,False,T31X-PEE7-X5E1-3T37
FVGFz3wAnGilnYs,1557048745,–ê–¢–ë,5411,5411,-22900,-22900,980,0,458,300591,False,8P4E-MHAX-MH6E-2H9C
l70-aK5vWfvfO0A,1557041519,–°—ñ–ª—å–ø–æ,5411,5411,-13900,-13900,980,0,278,323491,False,EMKK-A377-C3BT-MPCH
Wui4jqjQCkhvxMU,1557038847,Right Coffee Bar,5814,5814,-18500,-18500,980,0,0,337391,False,HPH2-XCK5-CPPB-2A20
jomBS5QHg3Xk9-s,1556999798,–°–∫–∞—Å—É–≤–∞–Ω–Ω—è. Google,7399,7399,600,600,980,0,0,355891,False
SjcT9GVZ78jzLBs,1556998952,Wayforpay,5995,5995,-78300,-78300,980,0,0,355291,False,19ME-8P4A-2933-APMT
zgZx-7F5o2hjOYY,1556998896,Google,7399,7399,-600,-600,980,0,0,433591,False
qM8ycVsGjuavZCE,1556995716,–°—ñ–ª—å–ø–æ,5411,5411,-75884,-75884,980,0,1517,434191,False,PT6M-BC66-6MCP-M6A8
2rPBZFqcdYL4-RY,1556984848,Riccio,5812,5812,-15000,-15000,980,0,0,510075,False,8HB5-8T59-4K54-5CTM
i9Rr128bcfkKdI8,1556983637,Riccio,5812,5812,-704560,-704560,980,0,0,525075,False,M5XM-HET2-7KP0-88T9
jbrVMGLHpHYxJoE,1556974899,–õ—ñ–∞–Ω–∞ –î—É–¥–Ω—ñ–∫,4829,4829,-940000,-940000,980,0,0,1229635,True,0H6B-CAB0-ABCA-92PB
ORPl9jJkKXHwn_o,1556960097,Taxi,4121,4121,-11100,-11100,980,0,0,2169635,False,44AE-XC8K-589T-6393
PdEo5QEAbBf1asM,1556954055,Portugeza,5814,5814,-4000,-4000,980,0,0,2180735,False,EECX-0TX3-HHHC-5KP4
KZZUq_crwUa1uSo,1556948482,Wayforpay,4121,4121,-5500,-5500,980,0,0,2184735,False,M9HE-34XE-B01M-TPC0
zCvpBla0tT45vpU,1556948099,Glovo,5814,5814,-14500,-14500,980,0,0,2190235,False,PBE7-P4T1-ET43-6445
L084e91qwY5jJOs,1556914785,Lesya,4829,4829,-300000,-300000,980,0,0,2204735,True,8808-5772-8TEM-KK7E
ZTK-nZoBZfUTl9k,1556902706,Glovo,5814,5814,-51400,-51400,980,0,0,2504735,False,4089-0KPT-73B2-M5HH
xs96Owi_xvfXGj0,1556897559,Fotovramke,5946,5946,-62000,-62000,980,0,0,2556135,False,E67K-M023-KX65-2913
dl9c81r79qGX0mc,1556892158,–î–µ–Ω–∏—Å –ö–æ—Ç–æ–≤,—Ö–æ—Ç–¥–æ–≥,4829,4829,-8600,-8600,980,0,0,2618135,True,0M9M-CXB4-7M60-TPCP
_a1168chOHpGf-w,1556879859,–íi–¥: –ü–†–ò–•–û–î–¨–ö–û –ï.–í. –§–û–ü,4829,4829,2600000,2600000,980,0,0,2626735,True
eKTBKPI60vHqbdI,1556820545,–õ–∏–Ω–¥–∞-–§–∞—Ä–º,5912,5912,-2405,-2405,980,0,0,26735,False,H474-P03P-56CT-EKBB
dQ0DaDk_DVayUS0,1556819419,Glovo,5814,5814,-12900,-12900,980,0,0,29140,False,1612-7XB5-T6MT-4H6H
l3tuE36-8H9ny9I,1556817578,ProduktiJArVal19,5499,5499,-1100,-1100,980,0,22,42040,False,1K7T-5HP5-0AX5-T23E
K-dnPDliycnq-xA,1556815268,FOP PROBAChAY OM,742,742,-52000,-52000,980,0,0,43140,False,3801-KXH4-2KAT-M58H
JxDKpaoSBjsdH9c,1556814934,Wayforpay,4121,4121,-7500,-7500,980,0,0,95140,False,6T3K-PXH0-A598-C16P
EFP0crgGXcuXmxE,1556810692,Taxi,4121,4121,-9000,-9000,980,0,0,102640,False,C3XX-M5XB-T5A3-MKBE
DJeaOrUS1Ot4hBM,1556802220,Floristicheskayastudiy,5992,5992,-211500,-211500,980,0,42300,111640,False,7H84-8B98-9C1B-P1M2
noqERipV7wT37zo,1556801779,–ü—Ä–∏–≤–∞—Ç24,6536,6536,300000,300000,980,0,0,323140,False
8UMG9hNd_YJE9Kw,1556793080,Lesya,4829,4829,-250000,-250000,980,0,0,23140,True,8K7X-3T71-9PTX-B8A2
5HTXp5sQA1YlhV8,1556792810,McDonalds,5814,5814,-39700,-39700,980,0,0,273140,False,PXE2-32M7-163K-7240
SA2WjyT66p2nNOI,1556791716,–°—ñ–ª—å–ø–æ,5411,5411,-12900,-12900,980,0,258,312840,False,T2BA-KM41-339H-X05A
t4fmL1Pje3nIntU,1556724167,Wayforpay,4121,4121,-6000,-6000,980,0,0,325740,False,TMH8-9CH5-0K42-C667
AD_YkDN3hn0arX8,1556708241,Bolt,4121,4121,-5100,-5100,980,0,0,331740,False,99T1-69PE-3052-0P3T
56x6x8yPsT7QFMg,1556708051,PHotosalonMAN,7221,7221,-16000,-16000,980,0,0,336840,False,3AE3-6HMK-CK20-78BE
AIeuM4aJtHBezZc,1556699068,–í—ñ–¥—Å–æ—Ç–∫–∏ –∑–∞ –∫–≤—ñ—Ç–µ–Ω—å,4829,4829,3169,3169,980,0,0,352840,True
xp0Xj7KFtDg7BRk,1556696762,–í–∏–≤–µ–¥–µ–Ω–Ω—è –∫–µ—à–±–µ–∫—É 500.00‚Ç¥,4829,4829,40250,40250,980,0,0,349671,True
DN571YBYCJo9zsI,1561829890,Glovo,5814,5814,-19000,-19000,980,0,0,184776,False,63TP-P299-45C1-4CMP
7j2NtgGcnQLlXFg,1561816855,Steam,5816,5816,-8400,-8400,980,0,0,203776,False,07MT-7EHB-T0M8-2X6E
k7OX8pCT_H-WZCA,1561797213,Lesya,4829,4829,-120000,-120000,980,0,0,212176,True,89AM-0151-E2AK-EK8B
XVdbC5R3NzRzV2Q,1561751260,Bolt,4121,4121,-4800,-4800,980,0,480,332176,False,PA74-AAKT-M338-CTH4
FeD2XGCUwp8jP9E,1561739433,Bolt,4121,4121,-4800,-4800,980,0,480,336976,False,6614-AETX-443K-K959
zSjJwF5CddU-m6U,1561728727,APTEKA7,5912,5912,-2809,-2809,980,0,0,341776,False,0CE1-K177-M966-8AP1
5vqSufjCSu0kQyk,1561728196,BeerMarket,5921,5921,-17498,-17498,980,0,0,344585,False,T5PE-7MCP-9PTX-5656
19jS_eBl3v8NzqI,1561728049,Glovo,5814,5814,-19000,-19000,980,0,0,362083,False,3M8K-7K83-1C99-M0X2
0Ad1oUy9_Sx_TeI,1561727940,ZoomagazinZooBoss,742,742,-26400,-26400,980,0,0,381083,False,C640-39H6-0885-B374
MCUp5ghmm9aM8vE,1561723916,Steam,7994,7994,-1600,-1600,980,0,0,407483,False,PE3C-C79E-HB7K-HH6E
4sFoVu1HUTLc0Ck,1561715572,Amazon,7399,7399,-10442,-398,840,0,0,409083,False,79HT-PK1A-AX0K-E590
JEglnmNi7GdEA1I,1561707608,Wayforpay,5995,5995,-89000,-89000,980,0,0,419525,False,C283-1338-1A84-12HT
ki-h639wEWeT7Lg,1561656082,Glovo,5814,5814,-29300,-29300,980,0,0,508525,False,TKPH-513X-9M46-E79K
_U6nufyKtFwA6E0,1561654124,Glovo,5814,5814,-15600,-15600,980,0,0,537825,False,AT1H-9X7P-40BX-2738
HrTamtsAtdAZ4R4,1561573309,Glovo,5814,5814,-44000,-44000,980,0,0,553425,False,EA7A-P221-1C5T-T113
AdvN8dUOjbaHwgA,1561556402,Bolt,4121,4121,-6100,-6100,980,0,610,597425,False,92A2-B633-20EA-9PPP
zOmrnrGXeA7kBhU,1561545024,Glovo,5814,5814,-15600,-15600,980,0,0,603525,False,H78E-K7AA-1E75-149K
DTidk_Yz6fmMb2w,1561542927,Lesya,4829,4829,-600000,-600000,980,0,0,619125,True,1E65-24M8-EMA4-4C1P
heyscTnggwJyX3k,1561541776,–íi–¥: –ü–†–ò–•–û–î–¨–ö–û –ï.–í. –§–û–ü,4829,4829,1500000,1500000,980,0,0,1419125,True
Y6U7DHV20h7xvj8,1561530569,–ü–ª–∞—Ç—ñ–∂ COMFY,4829,4829,-137000,-137000,980,0,0,-80875,True
4OvaxwJxrM1HInU,1561490008,–°—ñ–ª—å–ø–æ,5411,5411,-8600,-8600,980,0,0,56125,False,XX10-H9B1-98KP-88E4
e5W2URskne3sp9U,1561481987,Bolt,4121,4121,-4100,-4100,980,0,41,64725,False,9TK9-P8X1-83XT-B457
TXIubmdHclQokSM,1561466273,PRODUKTOFF,5499,5499,-20800,-20800,980,0,0,68825,False,B92M-HK3H-BHM6-A5XC
ePW57g7HdR5wglQ,1561448528,Wayforpay,4121,4121,-30500,-30500,980,0,305,89625,False,6TH2-7AEE-BE2A-EEX9
2wk_NFzOqeeRVbE,1561448458,–ü—Ä–∏–≤–∞—Ç24,6536,6536,100000,100000,980,0,0,120125,False
3keUlTVHgtXdL_4,1561389024,Bolt,4121,4121,-5400,-5400,980,0,54,20125,False,9X6K-8A8B-6A02-K298
GVuulGBOGtWVaIw,1561366078,portmone.com.ua,4814,4814,-17000,-17000,980,0,0,25525,False,TXH4-8323-TK69-7846
kbmz7OotNBP8AFU,1561241139,–°–∫–∞—Å—É–≤–∞–Ω–Ω—è. Taxi,4121,4121,6100,6100,980,0,-61,42525,False
6BsErtsyNgIY1o0,1561239996,Bolt,4121,4121,-8200,-8200,980,0,82,36425,False,3BB9-7HP2-7KAH-2T29
KQO7wQt7RLLVNbU,1561239240,Taxi,4121,4121,-6100,-6100,980,0,61,44625,False
iJTzjivaob_vkeE,1561211552,PRAVDA REST-2,5812,5812,-7500,-7500,980,0,0,50725,False,3927-H2C9-9TMA-6MM2
6kXR_YJEGc3C1ZU,1561211528,"–¢–µ–∞—Ç—Ä –ø–∏–≤–∞ ""–ü—Ä–∞–≤–¥–∞""",5812,5812,-16000,-16000,980,0,0,58225,False,9AM8-M3P9-H142-5E1A
5JfLMPZEcXcyT84,1561198078,Svic09,5947,5947,-5000,-5000,980,0,0,74225,False,CM5E-7C79-PBX7-A667
HpfTXghFDfxjPIE,1561189758,Lesya,4829,4829,-52000,-52000,980,2000,0,79225,True,597K-3A7B-256T-A5X5
phDgu-cQ7I0Y7jc,1561116143,Bolt,4121,4121,-11400,-11400,980,0,114,131225,False,115T-301E-14M1-C8MC
wZ5ykeP68ZAlfmM,1561110109,Bolt,4121,4121,-9000,-9000,980,0,90,142625,False,1K0A-B799-P9XH-H0M3
OB0Oq--OsU2nee0,1561109076,Blackhany,5812,5812,-8300,-8300,980,0,0,151625,False,KKE0-63PK-80C1-0727
fpLKV6FSeUUkfH4,1561077738,HOTEL DNISTER (LVIV HA,5812,5812,-22500,-22500,980,0,0,159925,False,PAHC-1T3T-K48M-3T08
AHrHzb1zOde6l1o,1561067735,FOP TOKHME MALEK THE R,5812,5812,-13500,-13500,980,0,0,182425,False,EC14-E7P6-EH6E-MKA6
5ETFMmzGsoOXQMI,1561058970,Wayforpay,4121,4121,-13500,-13500,980,0,135,195925,False,X475-E5BC-0ABK-769T
ahuocwm0Hg-gKZQ,1561053394,HOTEL DNISTER (LVIV HA,5812,5812,-12500,-12500,980,0,0,209425,False,25K3-3E1H-B12E-B025
YpK7fqzgq34scug,1561039168,HOTEL BANK HOTEL,7011,7011,-5500,-5500,980,0,0,221925,False,0HP0-3724-8P7M-X3MC
CnZ3TsGUbAzGRls,1561035418,ATLJAS25D2VDMQVRNH001,5812,5812,-29400,-29400,980,0,0,227425,False,E886-HMPX-9X1C-HM6X
t90jKt4hgcjD-As,1561021236,Bolt,4121,4121,-11300,-11300,980,0,113,256825,False,7T6C-4MME-499A-B750
BnSKJY1Eq_qX0rc,1560991559,HOTEL DNISTER (LVIV HA,5812,5812,-79500,-79500,980,0,0,268125,False,2416-5EPC-X15P-5773
glL-7rtF34sYZiA,1560987032,HOTEL DNISTER (LVIV HA,5812,5812,-19500,-19500,980,0,0,347625,False,0EK8-H4XC-P637-XM87
_p4y1JzMUv26ELY,1560972038,–°–∫–∞—Å—É–≤–∞–Ω–Ω—è. Glovo,5814,5814,11900,11900,980,0,0,367125,False
MtwUZBV42dZRncY,1560970960,Glovo,5814,5814,-11900,-11900,980,0,0,355225,False
0_kLiVUOcHc6K1Y,1560947522,–ú–∏—Ö–∞–π–ª–æ –ö—É—â–µ–Ω–∫–æ,4829,4829,-31200,-31200,980,1200,0,367125,True,A33P-CPA8-8T0K-59CH
UkIowf26j9cX5To,1560935828,Bolt,4121,4121,-5100,-5100,980,0,359,398325,False,7P31-8XM8-3P6E-XM85
GgfdXNwQ0JDaySo,1560930084,Blackhany,5812,5812,-22200,-22200,980,0,0,403425,False,T74H-457X-41MC-8MXX
fgTMZ3lnk_ZMeGQ,1560898295,FOP TOKHME MALEK THE R,5812,5812,-10500,-10500,980,0,0,425625,False,0B90-HHMX-A7CT-6BBX
6ILOUq6MdpgB2nE,1560895156,FOP TOKHME MALEK THE R,5812,5812,-25000,-25000,980,0,0,436125,False,A7E8-H333-169K-22CB
diopzyc5N3JIOcI,1560893403,FOP TOKHME MALEK THE R,5812,5812,-10500,-10500,980,0,0,461125,False,P56X-10HC-C30P-968H
SGpG0MP5goqMHZE,1560889214,CHOVEN PIVBAR,5814,5814,-29000,-29000,980,0,0,471625,False,57HH-C6BH-6CP0-0579
LtU-2KY56c9F2p4,1560864265,Wayforpay,4121,4121,-15900,-15900,980,0,1590,500625,False,13A3-HP48-EE49-7M6M
nQ0NsLga-4fMSGM,1560857365,–Ü–≤–∞–Ω –î—ñ–±—Ä–æ–≤–∞,4829,4829,-20000,-20000,980,0,0,516525,True,K0B4-7K9C-CCB9-HMXH
b_u8Jg3_XKMmWP8,1560854287,Lesya,4829,4829,-800000,-800000,980,0,0,736525,True,85X6-HA0E-M6E7-T057
DdqYUzpd2rrulJU,1560854150,–íi–¥: –ü–†–ò–•–û–î–¨–ö–û –ï.–í. –§–û–ü,4829,4829,1400000,1400000,980,0,0,1536525,True
d-CiyMzB1eIwC48,1560842270,Wayforpay,4121,4121,-8500,-8500,980,0,85,136525,False,M13H-6H02-AAXB-HP86
jQXudUL__a8tCVs,1560839884,Wayforpay,4121,4121,-8000,-8000,980,0,80,145025,False,AEM2-58EB-6C09-1434
EJhyzb-JCmkqXaU,1560836390,HRCS2-001,5814,5814,-5400,-5400,980,0,0,153025,False,4A8P-68H4-P4KC-HKHX
6qmLTOIfWVMnuyE,1560824732,Taxi,4121,4121,-5700,-5700,980,0,57,158425,False,0692-98KE-H4M6-PM51
p0N1V3vBdqDZDco,1560806048,Amazon,7399,7399,-10553,-398,840,0,0,164125,False,60TX-8H6X-K639-303E
IYI0fFHLtadHyBA,1560797008,Taxi,4121,4121,-10000,-10000,980,0,100,174678,False,029H-ETHH-7661-MB5X
QE5NaVkNzb-NfgI,1560783414,Wayforpay,4121,4121,-30500,-30500,980,0,305,184678,False,MHE7-5M0A-T4E4-5KAA
hDmO_Y_JrSsgrZY,1560783396,–ó –¥–æ–ª–∞—Ä–æ–≤–æ—ó –∫–∞—Ä—Ç–∫–∏,4829,4829,188719,188719,980,0,0,215178,True
IzrqB0si3HIeiY0,1560765544,Wayforpay,4121,4121,-25500,-25500,980,0,255,26459,False,EAAE-H0E0-1B23-EB7M
GDw2uSrFtRYFMBo,1560755682,Wayforpay,5995,5995,-71400,-71400,980,0,0,51959,False,5AAE-K34B-T30E-TH30
vwJsZx6x3wRHy4g,1560748322,Wayforpay,4121,4121,-2300,-2300,980,0,23,123359,False,6HP3-82M2-T60H-X9A2
hnNJ1AoFI3J_QLs,1560705268,Wayforpay,4121,4121,-12100,-12100,980,0,121,125659,False,6K02-732K-5BA3-91KA
Hitc74DwPgzB4JA,1560704352,–°—ñ–ª—å–ø–æ,5411,5411,-31038,-31038,980,0,0,137759,False,70K0-20AM-EHCA-289T
FX1_PBifxFMpZYI,1560703270,–ï–ø—ñ—Ü–µ–Ω—Ç—Ä,5211,5211,-31500,-31500,980,0,0,168797,False,6B44-CMPA-X7BP-54C6
ODfaofx3KBrLEog,1560697465,Bolt,4121,4121,-10400,-10400,980,0,104,200297,False,34X3-740C-8H74-5754
W4trLTIzWosRsTk,1560685365,FOP PROROChENKO,7230,7230,-45000,-45000,980,0,0,210697,False,7AC8-M85M-CP7M-AK52
3Hhri9jyH4p9XJw,1560675756,Bolt,4121,4121,-14000,-14000,980,0,140,255697,False,26PE-P9AB-MP9M-84E6
LNDZY22aRDBQJ3w,1560668654,Lafabriqui,5814,5814,-23000,-23000,980,0,0,269697,False,CAEX-X79T-E614-59CT
CdFbB9J6g5bsoGk,1560623157,Bolt,4121,4121,-4900,-4900,980,0,49,292697,False,726A-E39A-592X-3BH6
ZEtAWBDmquVoVbk,1560621279,ARTEkler,5814,5814,-15400,-15400,980,0,0,297597,False,X1B8-976M-7TAK-E4K6
zEIhRTzYgBpuyeY,1560620427,NIKO BAR,5812,5812,-142600,-142600,980,0,0,312997,False,7P07-3C08-X034-98MX
niP9nX9Z5i1zqXA,1560614043,Bolt,4121,4121,-3400,-3400,980,0,34,455597,False,P1X2-KCKH-MK07-5KX0
ot-DNs09dSN0l_I,1560608370,Bolt,4121,4121,-9200,-9200,980,0,92,458997,False,45CX-HTXX-2X7C-3MM7
hU0PrDnzUdYgQOA,1560606361,–ï–ø—ñ—Ü–µ–Ω—Ç—Ä,5211,5211,-138735,-138735,980,0,0,468197,False,17EX-43E9-M687-253A
7saKMXYpYzJ3S4M,1560597845,Pizza King,5814,5814,-2200,-2200,980,0,0,6932,False,251B-9B27-B9BT-70B0
asmC2x66pGiPO7k,1560595800,Bolt,4121,4121,-4900,-4900,980,0,490,9132,False,930X-835X-72C7-05AC
Z-lBHPyYgfAOJEo,1560581635,Bolt,4121,4121,-7300,-7300,980,0,730,14032,False,6503-X064-BK06-3B0H
NbtDCdXNVwoBvco,1560579850,–í–∏–≤–µ–¥–µ–Ω–Ω—è –∫–µ—à–±–µ–∫—É 213.91‚Ç¥,4829,4829,17219,17219,980,0,0,21332,True
oIqEhQL2YJdLYNM,1560534307,BUDMO,5499,5499,-4650,-4650,980,0,0,4113,False,H440-B84H-H563-14HT
kMKaiAqCVK-EyRM,1560523830,–°–µ—Ä–≥—ñ–π –î—É—à–∏–Ω,–≤—ã—Ç—è–∂–∫–∞,4829,4829,-50000,-50000,980,0,0,8763,True,97EE-0KEC-8TK0-4H4A
qyDFKkuqFg_WsJo,1560515473,–í—ñ–¥: –ú–∞–∫—Å–∏–º –§–µ—â–µ–Ω–∫–æ,–º–∞–∫üëã,4829,4829,10000,10000,980,0,0,58763,True
AI3dxWgT6AOuwkA,1560509373,Glovo,5814,5814,-49200,-49200,980,0,0,48763,False,T16A-72A9-K8P9-MXCT
3E2OUZ7q4JZyKfk,1560495616,Bolt,4121,4121,-4800,-4800,980,0,480,97963,False,MH7M-8C28-143H-620T
x0pmV_3XRJwwoRM,1560428412,–î–µ–Ω–∏—Å –ö–æ—Ç–æ–≤,–º–∞–∫,4829,4829,-10000,-10000,980,0,0,102763,True,P19A-C90K-6M1A-AC4B
yYxoJ3VjUCofu4A,1560427213,–í—ñ–¥: –ö–æ—Å—Ç—è–Ω—Ç–∏–Ω –ê—Ñ–∞–Ω–∞—Å—å—î–≤,4829,4829,20000,20000,980,0,0,112763,True
lXxq0-2VOQCICjo,1560421710,Bolt,4121,4121,-29402,-3000,981,0,2940,92763,False,2400-0A10-B0T2-1XA8
95MjtU9BgLQtcHk,1560413303,Wayforpay,5995,5995,-89000,-89000,980,0,0,122165,False,0BTA-6AA8-84K4-748B
lQ3UowYBH-7s-Eo,1560411598,Bolt,4121,4121,-4307,-440,981,0,430,211165,False,965M-5018-PAHB-9A81
FPnoVRDfnzqJVq8,1560409795,Flower Time,5992,5992,-30000,-30000,980,0,6000,215472,False,4482-E671-M0K3-1A3P
AF_E97hzjuXx8K9AtXCQ,1560383820,"–°–∫–∞—Å—É–≤–∞–Ω–Ω—è —Å–ø–∏—Å–∞–Ω–Ω—è FONDY F, VUL. KRUGLOUNIVERSYTETS'KA, 14, KYIV, UA",6012,6012,27600,27600,980,0,0,245472,True
XfiSe9pV09EK-wg,1560367810,410232****2408,4829,4829,-30000,-30000,980,0,0,217872,True,EM06-180X-9878-H72C
bobmDSp6TI-gydc,1560364417,Glovo,5814,5814,-19000,-19000,980,0,0,247872,False,7377-8TBK-TEPC-2T6P
dbojCzdelhVkHW0,1560332398,MAGAZIN PRODUKTOVA LAV,5499,5499,-2400,-2400,980,0,0,266872,False,0470-M1CP-7196-HBE8
GifLbFKRnO5SHyA,1560331449,Egersund Seafood,5411,5411,-8400,-8400,980,0,0,269272,False,0T29-A707-5TK3-03TE
E6Bp-g8y4SN20bw,1560320867,Bolt,4121,4121,-5875,-600,981,0,587,277672,False,6A48-59K1-2M75-T9EX
UF2wxpFWdwplRLQ,1560254020,Glovo,5814,5814,-53500,-53500,980,0,0,283547,False,31H3-094B-EEE1-K08M
mrydusAyiynKato,1560234633,Bolt,4121,4121,-5368,-550,981,0,536,337047,False,1H11-M161-5T0X-47A9
h19rR86fL6BwMNE,1560202712,Bolt,4121,4121,-19489,-2000,981,0,1948,342415,False,B995-T1C7-5839-KAMA
oG7VxufDs6uW5gw,1560183339,–°—ñ–ª—å–ø–æ,5411,5411,-40440,-40440,980,0,0,361904,False,XB6B-42X0-24T4-2CAE
Xll8K05WiIRv_Sw,1560176915,Lesya,4829,4829,-800000,-800000,980,0,0,402344,True,B7BK-T97M-KT65-4EP3
uMKaoO78fSwlRk0,1560174461,MolokovidPHermera,5451,5451,-5760,-5760,980,0,0,1202344,False,P602-PAC6-XK6E-435M
Eir4dEQZ5M2iF0U,1560171632,–í—ñ–¥: –î–µ–Ω–∏—Å –ö–æ—Ç–æ–≤,–ö–∞–Ω–∞–ø–∞,4829,4829,38500,38500,980,0,0,1208104,True
iBVve53SsBO7Mnw,1560164440,Magazin,5499,5499,-3600,-3600,980,0,0,1169604,False,2X97-77M6-AM4H-HE87
aFXC4cZEh31LZ8c,1560164302,"–ü–∏—Ä—ñ–∂–∫–æ–≤–∞ ""–¢—ñ—Ç–∫–∞ –ö–ª–∞—Ä–∞""",5814,5814,-19300,-19300,980,0,0,1173204,False,4505-07KE-3XM5-3649
dJCYZIjkC423acI,1560159720,–íi–¥: –ü–†–ò–•–û–î–¨–ö–û –ï.–í. –§–û–ü,4829,4829,1100000,1100000,980,0,0,1192504,True
-XjgRHdROfBQAdc,1560148254,Lesya,4829,4829,-100000,-100000,980,0,0,92504,True,T80X-KAAK-BBMA-C5MC
eHbX01aSGlYtKiw,1560073561,–°—ñ–ª—å–ø–æ,5411,5411,-62156,-62156,980,0,0,192504,False,BPT0-BPPM-KP60-K7T5
lFeFdFaOfqOSrhc,1560073447,–°—ñ–ª—å–ø–æ,5411,5411,-12900,-12900,980,0,0,254660,False,E45T-E0C7-92KT-0857
M3MSI-aktK1Oi_0,1560062691,Lesya,4829,4829,-100000,-100000,980,0,0,267560,True,40BH-36M6-0754-4CE2
sOnmJixp8C8QAag,1560059756,Lesya,4829,4829,-3000,-3000,980,0,0,367560,True,T0BA-E412-4E9P-M854
wkYe0G8ik7ysqq4,1560009918,MolokovidPHermera,5451,5451,-16953,-16953,980,0,0,370560,False,17CT-X5M8-7BTH-34CX
VCb5z0z5ieVfKB4,1560003103,–ü–∞–ø–∞ –õ–µ—Å–∏,–æ—Ç –¢–∞—Ç—å—è–Ω—ã,4829,4829,-200000,-200000,980,0,0,387513,True,34P7-EX8C-CCP0-8TEH
asmC3B69oGyIObk,1559985945,Lesya,4829,4829,-100000,-100000,980,0,0,587513,True,PT4A-CH21-TE8M-HPA4
IFCZBwi4QBSwUWY,1559985194,–§–æ—Ä–∞,5499,5499,-33200,-33200,980,0,0,687513,False,H1B6-BE4X-824P-55CP
qjXLkaupde3zIDU,1559981175,–ö–∏—ó–≤—Å—å–∫–∏–π –º–µ—Ç—Ä–æ–ø–æ–ªi—Ç–µ–Ω,4111,4111,-800,-800,980,0,0,720713,False,E4CT-2P4X-EB14-3492
cRs2avG4RgC7hps,1559929180,FOP Pindzina L V 2,5992,5992,-17500,-17500,980,0,3500,721513,False,H56T-B3MT-020X-4ET1
Wxwa9Jsn-jogxsg,1559915317,Steam,7994,7994,-2400,-2400,980,0,0,739013,False,KPC3-A973-M2T9-P305
K278t-H0fwprVDU,1559906288,Glovo,5814,5814,-54400,-54400,980,0,0,741413,False,K2AP-4914-438T-M3M6
SXOMqqsB58BMEr0,1559891948,Lesya,4829,4829,-200000,-200000,980,0,0,795813,True,MAEX-T3M1-XB8E-75A0
FjlfHRJ6uaCj8ew,1559890978,ProduktiJArVal19,5499,5499,-6250,-6250,980,0,0,995813,False,8K0P-7P1X-X0HX-3PP1
SQdZT_V9AdNjOKQ,1559807547,ProduktiJArVal19,5499,5499,-4550,-4550,980,0,0,1002063,False,CAC4-9PH6-2CT8-X273
WroNaLKCFSLPbNc,1559745937,ZoomagazinZooBoss,742,742,-3500,-3500,980,0,0,1006613,False,300E-5ATE-3T9T-EC0M
Bf_1a1_zFNL_2CI,1559743459,Urban Spase 500,5812,5812,-26400,-26400,980,0,0,1010113,False,737M-KPH5-428C-P4CX
04vDaGxCrbl-rkA,1559743434,Urban Space 500,5812,5812,-9500,-9500,980,0,0,1036513,False,0HXM-T0XH-T0C7-7830
llf-HDwvUXbk9GY,1559719756,Lesya,4829,4829,-600000,-600000,980,0,0,1046013,True,X79P-B3KT-9BH8-M51K
MTY8HjC0ShnoBcA,1559718119,Wayforpay,4121,4121,-14400,-14400,980,0,1440,1646013,False,MAP0-B992-A287-3BTK
hwjyYSI1hXTTNFg,1559668145,Wayforpay,4121,4121,-6800,-6800,980,0,680,1660413,False,M3X9-XH99-9MPB-0P43
Hq3JCaaXh5OTRQY,1559665370,Lesya,4829,4829,-100000,-100000,980,0,0,1667213,True,10H9-C2CM-P81H-3MM5
QzESI81e9RJXGM8,1559663817,Lesya,4829,4829,-10000,-10000,980,0,0,1767213,True,PHXH-0XXK-MA61-KHA3
CP7YRzsGr_t7jJU,1559655507,FOP ARTYUKH GENNADIY,5812,5812,-6900,-6900,980,0,0,1777213,False,5BA3-2587-C66K-TEHM
TF3Y0fCkeryIK-0,1559655479,KANAPE,5812,5812,-118900,-118900,980,0,0,1784113,False,T5C1-T32M-7CTX-88E6
j5V7vnhy62fS8c0,1559655081,Wayforpay,4121,4121,-6500,-6500,980,0,650,1903013,False,08PT-T804-90X5-M06X
i7BMFsOqrqVTKAU,1559641633,Coffee Door,5812,5812,-7000,-7000,980,0,0,1909513,False,XABT-6PXT-301C-70CM
pudyjGWKYI5D-0o,1559630057,MolokovidPHermera,5451,5451,-9931,-9931,980,0,0,1916513,False,KMCB-391C-M5KB-CE3T
J0dnBf8ktqP_cfQ,1559590421,Wayforpay,4121,4121,-10000,-10000,980,0,1000,1926444,False,20P3-PXKK-C1T4-MP6H
OUhvAZxW8-8moXk,1559581325,Wayforpay,4121,4121,-11000,-11000,980,0,1100,1936444,False,MPA8-X8KH-P859-4X8M
32uKSDgCPohNE70,1559581265,Endorphin,5451,5451,-17500,-17500,980,0,0,1947444,False,7BXC-P729-87AA-C190
ENiNP6cIa81aYPI,1559571522,–ù–∞ –¥–æ–ª–∞—Ä–æ–≤—É –∫–∞—Ä—Ç–∫—É,4829,4829,-61803,-2300,840,0,0,1964944,True
h-ezp__mDBDAs4A,1559571043,–íi–¥: –ü–†–ò–•–û–î–¨–ö–û –ï.–í. –§–û–ü,4829,4829,2200000,2200000,980,0,0,2826747,True
ftqQaK5gN_hfQWw,1559550240,Right Coffee Bar,5814,5814,-29000,-29000,980,0,0,26747,False,2M8E-459X-HPHM-858B
5LuE2iUoj7YlXz0,1559491912,Novus,5499,5499,-17199,-17199,980,0,0,655747,False,7XXK-8066-7KPE-EKET
t04XEqniN1-Brw8,1559491729,Novus,5499,5499,-46020,-46020,980,0,0,672946,False,E8B1-23MT-1H0H-AMM3
TA8yBEie8wLQi5w,1559471444,MolokovidPHermera,5451,5451,-7050,-7050,980,0,0,118966,False,EM0P-7KMH-EA3E-2888
CRB0Ng4ABREVX44,1559470893,ZoomagazinZooBoss,742,742,-24700,-24700,980,0,0,126016,False,B19A-95KA-BEAP-T603
kl8DWt2S6IoOYew,1559402362,Taxi,4121,4121,-10000,-10000,980,0,100,150716,False,K6M7-HA98-C90A-2MA6
MJiK-aez5_JH29A,1559389387,–ï–ø—ñ—Ü–µ–Ω—Ç—Ä,5200,5200,-27192,-27192,980,0,0,160716,False,5BKH-45T8-BA4X-PKX6
UnAtc1dd2fZ0Z4Q,1559383418,KOMFI,5722,5722,-69900,-69900,980,0,0,187908,False,PPPM-M8CT-A1B8-6522
3lKF092phT2E0ck,1559381055,–í—ñ–¥—Å–æ—Ç–∫–∏ –∑–∞ —Ç—Ä–∞–≤–µ–Ω—å,4829,4829,2022,2022,980,0,0,257808,True
DZXzUo6kadazq50,1564486519,MAGAZIN PRODUKTOVA LAV,5499,5499,-7200,-7200,980,0,0,36347,False,9TM9-B685-71XH-303H
JnkmT_Wk7Jyze7U,1564482644,Bolt,4121,4121,-6300,-6300,980,0,0,43547,False,CX57-36AT-203M-1HC9
xm-Iw_fDH2k5ySY,1564403938,–î–µ–Ω–∏—Å –ö–æ—Ç–æ–≤,4829,4829,-5200,-5200,980,200,0,49847,True,ETHM-75XK-9C38-5CCA
bqzpaLWee5d0DjY,1564336336,"Avercamp ""–í–∞–ª—å-–¥–µ-–í–∞–ª—å""",5814,5814,-8432,-8432,980,0,0,55047,False,7P8B-BH98-29H0-516K
XkXP3eBCPmsVkuQ,1564312651,–ú–æ–ª–æ–∫–æ –í—ñ–¥ –§–µ—Ä–º–µ—Ä–∞,5451,5451,-6910,-6910,980,0,0,63479,False,2AE4-62MM-5M6P-06CA
LdfkwfChMTm8Xac,1564307921,Bolt,4121,4121,-5200,-5200,980,0,0,70389,False,AHB3-AEK8-550C-B3H6
6o68ffsTP8TAQBg,1564252154,–°—ñ–ª—å–ø–æ,5411,5411,-17200,-17200,980,0,0,75589,False,1B01-10HK-7C4E-2ME3
YPw2SXPQNoS7dds,1564227558,Right Coffee Bar,5814,5814,-15900,-15900,980,0,0,92789,False,T53X-6T9K-HACK-CTEE
jejme0GQzKN7Cp8,1564210997,–ü—Ä–æ–¥—É–∫—Ç–æ–≤—ã–π,5499,5499,-3475,-3475,980,0,0,108689,False,7B5C-B467-4E46-7HX5
2HkzVboNjJXK-eI,1564139828,–í—ñ–¥: –ú–∞–∫—Å–∏–º –ó–∞–±–æ–ª–æ—Ç–Ω–∏–π,Thanks,4829,4829,6000,6000,980,0,0,112164,True
_-I_id3VPVCtPTg,1564138814,–í—ñ–¥: –ú–∞–∫—Å–∏–º –ú—ñ–Ω–∞–∫–æ–≤,4829,4829,22000,22000,980,0,0,106164,True
7CTjTF0rKUGaeo4,1564131241,PRODUKTOVYI MAG,5499,5499,-4800,-4800,980,0,0,84164,False,2KCX-30C0-HMP0-C24X
j-UWa9e6cVelT_0,1564131103,"–ü–∏—Ä—ñ–∂–∫–æ–≤–∞ ""–¢—ñ—Ç–∫–∞ –ö–ª–∞—Ä–∞""",5814,5814,-25900,-25900,980,0,0,88964,False,P669-B45P-BXA6-C1X2
34QTT4RF-Sxuerw,1564120901,–ü–ª–∞—Ç—ñ–∂ COMFY,4829,4829,-137000,-137000,980,0,0,114864,True
cQeKSFV2sI5UV2E,1564077286,–°—ñ–ª—å–ø–æ,5411,5411,-17200,-17200,980,0,0,251864,False,0222-1A98-2563-T93K
lAxpkI9RmnmX11U,1564066126,–í—ñ–¥: –î–µ–Ω–∏—Å –ö–æ—Ç–æ–≤,4829,4829,22000,22000,980,0,0,269064,True
-hhHa_V6vITywW4,1563995959,–¶–∏–ø–∞ Taphouse,5812,5812,-22200,-22200,980,0,0,247064,False,1B6P-4529-CT8B-8T2M
Cn61iMkYDenr-ic,1563994099,Mon Cher,5814,5814,-35500,-35500,980,0,0,269264,False,2C7M-KBHT-H9H7-6A7B
C0HZi_6prswxDJk,1563976498,–í—ñ–¥: –í–∞–¥–∏–º –ê–Ω—ñ–∫—ñ–Ω,4829,4829,22000,22000,980,0,0,304764,True
Hbr10gi_6JA1Qts,1563967495,IZH1,5814,5814,-36500,-36500,980,0,0,282764,False,MP06-K1MT-TT80-CX2M
ZrQo3adRY06Gioo,1563958041,–í—ñ–¥: –û–ª–µ–≥ –ö–æ–≤–∞–ª–µ–Ω–∫–æ,4829,4829,22000,22000,980,0,0,319264,True
rNSjdNukN9yYQRQ,1563955711,Cosmo,5977,5977,-12210,-12210,980,0,0,297264,False,PKBA-ACP9-M108-4X3A
hmsAmT9z5jsNAUs,1563955202,–ê–ø—Ç–µ–∫–∞ –î–æ–±—Ä–æ–≥–æ –î–Ω—è,5912,5912,-21980,-21980,980,0,0,309474,False,ATA3-35B8-X13M-49XE
XrTTO_2hS00LvqE,1563919315,Bolt,4121,4121,-10300,-10300,980,0,0,331454,False,KC4T-K40P-K088-CXB7
wi2L9bsiA0wi_Jk,1563874541,Cosmo,5977,5977,-8120,-8120,980,0,0,341754,False,B5TH-B78P-M95B-4B00
iVvoxBUIg08rer4,1563874286,–Ø—Ä–æ—Å–ª–∞–≤–∞,5814,5814,-2800,-2800,980,0,0,349874,False,X60X-2C27-C6P2-PBAX
EESNjJuCj4sbbZ0,1563784541,portmone.com.ua,4899,4899,-20000,-20000,980,0,0,352674,False,PX4K-34CA-46P5-PAP1
HTnfuAf2CkroIDQ,1563777702,–°—ñ–ª—å–ø–æ,5411,5411,-12900,-12900,980,0,0,372674,False,M8E7-X746-MKM1-E0BE
sxfrW1_g9FdxhTI,1563714437,Bolt,4121,4121,-8000,-8000,980,0,0,385574,False,H6AM-0M5A-8H7T-121X
lg9ZPBy245lrS9c,1563704044,–ö–õ–û,5541,5541,-100014,-100014,980,0,0,393574,False,KM92-3CT6-9P85-84E4
tOiL8F_UXxkps2E,1563693251,Bolt,4121,4121,-12500,-12500,980,0,0,493588,False,57AH-73H9-0B9B-693K
bzHHKW8Sly2pibM,1563690542,Lesya,4829,4829,-210000,-210000,980,0,0,506088,True,295B-M96K-227T-96T9
65tZasC4x9VcSIY,1563628863,PHotosalonMAN,7221,7221,-2000,-2000,980,0,0,716088,False,2TK8-6MT3-K8A7-C902
ZzqqeS2j7kiXFjY,1563625997,TOV KNYHARNYA YE,5192,5192,-49284,-49284,980,0,4928,718088,False,6764-8KXK-A0A7-885K
JicymNBIylwmsrs,1563613683,EVA,5977,5977,-4699,-4699,980,0,0,767372,False,627A-P6HX-49CC-62XH
wmSbjnGdbzlUc6s,1563476269,The Cinematographer‚Äôs Party,5814,5814,-108500,-108500,980,0,0,772071,False,3T8P-PP43-99PX-A433
HKjX2GzjEqC9jV4,1563435727,–ú—ñ—Å—å–∫–µ –∫–∞—Ñ–µ ¬´–•–∞—Ä–º—Å¬ª (–ö–Ω–∏–∂–∫–æ–≤–∞ –∫—Ä–∞–º–Ω–∏—Ü—è ¬´–•–∞—Ä–º—Å¬ª),5814,5814,-30000,-30000,980,0,0,880571,False,5582-E4EH-TH36-HT57
tJ4jsSTH2ZPqj_M,1563429851,–°—ñ–ª—å–ø–æ,5411,5411,-17200,-17200,980,0,0,910571,False,0223-6698-AMAX-94HB
hbi0sm27kh76yKw,1563391162,Steam,7994,7994,-7600,-7600,980,0,0,927771,False,9K5C-885A-CAC5-2A81
e4-hfxpq-BDzglI,1563307520,410232****2408,4829,4829,-200000,-200000,980,0,0,935371,True,2E65-BC1M-E7TT-TA8A
iEtxwxzGkHa_Z1Q,1563300632,VEZUVIO,5814,5814,-16350,-16350,980,0,0,1135371,False,XA50-EA1K-48CK-447A
vFoc-M3sKLmofjw,1563300629,VESUVIO PIZZA CAFE,5814,5814,-7400,-7400,980,0,0,1151721,False,938K-CM9M-A0EK-B3M6
JIt9xpa-p99I5Og,1563276749,Lesya,4829,4829,-2000000,-2000000,980,0,0,1159121,True,AM5C-9HX1-HAP0-CB62
p8Yucu_VU0JNXdw,1563276546,–ù–∞ –¥–æ–ª–∞—Ä–æ–≤—É –∫–∞—Ä—Ç–∫—É,4829,4829,-36443,-1400,840,0,0,3159121,True
EFcbD5G0ipYswCA,1563271834,–íi–¥: –ü–†–ò–•–û–î–¨–ö–û –ï.–í. –§–û–ü,4829,4829,3000000,3000000,980,0,0,3195564,True
-b_hc4e2Z4dQVgs,1563267476,Bolt,4121,4121,-5500,-5500,980,0,0,195564,False,8C44-M042-KAAP-10X4
SnnkPWIA-DzTow8,1563208216,–ú–æ–ª–æ–∫–æ –í—ñ–¥ –§–µ—Ä–º–µ—Ä–∞,5451,5451,-2340,-2340,980,0,0,201064,False,C0A4-HH58-81M7-AEHT
FKlCM6ryGOLmKbI,1563198080,Glovo,5814,5814,-16600,-16600,980,0,0,203404,False,HHAK-863X-A850-M9C7
mrByrrBDgUfsZhc,1563190372,STEYKHAUS1,5814,5814,-14800,-14800,980,0,0,220004,False,MTC9-0X2M-C5X9-9C99
b6dodv46dMCO2is,1563170931,Glovo,5814,5814,-6900,-6900,980,0,0,234804,False,35PB-B6MM-007C-9A7A
VJmbrqjairKs65Y,1563123520,–ö–∏—ó–≤—Å—å–∫–∏–π –º–µ—Ç—Ä–æ–ø–æ–ªi—Ç–µ–Ω,4111,4111,-800,-800,980,0,0,241704,False,2458-HPA3-TKP9-K77T
kvvV3Ep5m2hqnLk,1563119489,–ö–∏—ó–≤—Å—å–∫–∏–π –º–µ—Ç—Ä–æ–ø–æ–ªi—Ç–µ–Ω,4111,4111,-800,-800,980,0,0,242504,False,M87E-XKT5-HBAK-CCHM
Z31YR1Wl7YJzbX0,1563110733,–§–æ—Ä–∞,5499,5499,-3218,-3218,980,0,0,243304,False,5A49-36TP-XHKX-4520
fgzACFA5YoLBR0s,1563109106,–ù–æ–≤–∞ –ø–æ—à—Ç–∞,4214,4214,-3500,-3500,980,0,0,246522,False,KX36-B376-K63K-M456
zJnnwEbnckG2US8,1563108897,APTEKA 7,5912,5912,-35250,-35250,980,0,0,250022,False,BTB6-64XA-M9E4-H54K
lRTli7AHDeob52I,1563105592,"–ü–∏—Ä—ñ–∂–∫–æ–≤–∞ ""–¢—ñ—Ç–∫–∞ –ö–ª–∞—Ä–∞""",5814,5814,-3500,-3500,980,0,0,285272,False,K3KX-HXA3-10C0-A8A3
Y3koH71a-PYd5ro,1563089232,–°—ñ–ª—å–ø–æ,5411,5411,-16899,-16899,980,0,0,288772,False,K28M-5M81-983E-696H
lKL4ZYKa6wqtUGM,1563033494,McDonalds,5814,5814,-25300,-25300,980,0,0,305671,False,H71P-27KH-T7M0-12KB
syL7dBsSLQQgtKU,1563032518,JYSK,5712,5712,-60000,-60000,980,0,0,330971,False,9KE9-BCEA-1MCE-X388
Q2rauaVxNk3M6s4,1563031450,–ï–ø—ñ—Ü–µ–Ω—Ç—Ä,5200,5200,-39346,-39346,980,0,0,390971,False,4BBB-4X8P-KCT7-B1KH
nidxY2YPKP7-xuo,1563003129,BUDMO,5499,5499,-4850,-4850,980,0,0,430317,False,9B10-E582-EM10-071C
u1seTeJ47uBzTko,1562921708,PRODUKTI,5499,5499,-2600,-2600,980,0,0,435167,False,995X-9BCE-903E-3HH2
m-sjKEcHYj5ItPs,1562880760,–¶–∏–ø–∞ Taphouse,5812,5812,-5800,-5800,980,0,0,437767,False,E3HE-5TAK-A168-H989
fB4UvpHFuxMXufQ,1562879958,–í—ñ–¥: –ö–∏—Ä–∏–ª–æ –ö—ñ—Ñ–æ—Ä—á—É–∫,4829,4829,7500,7500,980,0,0,443567,True
Cs0FgvnQOgpVaPM,1562863735,Glovo,5814,5814,-26000,-26000,980,0,0,436067,False,8B1K-EKPH-4E37-BAM6
GTna7AHT8UkW2tc,1562783922,Wayforpay,5499,5499,-35610,-35610,980,0,0,462067,False,XX99-XM63-9KTM-HM18
RTKqKKoTBxOafb8,1562780901,BeerMarket,5921,5921,-4449,-4449,980,0,0,497677,False,E291-B0X4-5HXP-M7A8
BULPJaa12TBRg3k,1562775090,–í—ñ–¥: –ú–∞–∫—Å–∏–º –§–µ—â–µ–Ω–∫–æ,–°–æ—Ñ—ñ –Ω–∞ –ø–æ–¥–∞—Ä—É–Ω–æ–∫,4829,4829,50000,50000,980,0,0,502126,True
A3ODkTPS92d7xL8,1562755774,Bolt,4121,4121,-5100,-5100,980,0,0,452126,False,M651-P9H8-HCX0-7992
xpc7RJxUZMK_UBc,1562749143,Endorphin,5451,5451,-2200,-2200,980,0,0,457226,False,7H3K-0T48-24B6-TH53
tvvoxVwpEJfL4l4,1562694712,BeerMarket,5921,5921,-4449,-4449,980,0,0,459426,False,2175-H043-HM1C-042P
ABTMtDYAZnZt0b0,1562694463,–ú–æ–ª–æ–∫–æ –í—ñ–¥ –§–µ—Ä–º–µ—Ä–∞,5451,5451,-7279,-7279,980,0,0,463875,False,8H0P-AE4C-PBH5-K3AM
beZoL7l0vqllwOA,1562616369,–¶–∏–ø–∞ Taphouse,5812,5812,-21312,-21312,980,0,0,471154,False,P8EM-5KE6-P999-9X81
crDNLAq0JA81CG4,1562609338,Glovo,5814,5814,-14600,-14600,980,0,0,492466,False,77T8-1T4P-4596-5468
kOPltU6gcdlfeA4,1562609156,Lesya,4829,4829,-30000,-30000,980,0,0,507066,True,AT6H-PH51-56P0-25PH
tGSa31xzw4VHWE4,1562589224,Cosmo,5977,5977,-5970,-5970,980,0,0,37066,False,KBBH-994E-H8P6-0010
F1xKpDYL6NA3Mj4,1562520996,Roshen,5441,5441,-17307,-17307,980,0,0,43036,False,CH90-041E-X2BB-CT10
glyTrA1VSsy5MnQ,1562516966,Lesya,4829,4829,-30000,-30000,980,0,0,60343,True,M1PP-3764-K1PE-7127
-ywScRUHykJyWf0,1562511053,BUDMO,5499,5499,-9700,-9700,980,0,0,90343,False,936H-7692-M9ET-528T
fhd4CrCUL-TCa8c,1562507483,–°—ñ–ª—å–ø–æ,5411,5411,-16099,-16099,980,0,0,100043,False,M02X-22EA-T287-12C2
P3TDVHD8N_K5SsA,1562504979,–°—ñ–ª—å–ø–æ,5411,5411,-35689,-35689,980,0,0,116142,False,1611-ETCC-91A4-KB6H
01lFbK2HAifdNWI,1562497251,–ê–¢–ë,5411,5411,-20120,-20120,980,0,0,151831,False,6MBB-BE57-H73X-36HM
ceUcg6l7jElgVAA,1562478003,–§–æ—Ä–∞,5499,5499,-33021,-33021,980,0,0,171951,False,B0C6-H3BB-HHEX-MT9M
TN5iKYsxAClD1x4,1562475385,Taxi,4121,4121,-9900,-9900,980,0,0,204972,False,P787-M7E2-MEHT-2P7X
DhP9C6S9C2-ryjY,1562442398,Billa,5411,5411,-1999,-1999,980,0,0,214872,False,3P75-KB0A-3519-76C9
Q1ktJi0quIkaGqU,1562439002,–¶–∏–ø–∞ Taphouse,5814,5814,-26900,-26900,980,0,0,216871,False,K6XK-3P78-58E1-H4KP
e39ZGJURkgK3nzk,1562438970,–¶–∏–ø–∞ Taphouse,5812,5812,-75000,-75000,980,0,0,243771,False,X805-76EC-5TK5-B8MB
1wRhP3aO_AvIDrY,1562420585,–°–∫–∞—Å—É–≤–∞–Ω–Ω—è. Steam,5816,5816,8300,8300,980,0,0,318771,False
S2kCq7OjASVWdoE,1562415188,Steam,5816,5816,-8300,-8300,980,0,0,310471,False
iN0UMg4NZR3uHac,1562406350,BUDMO,5499,5499,-3070,-3070,980,0,0,318771,False,40P8-28XT-M5X5-3H86
Blmm4cgWK90eNzQ,1562355145,Taxi,4121,4121,-12000,-12000,980,0,0,321841,False,1177-MM3E-04HX-C0K8
OqTt1Us6eCxEoTU,1562343684,Varvar Bar,5812,5812,-64000,-64000,980,0,0,333841,False,2A03-1TK7-PCB9-4E09
yr3urNQGaWBuwKM,1562327012,PROGRESS CAFFE,5814,5814,-10500,-10500,980,0,0,397841,False,AX86-9E11-P53M-02A8
GqS1qkHZp2I041I,1562316140,–ú–∞–∫—Å–∏–º –ó–∞–±–æ–ª–æ—Ç–Ω–∏–π,–±–∞–Ω–∫–æ–º–∞—Ç üíµ,4829,4829,-70000,-70000,980,0,0,408341,True,A1KH-PME3-8X95-KTBH
m8rYaB8k2r4lqZo,1562310913,–Ø—Ä–æ—Å–ª–∞–≤–∞,5814,5814,-6000,-6000,980,0,0,478341,False,7659-MB43-A68H-K598
TRS0EHZjzTwxR7Q,1562266679,Lesya,4829,4829,-300000,-300000,980,0,0,484341,True,4AA3-T4K9-1KBP-E49M
Lm-_VkTxfxecbPQ,1562239230,473121****6580,4829,4829,-19096,-19096,980,0,0,784341,True,P730-2K87-715A-2PCX
Pfc8tL0renyOr2Q,1562219602,–°—ñ–ª—å–ø–æ,5411,5411,-17200,-17200,980,0,0,803437,False,BA90-H0XA-8XPH-55B8
H2dNsY85KoOozyw,1562138026,Right Coffee Bar,5814,5814,-5500,-5500,980,0,0,820637,False,TC4C-5559-C094-H9E9
bBmmKpyJR9y9mFw,1562088671,Mira Cafe,5814,5814,-10430,-10430,980,0,0,826137,False,65CC-71M4-116H-15HH
YV9bvYSLj_Ch-NI,1562078220,516749****3010,4829,4829,-150000,-150000,980,0,0,836567,True,MH6K-2TT3-X802-ET8K
NLDx3zFqv0mSmcU,1562069150,METRO,5411,4215,-148596,-148596,980,0,0,986567,False,ETP1-5MXM-69MX-B637
VTeLNnerSvwQQAI,1562068853,Wayforpay,4121,4121,-7800,-7800,980,0,0,1135163,False,EE3T-8K22-64E8-6T63
5Kn8PJ0cKbEa7Ug,1562063591,Wayforpay,4121,4121,-8500,-8500,980,0,0,1142963,False,95K0-785C-P5H6-BMMC
3gLmzguQHYWcPqA,1562057855,Glovo,5814,5814,-26400,-26400,980,0,0,1151463,False,CH93-XH6H-3937-9006
evz42tSoD1cs-oE,1562052194,Wayforpay,5995,5995,-42800,-42800,980,0,0,1177863,False,EP9X-BEC5-2A69-2A6B
xWa6DU4F1lS524Q,1562049477,Right Coffee Bar,5814,5814,-25000,-25000,980,0,0,1220663,False,87E0-XT9B-XPM1-AC23
oXve1ZUCwz2XM8M,1562045608,Lafabriqui,5814,5814,-7600,-7600,980,0,0,1245663,False,5K7K-721B-5A13-6HM7
eJF8JqNltNR7hJA,1562005498,BeerMarket,5921,5921,-8598,-8598,980,0,0,1253263,False,8H6H-73MH-16MM-2ET3
0wIPDLaWYEeFX1c,1562004478,RESTORAN BASSANO DOLCE,5812,5812,-31000,-31000,980,0,0,1261861,False,B7KC-X152-PB28-T8T9
yecRw2U9nxPqPQs,1561982801,Lesya,4829,4829,-1500000,-1500000,980,0,0,1292861,True,HKM6-080H-6EK3-T517
muTTyvTAS9ztokI,1561982791,–ù–∞ –¥–æ–ª–∞—Ä–æ–≤—É –∫–∞—Ä—Ç–∫—É,4829,4829,-89201,-3400,840,0,0,2792861,True
Oidfs9QPaJKAtuM,1561981878,Glovo,5814,5814,-22300,-22300,980,0,0,2882062,False,4B9T-XC7K-P3X8-94BA
aQZa6UWYkAr9L2U,1561981163,–íi–¥: –ü–†–ò–•–û–î–¨–ö–û –ï.–í. –§–û–ü,4829,4829,3000000,3000000,980,0,0,3104362,True
2rLmFPGDjjwTXmo,1561976185,–í—ñ–¥—Å–æ—Ç–∫–∏ –∑–∞ —á–µ—Ä–≤–µ–Ω—å,4829,4829,1341,1341,980,0,0,104362,True
ITy-LtZDrf7l7CE,1567171627,Progress Cafe,5814,5814,-6000,-6000,980,0,0,486140,False,CKXC-3H04-36A2-5KP5
6PDh_UrqbMyoMJw,1567156082,Produkti,5499,5499,-2600,-2600,980,0,0,492140,False,5KC4-7B6K-4PBB-0HHH
U7FaprC1SbATx2I,1567149111,APTEKA_______7,5912,5912,-5500,-5500,980,0,0,494740,False,H59H-4M8K-235K-7KC2
DMUU-cSINlvj9H0,1567091388,Lesya,4829,4829,-36000,-36000,980,0,0,240,True,37X9-XPM4-52PH-22K9
Fwgij_hV3iQeK2Y,1567089695,Progress Cafe,5814,5814,-6000,-6000,980,0,0,36240,False,M9E8-H5B4-1K0A-T2PM
260iXPe8-4HLv2U,1567073674,Bolt,4121,4121,-6400,-6400,980,0,0,42240,False,H1M6-C30K-AK72-H2EE
C7k6vPsOy03E1ho,1567062273,Lesya,4829,4829,-100000,-100000,980,0,0,48640,True,H8EB-XKEK-9AT4-7153
jRlG_3iFTAdp6jc,1567018826,Bolt,4121,4121,-7900,-7900,980,0,0,148640,False,5H5B-X2PC-77A7-6P5B
R4bezFYxwvbrVSE,1567015368,Bolt,4121,4121,-7600,-7600,980,0,0,156540,False,17XT-P1X6-HP36-M3EB
i4FbRzbyGcCceus,1567006957,–ö–∏—ó–≤—Å—å–∫–µ –º–µ—Ç—Ä–æ,4111,4111,-800,-800,980,0,0,164140,False,3EBX-66AB-XHTM-C5HB
jHV03Iifog6mt4Q,1567002262,Bolt,4121,4121,-6200,-6200,980,0,0,164940,False,251T-3X4A-C12M-HKEH
YuY2Tldy3LysRYw,1566997108,Grecheskajaolivochka,5499,5499,-12000,-12000,980,0,0,171140,False,HHMP-960P-0P09-26P7
-4A35WYIaM2OMZs,1566891890,Lesya,4829,4829,-200000,-200000,980,0,0,183140,True,14T1-BT8B-MHX1-K3MH
lSsqO4ScH0EWkw0,1566835384,KuznjaRebrataPiva1,5814,5814,-45300,-45300,980,0,0,383140,False,EB8P-07ET-M4TB-XT7P
axwkblas5s6xAE4,1566831060,Bolt,4121,4121,-5200,-5200,980,0,0,428440,False,6B0K-TC2B-8TX4-X017
c650tI1ZJ21glDc,1566816575,–°—ñ–ª—å–ø–æ,5411,5411,-16731,-16731,980,0,0,433640,False,9866-0K7A-9P9A-7XC9
akMp6RvPCgQ9H-g,1566815460,–í–∏–≤–µ–¥–µ–Ω–Ω—è –∫–µ—à–±–µ–∫—É 623.44‚Ç¥,4829,4829,50186,50186,980,0,0,450371,True
QMBT1IS2jgnEMiw,1566800377,APTEKA_______7,5912,5912,-8940,-8940,980,0,0,400185,False,3CE5-CABM-5EXH-9MHT
o4AGZ1TTQ9OLEXk,1566726161,–°—ñ–ª—å–ø–æ,5411,5411,-21035,-21035,980,0,0,409125,False,K7EP-PT14-3810-C9TP
-eKhsxrAAvga48c,1566726097,–°—ñ–ª—å–ø–æ,5411,5411,-35444,-35444,980,0,0,430160,False,208M-HA2A-7BTC-4P46
Sa8qow2fIv6BeoI,1566666009,APTEKA   16,5912,5912,-5290,-5290,980,0,0,465604,False,8M6P-XP16-MPE3-9762
3zdO-yb74Mn850M,1566665361,–ë–µ–∑ –î–≤–µ—Ä–µ–π Espresso Bar,5812,5812,-5000,-5000,980,0,0,470894,False,2BXX-C121-K4A0-543P
427hI6MmPap4in8,1566663667,TSERKOVNYY M.V.,5812,5812,-12292,-12292,980,0,0,475894,False,2KPT-62T9-020M-BM99
B4DZCBBycLySvWo,1566649119,Karnivora1,5812,5812,-10900,-10900,980,0,0,488186,False,BMKP-K0B6-A7XH-PHM8
7JM9T6iA9BDvrMM,1566648837,Karnivora1,5499,5499,-75600,-75600,980,0,0,499086,False,XTMM-307E-781P-MHPX
Cj8nBZ0RdlHjDjE,1566646022,–ö–∏—ó–≤—Å—å–∫–µ –º–µ—Ç—Ä–æ,4111,4111,-800,-800,980,0,0,574686,False,12CC-5ATC-MP65-BCX5
L3HrDoNM2jMOVpU,1566638429,Bolt,4121,4121,-8900,-8900,980,0,0,575486,False,7M01-X0E0-76C3-4PPA
NJffPzjIOv_hnuI,1566632791,–ü—Ä–æ–¥—É–∫—Ç–æ–≤—ã–π,5499,5499,-5875,-5875,980,0,0,584386,False,9HT5-K62M-2B04-73C4
Bm0HqkAYLEUPq4o,1566561673,535129****7470,4829,4829,-4000,-4000,980,0,0,590261,True,2X27-B04H-H212-2TH5
F6Z50JMxJv88zBE,1566556977,PRODUKTI,5499,5499,-2600,-2600,980,0,0,594261,False,5E39-BM45-HA4B-7CA5
zQKJcy9JfB-KVPo,1566552129,–ú–∞–∫—Å–∏–º –§–µ—â–µ–Ω–∫–æ,4829,4829,-10000,-10000,980,0,0,596861,True,7440-T54E-1CCE-B2P9
8kPluyvhZ_coK9o,1566496654,Uklon,4121,4121,-13200,-13200,980,0,709,606861,False,4C67-87PE-EC0K-68A7
oX9-ASVRS3B3MsE,1566495836,–°—ñ–ª—å–ø–æ,5411,5411,-27397,-27397,980,0,547,620061,False,M674-085P-52KE-C1BC
veRZOFxDvRgDSk0,1566489444,–í—ñ–¥: –û–ª–µ—Å—è –°–∞—á–µ–Ω–∫–æ,4829,4829,200000,200000,980,0,0,647458,True
4DqKhR4gVKqrc0Q,1566489099,Lesya,4829,4829,-300000,-300000,980,0,0,447458,True,ABHM-X483-0BK5-HH9M
mDF7eiC3oupN5Qk,1566466767,–í—ñ–¥: –ú–∞–∫—Å–∏–º –§–µ—â–µ–Ω–∫–æ,4829,4829,5000,5000,980,0,0,747458,True
yoD6EDcngz4M3G8,1566459081,BUSINESS COFFEE,5812,5812,-4500,-4500,980,0,0,742458,False,EEM8-C3AP-4KP3-P50K
u90-GGMD5oXtYDw,1566400066,Bolt,4121,4121,-9800,-9800,980,0,1960,746958,False,98K0-M8E4-PTBH-52A2
qaukEqmIOZE0Ui8,1566389742,Bolt,4121,4121,-9900,-9900,980,0,1980,756758,False,A58P-H9XC-1T34-PX95
6oJtvfsrtK-obZo,1566381709,BUSINESS COFFEE,5812,5812,-4500,-4500,980,0,0,766658,False,E2BE-4P4B-E12B-9PPH
XGwl-AmwOciX48w,1566380701,516874****7317,4829,4829,-28000,-28000,980,0,0,771158,True,C3KT-54BX-CX79-XH0C
Sn_GqluLd02U-YE,1566376268,portmone.com.ua,4899,4899,-20000,-20000,980,0,0,799158,False,21CA-27H7-98MM-C8T6
INq4nCec-UCiGz8,1566374545,–ú—ñ—Å—å–∫–µ –∫–∞—Ñ–µ ¬´–•–∞—Ä–º—Å¬ª (–ö–Ω–∏–∂–∫–æ–≤–∞ –∫—Ä–∞–º–Ω–∏—Ü—è ¬´–•–∞—Ä–º—Å¬ª),5814,5814,-4700,-4700,980,0,0,819158,False,M9P0-BAMB-3PM5-B7EM
S0k9FG9zrg2HXQk,1566367848,–°—ñ–ª—å–ø–æ,5411,5411,-30100,-30100,980,0,602,823858,False,M99H-7XB1-H9XK-XM46
TFnqx1MWsVSIe2U,1566324821,Bolt,4121,4121,-7900,-7900,980,0,1580,853958,False,P7CH-1592-EH03-53H4
Yxkzdoztu97tEcg,1566324739,Bolt,4121,4121,-8300,-8300,980,0,1660,861858,False,1C0A-B14P-EP65-32X4
f6qdNk87Xa8uxSg,1566312939,Bolt,4121,4121,-6400,-6400,980,0,1280,870158,False,3174-MC3B-H600-857B
qUUHdvSow1agu_M,1566310939,Bolt,4121,4121,-7800,-7800,980,0,1560,876558,False,BXAE-T3CP-09P5-5TKC
hQo1YpWQYvw80Qw,1566291484,Bolt,4121,4121,-5300,-5300,980,0,1060,884358,False,9M5C-A1AT-27AX-3T84
HyZu5ypsj6B5dVU,1566282951,Lesya,4829,4829,-1000000,-1000000,980,0,0,889658,True,E941-E0E9-9K42-T5H7
4GOhG86QlymGOsw,1566279466,Bolt,4121,4121,-5000,-5000,980,0,1000,1889658,False,B8AE-4E7E-CP27-6P0B
m-Ssja-ZCSRWFKo,1566277817,Bolt,4121,4121,-4200,-4200,980,0,840,1894658,False,6CPP-BHXT-XAP8-T12H
dLy47uJLBSj8deI,1566247442,Bolt,4121,4121,-5900,-5900,980,0,1180,1898858,False,91M4-7TTE-6T97-MXKM
OEnnJkjIoasWiYg,1566246762,FOP PROBAChAY OM,742,742,-72601,-72601,980,0,0,1904758,False,X18H-TCXH-B7X7-A0A1
ZiHtKIKxtD8L54A,1566237999,Bolt,4121,4121,-7600,-7600,980,0,1520,1977359,False,8K0H-KA5B-57AA-711B
NcXzxpG-qW3Z4zw,1566235761,–ê–ø—Ç–µ–∫–∞ –ù–∏–∑—å–∫–∏—Ö –¶—ñ–Ω,5912,5912,-6070,-6070,980,0,0,1984959,False,X5CT-683B-32KM-BXH8
w6oEWIB5J3c8yhE,1566221267,Bolt,4121,4121,-10000,-10000,980,0,2000,1991029,False,8AA4-0E75-M02T-6631
L4Q6nnbjAOZh8Js,1566218315,Progress Cafe,5814,5814,-4500,-4500,980,0,0,2001029,False,AEXK-HA07-7P7X-4E67
Jeitb3jBOkhN6Iw,1566211556,Lesya,–Ω–∞ –ø–∞—Å—Ç–µ–π—à–∏,4829,4829,-1000000,-1000000,980,0,0,2005529,True,3270-ACP1-38B8-MMTX
YzjMVWYds8XGVRo,1566210389,Lesya,4829,4829,-400000,-400000,980,0,0,3005529,True,0P72-8262-6C6B-0P52
8edAuJEcJ5D5TMk,1566207798,Bolt,4121,4121,-4600,-4600,980,0,920,3405529,False,60XK-80E4-00C6-53H1
33sN3orIYF3kL7E,1566206694,–ù–∞ –¥–æ–ª–∞—Ä–æ–≤—É –∫–∞—Ä—Ç–∫—É,4829,4829,-78646,-3100,840,0,0,4010129,True
ZhIaE4cTowu6GjI,1566206261,–íi–¥: –ü–†–ò–•–û–î–¨–ö–û –ï.–í. –§–û–ü,4829,4829,4000000,4000000,980,0,0,4088775,True
rxRjw0bHQfiDB88,1566158826,Bolt,4121,4121,-6700,-6700,980,0,67,88775,False,7E12-9H2X-T8B5-KHC6
yzQTy-G1nkrhFTI,1566150872,Bolt,4121,4121,-4400,-4400,980,0,44,95475,False,E0K6-K3XP-K625-HA56
djUASoXorSSkF3g,1566129332,–ö–∏—ó–≤—Å—å–∫–µ –º–µ—Ç—Ä–æ,4111,4111,-800,-800,980,0,0,99875,False,54E4-6XHP-B003-CXX3
fndCdTQha_a4tAg,1566128751,Goodwine,5921,5921,-14500,-14500,980,0,145,100675,False,13AE-8CMK-T50H-36X1
aMTVdm4D9BJCCA8,1566125821,–ö–∏—ó–≤—Å—å–∫–µ –º–µ—Ç—Ä–æ,4111,4111,-800,-800,980,0,0,115175,False,C37B-1188-BX33-T088
pvFeLj7vZMOHnB4,1566118996,Bolt,4121,4121,-6000,-6000,980,0,60,115975,False,T220-K6A5-XE6P-2MKA
vvY__3m1fgyszOI,1566114644,–ú–æ–ª–æ–∫–æ –í—ñ–¥ –§–µ—Ä–º–µ—Ä–∞,5451,5451,-13758,-13758,980,0,137,121975,False,4EMX-BC19-53MX-P71E
GucVK3tcEpcY2Z4,1566111362,–ê–ø—Ç–µ–∫–∞ –ù–∏–∑—å–∫–∏—Ö –¶—ñ–Ω,5912,5912,-10850,-10850,980,0,0,135733,False,XACA-02H9-HMC6-7HPE
tLU5hqLqevz3tHs,1566074677,Bolt,4121,4121,-5000,-5000,980,0,50,146583,False,905C-AB13-0P7X-6PP5
c2vHqUhde_6k5sU,1566074486,FOP PROBAChAY OM,742,742,-57600,-57600,980,0,0,151583,False,PE44-94KP-908X-54B2
l2TjGVU4OSnDQwc,1566068499,–ë–∞–Ω–∫–æ–º–∞—Ç KREDOBANK,6011,6011,-41600,-41600,980,1600,0,209183,False,ET3K-MC6T-EKM9-P9B6
mDZsZ7uXzO4kN4w,1566068371,Apteka 12 Farmart LTD,5912,5912,-7490,-7490,980,0,0,250783,False,E769-0X86-59KC-7C67
BGtnJR0Fcht60QE,1566065606,Bolt,4121,4121,-3400,-3400,980,0,34,258273,False,058X-BEX5-AKPB-C1XT
keb2ZJyU0XjFvA8,1566051276,Wayforpay,5995,5995,-40800,-40800,980,0,0,261673,False,0BP9-A960-TX4T-0AT8
StzcoA16Wu9KJWY,1566037319,iPay.ua,6536,6536,60000,60000,980,0,0,302473,False
mZRUQcoOHaTULjI,1566033109,–ö–∏—ó–≤—Å—å–∫–µ –º–µ—Ç—Ä–æ,4111,4111,-800,-800,980,0,0,242473,False,6EK9-T44X-BK65-9CKH
pIsQCUWwf8E2Xrk,1566032437,Bolt,4121,4121,-6200,-6200,980,0,62,243273,False,1KK3-ETKK-BA9K-7M7A
WQQyCAPgDctSs24,1566024620,FOP PROBAChAY OM,742,742,-16000,-16000,980,0,0,249473,False,XEB6-M465-965H-0XKT
_FtniwRiP_Owy1A,1566024107,–ë–∞–Ω–∫–æ–º–∞—Ç ATM6305 PIVDENNYI,6011,6011,-52000,-52000,980,2000,0,265473,False,50HM-M032-591M-B88T
lZhMfkgzUIoLOqs,1566021746,Wayforpay,4121,4121,-8200,-8200,980,0,82,317473,False,28BA-5292-C636-96B5
gm_di6Yd1eNBxQc,1566005753,FOP PROBAChAY OM,742,742,-40700,-40700,980,0,0,325673,False,2879-292P-5H80-T48H
R51ySmJ30Zzd3pw,1565999669,FDY*UKLON,4121,4121,-10300,-10300,980,0,103,366373,False,PTXP-0EK6-H89P-E462
vwdSuPffzeVWOiU,1565996256,–í—ñ–¥: –ö–æ—Å—Ç—è–Ω—Ç–∏–Ω –ê—Ñ–∞–Ω–∞—Å—å—î–≤,4829,4829,55000,55000,980,0,0,376673,True
1gc8jyfXqLZO7yc,1565995733,BARWHOWHY,5814,5814,-241000,-241000,980,0,0,321673,False,AKHP-HBA7-01KP-AKAX
5MH4md7LrsamPhY,1565987855,–¶–∏–ø–∞ Taphouse,5812,5812,-13500,-13500,980,0,0,562673,False,4B3K-HCBB-AE4P-A4EB
eEiM_BMjHf86Tqk,1565967679,PRODUKTI,5499,5499,-12201,-12201,980,0,122,576173,False,EK5K-5EE0-41CT-2H59
G_l7Ofcp6XUrmk4,1565958560,Honey. Cafe-confectionery,5812,5812,-11700,-11700,980,0,0,588374,False,MKM0-XAKH-CMKM-E21T
B9fnLzvD5CaR96Y,1565946691,Lesya,4829,4829,-104600,-104600,980,0,0,74,True,ME80-HKXH-T76E-CCX7
02_5MfXEUWI7OaU,1565936550,Konditersyka-pekarnya,5441,5441,-5900,-5900,980,0,118,104674,False,KX77-822X-M5E6-H745
DSimmjn_xZW38cw,1565878106,Bolt,4121,4121,-5600,-5600,980,0,1120,110574,False,7744-P2E6-519E-AXKP
7iw2EKBj4vpS8ns,1565874074,Bolt,4121,4121,-5800,-5800,980,0,1160,116174,False,PXH5-20K5-E708-8TH6
jJ-B5ubVp0ClSPM,1565873407,Honey. Cafe-confectionery,5812,5812,-11700,-11700,980,0,0,121974,False,4PK8-K097-X802-3HH6
Tot82zZ20-KVFJE,1565873139,Mon Cher,5814,5814,-52400,-52400,980,0,0,133674,False,7H5B-E05K-E89K-C76T
whPcaaRPQ_OhdNU,1565805370,–ú–æ–ª–æ–∫–æ –í—ñ–¥ –§–µ—Ä–º–µ—Ä–∞,5451,5451,-3600,-3600,980,0,72,186074,False,4A8H-AM2B-4C6P-6456
bgp3UvX8CAz0wFY,1565801812,–ù–∞ –¥–æ–ª–∞—Ä–æ–≤—É –∫–∞—Ä—Ç–∫—É,4829,4829,-68848,-2700,840,0,0,189674,True
-hWcI7pvrgtcds4,1565716678,Wayforpay,4121,4121,-13600,-13600,980,0,2720,258522,False,0E8X-T5P0-5354-1P36
obUZCQzbj0EYBS8,1565714615,–ù–∞—Ç–∞–Ω –î–∂–æ–∑–µ—Ñ –ï–≤–µ—Ä–µ—Ç,–õ–µ—Å—è,4829,4829,-36500,-36500,980,0,0,272122,True,BP84-C2A5-XTH0-EE19
ubgyLekdsJtOiKE,1565699669,Wayforpay,4121,4121,-11100,-11100,980,0,2220,308622,False,CTM2-921E-7TA7-C6A8
C91VKk9bhks5RAc,1565694966,–ù–∞ –¥–æ–ª–∞—Ä–æ–≤—É –∫–∞—Ä—Ç–∫—É,4829,4829,-35608,-1400,840,0,0,319722,True
N4sPBieYc7Fusjo,1565694667,–í—ñ–¥: 516798****8598,4829,4829,300000,300000,980,0,0,355330,True
nui5J1rsefbSwrc,1565694080,Wayforpay,4121,4121,-8700,-8700,980,0,1740,55330,False,4385-90KT-BBTE-6T14
i8gb8NBsL5BazO0,1565690070,Lesya,4829,4829,-110000,-110000,980,0,0,64030,True,9T84-5A8H-2E13-KEKH
wBm7arzG0sYxRbU,1565632796,BeerMarket,5921,5921,-9598,-9598,980,0,191,174030,False,CA8H-AK4T-044B-C4B4
pGZZaZGgOqhZbs8,1565546985,–°—ñ–ª—å–ø–æ,5411,5411,-25800,-25800,980,0,516,183628,False,4CB8-MC21-56EC-461C
nu1sSFBm4Qat9SQ,1565538917,Lesya,4829,4829,-60000,-60000,980,0,0,209428,True,570B-BH7M-B6B4-94HB
QPHyd5_UP4o6BYQ,1565530568,–ë–∞–Ω–∫–æ–º–∞—Ç –ê–¢–ë,6011,6011,-30150,-30150,980,150,0,269428,False,K59T-MEXE-0K6K-7TP2
WKWJT1zCbMjZzWc,1565530493,–ê–¢–ë,5499,5499,-18220,-18220,980,0,364,299578,False,91A8-TT03-BK44-ME6A
zdjckDtG16CguEU,1565527620,516874****0807,4829,4829,-47000,-47000,980,0,0,317798,True,24P0-2A1B-P863-TKMB
YyHg694bgHYLWDQ,1565505942,–ü—Ä–æ–¥—É–∫—Ç–æ–≤—ã–π,5499,5499,-3500,-3500,980,0,70,364798,False,HPEC-P8TT-H84T-EX03
oiyvI1SfneH85d0,1565438669,Konditersyka-pekarnya,5441,5441,-15000,-15000,980,0,300,368298,False,9BM0-CBAB-97C0-96MC
nP8SeE67O95pe4o,1565437555,KapheKiivOazis,5814,5814,-11400,-11400,980,0,0,383298,False,72HH-A06H-4H09-6X2P
ND2H5blMRJNgJ5U,1565425085,Wayforpay,5499,5499,-27540,-27540,980,0,550,394698,False,07K4-B052-52BA-8A5X
uNzYiyEdw_hDlu8,1565373856,–°—ñ–ª—å–ø–æ,5411,5411,-15400,-15400,980,0,308,422238,False,7P4H-T4MK-B041-0824
qiwgNyLLhKywqy8,1565356362,LIQPAY*FOP Lemeshko Yu,7278,7278,-80285,-80285,980,0,0,437638,False,H2T6-A7A6-B0C7-637M
OB_L4P3fv71tYpY,1565355923,535129****7470,4829,4829,-5000,-5000,980,0,0,517923,True,89C0-2C72-AMP8-4H14
1N83cAavHJ3U-u4,1565342110,–í–∞–¥–∏–º –ê–Ω—ñ–∫—ñ–Ω,–ø–∏–≤–æ üê•,4829,4829,-6300,-6300,980,0,0,522923,True,0E0X-PTB5-CKHE-PHP9
d44LJRF5n4Vtfj4,1565329794,Lesya,4829,4829,-100000,-100000,980,0,0,529223,True,6A18-M9T8-EX0P-A8A3
Gs5RK9GFkriCB3pMrF-L,1565306708,–°–∫–∞—Å—É–≤–∞–Ω–Ω—è. Bolt,4121,4121,4000,4000,980,0,-800,629223,False
inP7KStczGrA1pQ,1565288159,–°—ñ–ª—å–ø–æ,5411,5411,-17200,-17200,980,0,344,625223,False,K7C1-7EHK-AX02-H26A
1acFbg8sHrd0xiM,1565267412,414962****4667,4829,4829,-150000,-150000,980,0,0,642423,True,PAH9-7E51-5XE5-H8CC
esNErrjfuP5ABMw,1565267389,–°–∫–∞—Å—É–≤–∞–Ω–Ω—è. 516749****3010,4829,4829,150000,150000,980,0,0,792423,False
KcbiZ3efIM_0UHA,1565267387,516749****3010,4829,4829,-150000,-150000,980,0,0,642423,False
qGt91w1j8-Xa1fU,1565264891,–°–∫–∞—Å—É–≤–∞–Ω–Ω—è. 414962****4667,4829,4829,150000,150000,980,0,0,792423,False
OurwAW3g-smf_uU,1565264891,414962****4667,4829,4829,-150000,-150000,980,0,0,642423,False
AfUC0bNsElRlYOY,1565263967,–°–∫–∞—Å—É–≤–∞–Ω–Ω—è. 516749****3010,4829,4829,150000,150000,980,0,0,792423,False
BzXvZ1jpKx5NHPA,1565263967,516749****3010,4829,4829,-150000,-150000,980,0,0,642423,False
CUcM-8BNGf969so,1565263921,–°–∫–∞—Å—É–≤–∞–Ω–Ω—è. 516749****3010,4829,4829,150000,150000,980,0,0,792423,False
-2dNYE_67lxSdNI,1565263916,516749****3010,4829,4829,-150000,-150000,980,0,0,642423,False
hdRRlXfqq5K98jc,1565207119,EASY Westgate,5812,5812,-89500,-89500,980,0,0,792423,False,K9C3-EE8B-5362-P4HA
ZHjxKqxgPVAAgVQ,1565179976,Bolt,4121,4121,-6700,-6700,980,0,1340,881923,False,B0KH-575C-CT3T-M6K1
xQgUAbbFI9TePLU,1565177341,Bolt,4121,4121,-4000,-4000,980,0,800,888623,False
2aHnA6rRQa3KFp0,1565176085,–í—ñ–¥: –ú–∞–∫—Å–∏–º –§–µ—â–µ–Ω–∫–æ,—Å–ø—Å,4829,4829,20000,20000,980,0,0,892623,True
E0doFjwCJKBuxpk,1565168196,Lesya,4829,4829,-100000,-100000,980,0,0,872623,True,B958-1E85-PE62-4T73
XmVMsjnSfZMRZ-4,1565118179,Bolt,4121,4121,-4800,-4800,980,0,960,972623,False,40ET-M3AX-955P-8E31
YgvzonkHHdyOwRs,1565096958,Bolt,4121,4121,-6800,-6800,980,0,1360,977423,False,CM13-P10P-BCKM-1M89
KqhF78UH1tHTK80,1565086897,Bolt,4121,4121,-4200,-4200,980,0,840,984223,False,KEX5-MT1T-029X-C409
_TlsjA-1deFzPMU,1565085816,–ú–∞–∫—Å–∏–º –ó–∞–±–æ–ª–æ—Ç–Ω—ã–π BCD,4829,4829,-3000,-3000,980,0,0,988423,True,XE0H-2HPH-CK61-XX74
l6xd3tQIfWyIbcE,1565082359,Bolt,4121,4121,-4700,-4700,980,0,940,991423,False,XCX2-87EB-M410-2AT3
KXDWHxqvpoWyJFk,1565079557,–û–∫—Å–∞–Ω–∞ –ì–∞–ª–∞–Ω,—à–∞–ª—Ñ–µ–π,4829,4829,-35000,-35000,980,0,0,996123,True,6K7T-P822-61M6-HCB1
HatNslp4MwEmAw8,1564991886,Lesya,—Ç–æ—Ñ—É –Ω–∞–ø–æ–ª–Ω–∏—Ç–µ–ª—å,4829,4829,-300000,-300000,980,0,0,1031123,True,EE63-CTMM-A10X-2TCP
3vyuI_eQeB0CJKw,1564932299,Mamamia!,5812,5812,-35802,-35802,980,0,0,1331123,False,T152-5P6T-93M4-CPAM
7CsbQRAan8Qr20M,1564911559,–í–µ–ª–∏–∫–∞ –ö–∏—à–µ–Ω—è,5411,5411,-10075,-10075,980,0,201,1366925,False,9HC9-3CPB-A46B-T803
xFPunDJ8JNBVOSU,1564859482,–°—ñ–ª—å–ø–æ,5411,5411,-12900,-12900,980,0,258,1377000,False,B84M-7T0E-KHTT-B650
zK-9nVrmr7mHyqM,1564858349,Bolt,4121,4121,-8200,-8200,980,0,1640,1389900,False,3B1T-5EMM-97TC-0BT1
yRs5wydRO_cRaKc,1564847565,Bolt,4121,4121,-9300,-9300,980,0,1860,1398100,False,4EE1-ET2H-00T1-3AA7
JfztvZtBqalzIBU,1564845376,Right Coffee Bar,5814,5814,-9400,-9400,980,0,0,1407400,False,6C6K-KHME-9E32-44CB
eZE1sWX3CDBQoZg,1564840240,Wayforpay,4121,4121,-10500,-10500,980,0,2100,1416800,False,00XT-0MT9-H4X2-EEH8
L1s0aUbZT97irfY,1564836121,Wayforpay,4121,4121,-10000,-10000,980,0,2000,1427300,False,P95H-54XP-4PA8-AHMP
HR4sOXbksNGhID0,1564828963,"–ü–∏—Ä—ñ–∂–∫–æ–≤–∞ ""–¢—ñ—Ç–∫–∞ –ö–ª–∞—Ä–∞""",5814,5814,-13600,-13600,980,0,0,1437300,False,XE15-TK4B-170X-PT9H
ip5SY_jmCP_WFsI,1564826898,–ë–∞–Ω–∫–æ–º–∞—Ç ATM6305 PIVDENNYI,6011,6011,-60300,-60300,980,300,0,1450900,False,85X0-T9C4-0440-9415
D6hhl9ml_USRQgg,1564825366,Wayforpay,4121,4121,-8200,-8200,980,0,1640,1511200,False,MP3C-CMCA-6B1P-9019
6Pe53lkaPMMTknM,1564755871,–°—ñ–ª—å–ø–æ,5411,5411,-30537,-30537,980,0,610,1519400,False,2P95-6EK0-T25C-EH13
zge60YdKIb2gYic,1564738738,–°–∫–∞—Å—É–≤–∞–Ω–Ω—è. Taxi,4121,4121,7900,7900,980,0,-1580,1549937,False
LGr2U9q8h3PAm6o,1564735667,–ë–∞–Ω–∫–æ–º–∞—Ç ATM6305 PIVDENNYI,6011,6011,-100500,-100500,980,500,0,1542037,False,29KH-H0EX-P2A2-PMXX
FLaFuELEfiQlXYg,1564735268,Taxi,4121,4121,-7900,-7900,980,0,1580,1642537,False
UecY7Acgriu9ueE,1564668418,LIQPAY*Foundation Coff,5411,5411,-57700,-57700,980,0,1154,1650437,False,5PA0-1HAH-0A48-HB12
LqZzmSI_fWv2P5g,1564656021,Lesya,4829,4829,-1600000,-1600000,980,0,0,1708137,True,MHB4-9XM0-2B8A-8H44
cfHN0VOFq5lw5PQ,1564655998,–ú–∞–∫—Å–∏–º –§–µ—â–µ–Ω–∫–æ BCD,–ø–∏–≤–æ –∏ –≥–Ω–∏–ª–∞—è –∫–∞—Ä—Ç–æ—Ö–∞ üòÑ,4829,4829,-30000,-30000,980,0,0,3308137,True,8P2C-PT68-48T3-041P
B8IDzfkzyUu0ncU,1564655852,–ù–∞ –¥–æ–ª–∞—Ä–æ–≤—É –∫–∞—Ä—Ç–∫—É,4829,4829,-68673,-2700,840,0,0,3938137,True
QnFxQp6ho-O1cfg,1564655810,–î–æ—Å—Ç—Ä–æ–∫–æ–≤–µ –ø–æ–≥–∞—à–µ–Ω–Ω—è COMFY,4829,4829,-274000,-274000,980,0,0,4006810,True
DNOLfxFIowPnSgU,1564655388,–íi–¥: –ü–†–ò–•–û–î–¨–ö–û –ï.–í. –§–û–ü,4829,4829,3300000,3300000,980,0,0,4280810,True
4eIpehZHrnY--_I,1564655355,–íi–¥: –ü–†–ò–•–û–î–¨–ö–û –ï.–í. –§–û–ü,4829,4829,900000,900000,980,0,0,980810,True
iZpqzoVaSdexn3k,1564648228,–í—ñ–¥—Å–æ—Ç–∫–∏ –∑–∞ –ª–∏–ø–µ–Ω—å,4829,4829,859,859,980,0,0,80810,True
xx_ZLjcFzzBISWI,1564645062,APTEKA   16,5912,5912,-1550,-1550,980,0,0,79951,False,7KK2-0P52-7T9A-1K0X
sR7UdW16jcnIyME,1564644095,–ê–ø—Ç–µ–∫–∞ –ù–∏–∑—å–∫–∏—Ö –¶—ñ–Ω,5912,5912,-5040,-5040,980,0,0,81501,False,1A2X-1ACB-5T75-58C8
CUzChZqVVv_NuQE,1564644027,–ê–ø—Ç–µ–∫–∞ –ù–∏–∑—å–∫–∏—Ö –¶—ñ–Ω,5912,5912,-3260,-3260,980,0,0,86541,False,KHK6-34P5-HH47-0902
sRGTmDyOWMv3_F0,1564643609,–°—ñ–ª—å–ø–æ,5411,5411,-21500,-21500,980,0,0,89801,False,5B4A-K6KC-C9PP-E13H
jfXkAFtjKAsqg78,1569777269,–°—ñ–ª—å–ø–æ,5411,5411,-5037,-5037,980,0,0,329758,False,TXPC-918C-06K0-6KA4
Q4RU3n-3OfIEzss,1569768062,–°—ñ–ª—å–ø–æ,5411,5411,-39732,-39732,980,0,0,334795,False,K1T0-9C16-A464-7HAP
T7syS7wK58e1lso,1569759329,KOLO,5499,5499,-19600,-19600,980,0,0,374527,False,T054-KKB3-65C3-4TAH
RgsiX6FPP-D2IFo,1569692416,Bolt,4121,4121,-8200,-8200,980,0,0,394127,False,ET21-P8CC-XA9K-7355
D17QCuYCsfYZ89I,1569690922,Glovo,4215,4215,-26500,-26500,980,0,0,402327,False,1B3X-CCC9-1AC6-567P
8e6TU8_veirCjVc,1569686264,–ê–¢–ë,5411,5411,-4400,-4400,980,0,0,428827,False,8EK9-HXXM-6E3M-6XHK
k6-2kiS7q0vYLQc,1569686123,Bolt,4121,4121,-9500,-9500,980,0,0,433227,False,M86P-9C2K-4M51-63TK
NIJtATOU_xpIX9s,1569681166,TOVFLAGMANSTORKAFE1,5814,5814,-89830,-89830,980,0,0,442727,False,31AM-96T0-775X-86C8
5oOu-z1OEHVYe-4,1569681127,TOV FLAGMAN STOR KAFE,5814,5814,-203700,-203700,980,0,0,532557,False,2K90-1CX9-5355-XP25
fvOWV1UCh7GV4ko,1569681119,–ü—Ä–∏–≤–∞—Ç24: Beloshitskiy Bogdan,6536,6536,100000,100000,980,0,0,736257,False
5rb5eS3GqY8k9bU,1569658749,–°—ñ–ª—å–ø–æ,5411,5411,-40399,-40399,980,0,0,36257,False,2MAA-4CET-T00H-BB55
AsgACu4PUBUWl7E,1569657982,–í–∏–≤–µ–¥–µ–Ω–Ω—è –∫–µ—à–±–µ–∫—É 500.00‚Ç¥,4829,4829,40250,40250,980,0,0,76656,True
H9K4sGHs4x1ykz4,1569630648,Bolt,4121,4121,-34700,-34700,980,0,0,36406,False,A099-BTP8-07C2-A3P5
ZFERIKXe9p9PnFU,1569613991,FLOCAFE ES,5812,5812,-8773,-330,978,0,0,71106,False,P5CB-K44X-M7KX-986M
QAzyfuP9MFYXDto,1569610937,DUTY FREE - ELL. DIANO,5999,5999,-8746,-329,978,0,0,79879,False,11C6-P900-53C0-400M
-Sq2Wl5zP8zMEqg,1569600534,DASKALAKI MARIA MIKE,5541,5541,-26584,-1000,978,0,0,88625,False,261P-H403-HKBM-1PKA
2GV1ZJOOyTPW_Uo,1569598509,ANDREAS PETRAS KAI SIA,5813,5813,-9305,-350,978,0,0,115209,False,K8BP-6XMB-H2TE-PMA9
n0_OaS2OLH5IvHI,1569566969,BYRON RENT A CAR,7512,7512,-133280,-5000,978,0,0,124514,False,8735-8PEH-BB23-18XT
yaIBIZaNp282vaI,1569523326,MAKRAKIS GEORGIOS,5812,5812,-207917,-7800,978,0,0,257794,False,MPT0-MKX4-ETCP-PP03
jid2AkZi-bYIVOk,1569511146,CHOULIARA ELEANA,5813,5813,-13328,-500,978,0,310,465711,False,5KE0-EXAC-9796-K7BP
tlRDOtAW-P4WW5E,1569500670,SIROCCO,5812,5812,-64508,-2420,978,0,1935,479039,False,7H1T-CPTT-9BB5-E4ME
mJtdbSp-yz1AVOk,1569490859,–í—ñ–¥: 516798****8598,4829,4829,500000,500000,980,0,0,543547,True
bYbtmg1a6JrkHw8,1569437821,Lesya,4829,4829,-40000,-40000,980,0,0,43547,True,ET3E-8X43-1430-B4XA
o3I5i_l45zYKu8E,1569435819,MAKRAKIS GEORGIOS,5812,5812,-129548,-4860,978,0,3886,83547,False,0C73-9P7X-THXB-B8X0
bDHanM1Scdedlvs,1569430142,CHEZ GEORGE,5812,5812,-9656,-398,840,0,289,213095,False,HCAB-KC67-9T8B-4E0K
C9yotTt2T8jK7xc,1569348996,MAKRAKIS GEORGIOS,5812,5812,-164934,-6171,978,0,4948,222751,False,BBH6-C4TH-217B-0MEX
VY0NznMU1AbSlmc,1569341755,CHEZ GEORGE,5812,5812,-18709,-700,978,0,561,387685,False,6M8A-A34C-227T-EAXK
H1DLLJChTnpeEZk,1569340029,–í—ñ–¥: 516798****8598,4829,4829,350000,350000,980,0,0,406394,True
xq27iN2C7T00TVw,1569249482,ANASTASIA CHATZIDAKI,5912,5912,-80613,-3000,978,0,0,56394,False,789M-AP9M-795P-2M7T
6886TX0yPKkLrn0,1569242223,MAKRAKIS GEORGIOS,5812,5812,-135967,-5060,978,0,4079,137007,False,0TB1-47H2-H2E3-7P07
Uez0bHcl7T9g-LU,1569234480,MILO,5411,5411,-10777,-400,978,0,0,272974,False,2885-HKXE-65PH-7BK4
BchmxoBJ6KDjBsk,1569227620,MELISSA,5411,5411,-29907,-1110,978,0,0,283751,False,683K-TA03-A271-8TA3
BOvv4rFP5PSUt6o,1569175977,Lesya,4829,4829,-200000,-200000,980,0,0,313658,True,0P0P-H46K-5061-9X51
ST7C16ya_HV8GZ8,1569173366,MAKRAKIS GEORGIOS,5812,5812,-156094,-5731,978,0,4682,513658,False,6769-X76T-67B9-BM13
TMEn1i2fxkSdCSM,1569150918,ISCREAM,5812,5812,-27237,-1000,978,0,817,669752,False,E856-MKTT-7X47-K3KE
u1lkO-HhBbdXJQw,1569145895,LIAPAKI,5441,5441,-11439,-420,978,0,0,696989,False,7B3P-H688-6992-X000
a5PMoE_37Qgn-0E,1569095736,MAKRAKIS GEORGIOS,5812,5812,-183549,-6739,978,0,5506,708428,False,M278-MPMH-MEB0-9B67
Sxyno-TWr8NysFU,1569090473,DIMOSTHENIS METHYMAK,5411,5411,-4194,-154,978,0,0,891977,False,A336-9T3C-EBE0-M56B
tLOBT9xCIBOsMOk,1569080990,DIMOS RETHYMNHS,7523,7523,-5720,-210,978,0,0,896171,False,TKK9-11PC-K666-5E87
ZvIGBlbDKZftV9E,1569069070,STAVROULAKI DESPOINA,7394,7394,-19066,-700,978,0,0,901891,False,0M2C-C2E4-KHKE-4893
otFY8lWh_Vew5F4,1569062242,ZAMPETAKI NEKTARIA,5812,5812,-6809,-250,978,0,204,920957,False
_xZCCrMbd01Nqa0,1569058331,Shell,5541,5541,-100776,-3700,978,0,0,927766,False,3EC7-29KB-5924-T9P1
xS-ye4mUFDs8rNo,1569056624,KAFENEIO TO PEFKO,5921,5921,-12257,-450,978,0,0,1028542,False,63E0-TEKH-TA89-03AM
5l9lLYdOBoWQl24,1569051148,BYRON RENT A CAR,7512,7512,-122566,-4500,978,0,0,1040799,False,E6EX-12M4-TE02-09HB
39DiWlthjweyVxo,1569006666,MAKRAKIS GEORGIOS,5812,5812,-141631,-5200,978,0,4248,1163365,False,E322-094H-MKT7-H368
LGiafdQxeFeNaEE,1568997257,ANTONIS PAGKALOS A.E,5411,5411,-3432,-126,978,0,0,1304996,False,0CC6-HATM-T93P-PH7H
0WUjjnB2VKHfHX0,1568965218,portmone.com.ua,4899,4899,-20000,-20000,980,0,0,1308428,False,A63T-5X02-66H3-K7H3
P2BX7b4ZM_JPM-w,1568917499,DIMOSTHENIS METHYMAK,5411,5411,-18212,-665,978,0,0,1328428,False,735K-167H-KH98-32KX
fJDeYdSfJe_KHG4,1568916366,MAKRAKIS GEORGIOS,5812,5812,-152431,-5566,978,0,4572,1346640,False,P3E9-0X09-EMTB-AE4P
yDSMB6sVYQFrw2k,1568883629,S  M PLAKOGIANNAKIS,5912,5912,-48199,-1760,978,0,0,1499071,False,5861-HH64-6B5M-45H3
4EkAohFdvXAcKy0,1568820992,SIGARNIY DIM FORTUNA,5993,5993,-45000,-45000,980,0,0,1547270,False,9159-C274-MX7A-5AA6
rl-ohChM-5hz3i4,1568818616,iPay.ua,6536,6536,19000,19000,980,0,0,1592270,False
ysTgNLl4cabm8BI,1568808540,Bolt,4121,4121,-7300,-7300,980,0,0,1573270,False,TE85-M727-MT36-P58B
CLI_K7Qg3x4LoDQ,1568800518,Bolt,4121,4121,-6200,-6200,980,0,0,1580570,False,12C2-715E-MP0E-HC43
abY6LfgpdxmYhbM,1568794725,Lesya,4829,4829,-500000,-500000,980,0,0,1586770,True,HE09-9064-K4K8-XHC4
jU5o_acCD4KtlfE,1568792891,Honey. Cafe-confectionery,5812,5812,-16400,-16400,980,0,492,2086770,False,0468-ATA0-6892-6563
sqA6NvD6adPu3-Q,1568792382,Biokon 28,5912,5912,-21930,-21930,980,0,0,2103170,False,TP7A-KT02-H374-53B6
qcAZQKb2ZmpetMI,1568733567,–í—ñ–¥: –ú–∞–∫—Å–∏–º –§.,–±—É—Ä–≥–µ—Ä,4829,4829,18000,18000,980,0,0,2125100,True
3vJHAgFtWpTVH-4,1568724186,–í—ñ–¥: –î–µ–Ω–∏—Å –ö.,4829,4829,19000,19000,980,0,0,2107100,True
4RBfDC3VwjnZtTg,1568718619,Glovo,4215,4215,-93500,-93500,980,0,0,2088100,False,XKE6-BA22-A181-T2MB
B_SGnH2ajecy58A,1568715742,–Ü—Ä–∏–Ω–∞ –¢.,–õ–µ—Å—è,4829,4829,-350000,-350000,980,0,0,2181600,True,CXT2-XX21-BMP7-47M3
xt-SCRpFspQl4Sg,1568712825,Lesya,4829,4829,-500000,-500000,980,0,0,2531600,True,0K8B-HTK2-TBAT-043X
dfwm-WzF_GMmVs4,1568712803,–ù–∞ –¥–æ–ª–∞—Ä–æ–≤—É –∫–∞—Ä—Ç–∫—É,4829,4829,-87243,-3500,840,0,0,3031600,True
5tncNg6L3BsU4X0,1568712625,–íi–¥: –ü–†–ò–•–û–î–¨–ö–û –ï.–í. –§–û–ü,4829,4829,3100000,3100000,980,0,0,3118843,True
kUSz9_W6QwiYgjg,1568711117,Bolt,4121,4121,-6700,-6700,980,0,0,18843,False,EBME-KP6X-X7TK-BAM6
KKefkiVT8tNnkB4,1568709342,–ú—ñ—Å—å–∫–µ –∫–∞—Ñ–µ ¬´–•–∞—Ä–º—Å¬ª (–ö–Ω–∏–∂–∫–æ–≤–∞ –∫—Ä–∞–º–Ω–∏—Ü—è ¬´–•–∞—Ä–º—Å¬ª),5814,5814,-3760,-3760,980,0,112,25543,False,H2AB-6T80-P0EA-P9AK
mdC8ivimjm9b3Yg,1568647136,–î–µ–Ω–∏—Å –ö–æ—Ç–æ–≤,4829,4829,-5000,-5000,980,0,0,29303,True,C42P-PX3E-K884-629B
tdBznz_njexkCSg,1568622821,SIGARNIY DIM FORTUNA,5993,5993,-22500,-22500,980,0,0,34303,False,384K-5X82-C5X5-BE62
RVVnkFZQWoyCBik,1568569283,Roshen,5441,5441,-8542,-8542,980,0,0,56803,False,K904-K2MA-03BM-6T17
f2dL8eXRYT3LA9Q,1568549951,–ê–¢–ë,5411,5411,-26170,-26170,980,0,0,65345,False,78B4-12HX-HH4H-3PT2
qGwLqto-8df3TZ4,1568547002,Right Coffee Bar,5814,5814,-11700,-11700,980,0,351,91515,False,87C4-BTEK-EA53-E9T7
HocydwztFIxuLrk,1568537770,Lesya,4829,4829,-200000,-200000,980,0,0,103215,True,BM0K-K46B-CM3M-H8HT
T9CkmGXWh5DqjTU,1568530931,Pirogiidruzja,5814,5814,-11500,-11500,980,0,345,303215,False,2C5C-B96C-KBC6-K18T
Qzy-g_aSViKg8-I,1568471773,RESTORAN BASSANO DOLCH,5812,5812,-77500,-77500,980,0,2325,314715,False,6C33-X6A5-TA7H-K5TX
CxABBt1YLGWFQDU,1568461009,–ú—É—Å–∞—Ñ–∏—Ä (–ú—É—Å–∞—Ñ—ñ—Ä),5812,5812,-5800,-5800,980,0,174,392215,False,MA4B-C0B2-T137-P9C2
uYMc0hxzilyS3oQ,1568460975,RestoranMusafir,5814,5814,-73200,-73200,980,0,2196,398015,False,E997-AKKK-0E6X-2XX1
_2BB_6Vah271U3I,1568446309,–°—ñ–ª—å–ø–æ,5411,5411,-3888,-3888,980,0,0,471215,False,B6EC-6424-HT1C-90CT
aLXHt9pnU-7BlgQ,1568370450,–í—ñ–¥: 516798****8598,4829,4829,450000,450000,980,0,0,475103,True
M3tbkBVZio-b37g,1568362341,Lesya,4829,4829,-150000,-150000,980,0,0,25103,True,BEM5-43A2-CK30-CPX2
UrungygsmCBtUeQ,1568362281,Lesya,4829,4829,-40000,-40000,980,0,0,175103,True,1AH0-CK55-9014-T8B2
u7psZDBVDoSsmJs,1568357698,Pirogiidruzja,5814,5814,-15500,-15500,980,0,465,215103,False,EC19-HPKX-5H8H-4K6M
YzztoMEDJvsHDd8,1568286784,KAFE KHLIBNYi,5812,5812,-4000,-4000,980,0,120,230603,False,XH6M-X716-PCA3-8967
ADFro0emdH6ng7M,1568284362,KAFE KHLIBNYi,5812,5812,-30000,-30000,980,0,900,234603,False,HX4K-6E2X-B3M1-3X95
BVaMX9ohplcW3Jk,1568233269,–û–ª–µ–∫—Å—ñ–π –í–∏–∫–∞–ª—é–∫,4829,4829,-4000,-4000,980,0,0,264603,True,5E3M-A9HX-HHEK-37AT
0yc306xEhsz5-Lw,1568232953,MOKRIVUSA,5814,5814,-38000,-38000,980,0,1140,268603,False,3M3A-6X56-9XH5-5025
tKZcpIyS3XP2AJU,1568189966,ProduktiJArVal19,5499,5499,-2300,-2300,980,0,0,306603,False,4C1T-X810-5PTX-93HA
SxdjNWl6eGWZnXk,1568118993,SIGARNIY DIM FORTUNA,5993,5993,-22500,-22500,980,0,0,308903,False,33HK-BT16-M1H4-P7C5
fM96q4kfW1zqjfI,1568118834,STEYKHAUS1,5814,5814,-13900,-13900,980,0,417,331403,False,19A7-X7MK-TKEP-AX2M
tVc7UOHnKo4Ttj0,1568110499,–ú—ñ—Å—å–∫–µ –∫–∞—Ñ–µ ¬´–•–∞—Ä–º—Å¬ª (–ö–Ω–∏–∂–∫–æ–≤–∞ –∫—Ä–∞–º–Ω–∏—Ü—è ¬´–•–∞—Ä–º—Å¬ª),5814,5814,-4700,-4700,980,0,141,345303,False,8AKM-X96C-BHBX-69A3
vFVKExL-ghisSUo,1568107938,–í—ñ–¥: 516798****8598,4829,4829,350000,350000,980,0,0,350003,True
VtGTYveqobjXhBI,1568107855,Lesya,4829,4829,-84200,-84200,980,0,0,3,True,17X5-2594-KX06-B31C
di5-q-EFMikqGqQ,1568098627,–ê–ø—Ç–µ–∫–∞ –ù–∏–∑—å–∫–∏—Ö –¶—ñ–Ω,5912,5912,-670,-670,980,0,0,84203,False,AB29-8H0M-320P-3H79
__5vq492BeUNYbY,1568055688,–Æ–ª—ñ—è –®.,–õ–µ—Å—è. –∫–æ–≤–µ—Ä.,4829,4829,-380000,-380000,980,0,0,84873,True,02PP-KPPC-95E6-5K11
BYiN6q1VPe6O4LA,1568024490,Lesya,4829,4829,-100000,-100000,980,0,0,464873,True,2EX6-35CX-XEA0-E19A
gcErubKyfDfSM7c,1568021950,–ú—ñ—Å—å–∫–µ –∫–∞—Ñ–µ ¬´–•–∞—Ä–º—Å¬ª (–ö–Ω–∏–∂–∫–æ–≤–∞ –∫—Ä–∞–º–Ω–∏—Ü—è ¬´–•–∞—Ä–º—Å¬ª),5814,5814,-7900,-7900,980,0,237,564873,False,K7CT-E5CE-0TTP-TB84
Hl__T9-2ImgxK2k,1568014889,–ú—ñ—Å—å–∫–µ –∫–∞—Ñ–µ ¬´–•–∞—Ä–º—Å¬ª (–ö–Ω–∏–∂–∫–æ–≤–∞ –∫—Ä–∞–º–Ω–∏—Ü—è ¬´–•–∞—Ä–º—Å¬ª),5814,5814,-75300,-75300,980,0,2259,572773,False,6XHC-M33E-EAT7-P37C
jHrexgstQfS7-uQ,1567957954,Glovo,4215,4215,-19700,-19700,980,0,0,648073,False,E8HA-T2KP-1755-A014
zGhNB9VKdjfIulg,1567937842,Lesya,4829,4829,-100000,-100000,980,0,0,667773,True,EC46-P2B5-90B3-BB49
75H6ON3ZV2cpqRU,1567870629,KAFE KHLIBNYi,5812,5812,-16900,-16900,980,0,507,767773,False,57CA-K61E-E50T-3TPM
xdXXN7d-beC-QvQ,1567858372,Uklon,4121,4121,-10700,-10700,980,0,0,784673,False,8HP9-A6TC-0X46-MBHB
WobfcDGrcEGLoxY,1567858356,–ê–Ω–∞—Å—Ç–∞—Å—ñ—è –•.,—à–∞–ª—Ñ–µ–π —Å–∞—á–µ–Ω–∫–æ,4829,4829,-35000,-35000,980,0,0,795373,True,604K-59A5-2828-6C12
t8DSFB4LARNrgSQ,1567855261,Uklon,4121,4121,-10100,-10100,980,0,0,830373,False,A0H2-KX15-T6X7-8B3B
KuAqy1irkMLEaic,1567844159,Lesya,4829,4829,-100000,-100000,980,0,0,840473,True,CC74-C1EC-6MCH-KPKM
VjmZgbtMDH3mx_s,1567772808,–ü–∏—Ä–æ–≥–∏ —Ç–∞ –¥—Ä—É–∑—ñ,5814,5814,-41500,-41500,980,0,1245,940473,False,EAT5-E896-4H8A-A619
F7Jcyhpbyn-0axI,1567764993,–ú—ñ—Å—å–∫–µ –∫–∞—Ñ–µ ¬´–•–∞—Ä–º—Å¬ª (–ö–Ω–∏–∂–∫–æ–≤–∞ –∫—Ä–∞–º–Ω–∏—Ü—è ¬´–•–∞—Ä–º—Å¬ª),5814,5814,-3760,-3760,980,0,112,981973,False,07T9-BK55-P59P-168K
3U-RgUOrMDq3GKY,1567746973,Uklon,4121,4121,-2100,-2100,980,0,0,985733,False,3E46-CM5H-C329-2A49
70qHjnTjAnx7FGw,1567690723,Uklon,4121,4121,-8500,-8500,980,0,0,987833,False,3563-0CCC-A8E2-T0M1
78s2dOZ7_OjRzrQ,1567674267,SIGARNIY DIM FORTUNA,5993,5993,-22500,-22500,980,0,0,996333,False,CT89-1H37-TE33-3XH8
knYubUvwXNTlaf0,1567673698,ProduktiJArVal19,5499,5499,-8550,-8550,980,0,0,1018833,False,T4K0-9E87-6KT3-341K
wTY9PiJCIbeIaO4,1567589656,–ú—ñ—Å—å–∫–µ –∫–∞—Ñ–µ ¬´–•–∞—Ä–º—Å¬ª (–ö–Ω–∏–∂–∫–æ–≤–∞ –∫—Ä–∞–º–Ω–∏—Ü—è ¬´–•–∞—Ä–º—Å¬ª),5814,5814,-4700,-4700,980,0,141,1027383,False,P047-TP4E-51EE-7PKX
cVtA4gspteTahdc,1567586373,Bolt,4121,4121,-9800,-9800,980,0,0,1032083,False,8B1P-4KKA-BHPC-T62H
9mBFVzoh2omG6OE,1567585220,516798****0456,4829,4829,-138000,-138000,980,0,0,1041883,True,AMCT-CXB7-CEMA-KME4
DnVC-ZWQ7BTd4TU,1567533246,Bolt,4121,4121,-8100,-8100,980,0,0,1179883,False,9P54-97M3-XKT2-A3KH
vfMyEVZi7v3flmo,1567500243,–°—É–ø–µ—Ä–º–∞—Ä–∫–µ—Ç,5411,5411,-3600,-3600,980,0,0,1187983,False,HK2E-83X3-X875-HK52
6zofvEuSisu0AzY,1567428589,SIGARNIY DIM FORTUNA,5993,5993,-22500,-22500,980,0,0,1191583,False,K72B-ECPT-CKPT-P6BT
Z_xVoes-j81bUSI,1567423372,Lesya,4829,4829,-900000,-900000,980,0,0,1214083,True,E39X-HC79-2EC6-63EM
F43YS12JVxNuGWE,1567423333,–ù–∞ –¥–æ–ª–∞—Ä–æ–≤—É –∫–∞—Ä—Ç–∫—É,4829,4829,-83508,-3300,840,0,0,2114083,True
0Pz3-ZMA7nzjo9k,1567422834,–íi–¥: –ü–†–ò–•–û–î–¨–ö–û –ï.–í. –§–û–ü,4829,4829,2400000,2400000,980,0,0,2697591,True
ZeA8u7BYMmfA3QI,1567422144,–í—ñ–¥: –ú–∞–∫—Å–∏–º –ú.,4829,4829,14000,14000,980,0,0,297591,True
NnCT3BXYmP94O-E,1567422034,KAFE KHLIBNYi,5812,5812,-14000,-14000,980,0,140,283591,False,K3M8-7C1T-6K0E-HKET
Q8I-dAWJYkXySng,1567421949,KAFE KHLIBNYi,5812,5812,-14400,-14400,980,0,144,297591,False,2HK5-KA7C-0XKK-TX23
QIGBuWpVxtudO8M,1567331527,–í—ñ–¥—Å–æ—Ç–∫–∏ –∑–∞ —Å–µ—Ä–ø–µ–Ω—å,4829,4829,2950,2950,980,0,0,311991,True
4cAmJ9Rofb6gyGA,1567326087,–ü—Ä–æ–¥—É–∫—Ç–æ–≤—ã–π,5499,5499,-6400,-6400,980,0,0,309041,False,B96P-XA4H-X37C-0K59
7dgbDvEruJPyOnI,1572453909,–í–∏–≤–µ–¥–µ–Ω–Ω—è –∫–µ—à–±–µ–∫—É 500.00‚Ç¥,4829,4829,40250,40250,980,0,0,425080,True
oRw7qy42Dmti2DI,1572445091,–í—ñ–¥: –û–ª–µ—Å—è –°.,lol nope,4829,4829,100,100,980,0,0,384830,True
64PbpnD2mhpXif8,1572442310,–•–ª–µ–±–Ω—ã–π,5812,5812,-25800,-25800,980,0,0,384730,False,7CX5-CMPT-35B5-K1MB
y6RxCQBVIeBuSn0,1572423886,KOLO,5499,5499,-13500,-13500,980,0,0,410530,False,C8TM-7P87-25PC-X3EH
oxMqi9cE_eKzqmg,1572376623,516874****1107,4829,4829,-37628,-37628,980,1447,0,424030,True,T446-0THT-3AMB-0133
FwKyBQI1X708Q0M,1572368157,–ú—ñ—Å—å–∫–µ –∫–∞—Ñ–µ ¬´–•–∞—Ä–º—Å¬ª (–ö–Ω–∏–∂–∫–æ–≤–∞ –∫—Ä–∞–º–Ω–∏—Ü—è ¬´–•–∞—Ä–º—Å¬ª),5814,5814,-3760,-3760,980,0,0,461658,False,H573-80B8-75EA-9X7B
LfYHTnirkHXQQxM,1572357396,–•–ª–µ–±–Ω—ã–π,5812,5812,-14500,-14500,980,0,0,465418,False,M1ET-TP70-01P0-9262
1iMyjo6UNsmO5p0,1572354070,KHuju,5814,5814,-33900,-33900,980,0,0,479918,False,KH2B-9B7P-2A7H-7P6M
W_Kx1CwTN7UBRo8,1572352707,iPay.ua,6536,6536,25000,25000,980,0,0,513818,False
rRcqmMApe5sGuoM,1572344487,–ù–æ–≤–∞ –ø–æ—à—Ç–∞,4214,4214,-4100,-4100,980,0,0,488818,False,7603-P490-5PB4-0398
p95b4XQ4QumwuFw,1572341527,–ú—ñ—Å—å–∫–µ –∫–∞—Ñ–µ ¬´–•–∞—Ä–º—Å¬ª (–ö–Ω–∏–∂–∫–æ–≤–∞ –∫—Ä–∞–º–Ω–∏—Ü—è ¬´–•–∞—Ä–º—Å¬ª),5814,5814,-3760,-3760,980,0,0,492918,False,660M-T6PM-C487-93MT
nzaJWMBdJLbKoqI,1572333756,516874****7843,4829,4829,-156000,-156000,980,6000,0,496678,True,HB9B-7MMB-A09C-97CX
QcNN-cZbwdIjuds,1572284854,KOLO,5499,5499,-13600,-13600,980,0,0,652678,False,0256-XPE5-HPEX-XHMX
xgjBbd3tTaIKFno,1572278701,–ê–ª–µ–∫—Å–µ–π –í—ã–∫–∞–ª—é–∫ BCD,—Ö–æ—Ç–¥–æ–≥,4829,4829,-8320,-8320,980,320,0,666278,True,1631-8BKE-54P5-BKT7
qZa5fXO9EFMh7Wc,1572257264,Rozetka,5399,5399,-589100,-589100,980,0,0,674598,False,4E5T-P8T6-7B3T-MAH8
rGoJIXeCt5JCHjs,1572257088,emag.pl,5311,5311,-3257459,-497300,985,0,10990,1263698,False
uf3mDqz0EvvUGvQ,1572256743,–íi–¥: –ü–†–ò–•–û–î–¨–ö–û –ï.–í. –§–û–ü,4829,4829,3900000,3900000,980,0,0,4521157,True
6xlsHfGTHSLERyc,1572247455,KOLO,5499,5499,-4500,-4500,980,0,45,621157,False,5PEA-TH76-ME8M-HC69
WiHKKtj9AY2x8ow,1572204429,–°—ñ–ª—å–ø–æ,5411,5411,-11998,-11998,980,0,119,625657,False,BHP4-A939-1B2B-T36K
xu_2PacyUPTyGzM,1572184183,Right Coffee Bar,5814,5814,-11400,-11400,980,0,114,637655,False,XMME-B772-8T89-7PK5
UNW1bzv22juM8v8,1572163337,–°—ñ–ª—å–ø–æ,5411,5411,-26753,-26753,980,0,267,649055,False,KX0H-77XC-2K8M-4C94
5Vt2e6L835PSP9Q4tbp8ZClX,1572133891,–°–∫–∞—Å—É–≤–∞–Ω–Ω—è. Uklon,4121,4121,8800,8800,980,0,0,675808,False
xNHmwB3AagBwzOchpMk,1572133891,Uklon,4121,4121,-8500,-8500,980,0,0,667008,True
Bbekn-rqKLt3QRI,1572088004,–°—ñ–ª—å–ø–æ,5411,5411,-22797,-22797,980,0,227,675508,False,95MX-C61C-41K7-K09C
ZQ-V_wFPFB2gI98,1572026849,–¶–∏–ø–∞ Taphouse,5814,5814,-9600,-9600,980,0,254,698305,False,092P-18XT-5156-C055
iSHjhl_LSJ0qwQQ,1572008744,Lesya,4829,4829,-150000,-150000,980,0,0,7905,True,2PBX-B5MT-HH7A-750A
kfukkYPWaTv5fms,1572004661,–í—ñ–¥: –í–∞–¥–∏–º –ê.,4829,4829,25000,25000,980,0,0,157905,True
SelySKQn02aDpBc,1572003713,–°—Ç–µ–π–∫—Ö–∞—É—Å,5814,5814,-25500,-25500,980,0,765,132905,False,EBMX-46X0-E701-T4K5
mQuXrIrUZw5dBfM,1572000508,–í—ñ–¥: –ö–∏—Ä–∏–ª–æ –ö.,4829,4829,25000,25000,980,0,0,158405,True
iHpRMuGwN5auVXE,1571999015,–ú—ñ—Å—å–∫–µ –∫–∞—Ñ–µ ¬´–•–∞—Ä–º—Å¬ª (–ö–Ω–∏–∂–∫–æ–≤–∞ –∫—Ä–∞–º–Ω–∏—Ü—è ¬´–•–∞—Ä–º—Å¬ª),5814,5814,-3760,-3760,980,0,112,133405,False,KET5-K687-MX79-904M
ngHlgKEMgsC1NHg,1571996728,–§–∞—É–Ω–∞ –°–µ—Ä–≤—ñ—Å / Fauna Service (–§–∞—É–Ω–∞ –°–µ—Ä–≤—ñ—Å),742,742,-150000,-150000,980,0,0,137165,False,XKC8-1780-KEP5-8X3H
2WFw4riFn1ndr7U,1571996241,Uklon,4121,4121,-8800,-8800,980,0,0,287165,False
qKgP1bj1wtSDf3c,1571992080,Uklon,4121,4121,-10900,-10900,980,0,0,295965,False,PECH-9M54-33E2-58MC
JYlFIzY7kFrAGZ4,1571990150,APTEKA   16,5912,5912,-730,-730,980,0,0,306865,False,4345-K5E8-53T2-CA2M
f1z0w6HHz_GLXhE,1571946265,–¶–∏–ø–∞ Taphouse,5814,5814,-57200,-57200,980,0,1716,307595,False,XB04-6P24-B11X-5118
OkxNH3bdllFzpLk,1571946240,–¶–∏–ø–∞ Taphouse,5812,5812,-58340,-58340,980,0,1750,364795,False,41T3-2C6B-B7AP-242C
qogSmEHlKXyfDTI,1571917586,–î–µ–Ω–∏—Å –ö–æ—Ç–æ–≤,4829,4829,-16000,-16000,980,0,0,423135,True,E03A-0PHA-5BA6-7211
ehJ3slUe_KDm7Ko,1571903865,–ú—ñ—Å—å–∫–µ –∫–∞—Ñ–µ ¬´–•–∞—Ä–º—Å¬ª (–ö–Ω–∏–∂–∫–æ–≤–∞ –∫—Ä–∞–º–Ω–∏—Ü—è ¬´–•–∞—Ä–º—Å¬ª),5814,5814,-3760,-3760,980,0,112,439135,False,AX4A-KK88-X10E-K90T
odAdAASTvai0Q4M,1571903132,Lesya,4829,4829,-300000,-300000,980,0,0,442895,True,B50T-212T-25A4-755K
j93lYajHTQTLzWc,1571864302,Bolt,4121,4121,-12600,-12600,980,0,0,742895,False,0PXA-884K-91TP-K71M
M1CfDI2rmxGqilQ,1571836862,–ö–æ—Å—Ç—è–Ω—Ç–∏–Ω –ê.,4829,4829,-30000,-30000,980,0,0,755495,True,M4PM-34M9-96A3-3038
uH3lIoVRBymeLPU,1571824171,Bolt,4121,4121,-5300,-5300,980,0,0,785495,False,P3HC-A1C2-XKP3-61ET
dXruZRHB_JLoNFI,1571820684,Lesya,4829,4829,-100000,-100000,980,0,0,790795,True,8589-CCB8-HHKE-26B9
MEPJutPjGVT8MrE,1571769398,KOLO,5499,5499,-11300,-11300,980,0,226,890795,False,P03E-1EB1-B9KC-1AEX
bGWpG9mczDUFM90,1571759507,414962****4667,4829,4829,-250000,-250000,980,0,0,902095,True,E9T0-87PP-PTXK-5T4X
P6cTVKfx01hWFE8,1571750363,–ö–æ—Å—Ç—è–Ω—Ç–∏–Ω –ê.,–Ω–∞ –ø–æ–¥–∞—Ä–æ–∫ –Æ—Ä–µ,4829,4829,-30000,-30000,980,0,0,1152095,True,1C4E-M236-BK0M-P49H
_FzEMvP8G1elz3s,1571746576,–ú—ñ—Å—å–∫–µ –∫–∞—Ñ–µ ¬´–•–∞—Ä–º—Å¬ª (–ö–Ω–∏–∂–∫–æ–≤–∞ –∫—Ä–∞–º–Ω–∏—Ü—è ¬´–•–∞—Ä–º—Å¬ª),5814,5814,-28000,-28000,980,0,840,1182095,False,K940-AM51-M2T9-C85E
HiY5FG5ce0LEaS8,1571741959,Business COFFEE,5812,5812,-5500,-5500,980,0,165,1210095,False,6T6H-B44H-H87E-3XHB
Cay1CN3u-6GuS7k,1571739082,Bolt,4121,4121,-7500,-7500,980,0,0,1215595,False,53K6-8A86-3486-HTAH
MEmORjA1CMaIRFU,1571732499,–°–∏–≥–∞—Ä–Ω—ã–π –¥–æ–º ¬´–§–æ—Ä—Ç—É–Ω–∞¬ª,5993,5993,-45000,-45000,980,0,0,1223095,False,695A-7A37-CAMX-APHP
PxeJJR8Zd9blopY,1571674120,Lesya,4829,4829,-150000,-150000,980,0,0,1268095,True,CC1P-46E8-02T2-1M97
ZlfgCtsl10G4dGo,1571658766,–ú—ñ—Å—å–∫–µ –∫–∞—Ñ–µ ¬´–•–∞—Ä–º—Å¬ª (–ö–Ω–∏–∂–∫–æ–≤–∞ –∫—Ä–∞–º–Ω–∏—Ü—è ¬´–•–∞—Ä–º—Å¬ª),5814,5814,-3760,-3760,980,0,112,1418095,False,0XC3-3A98-K23P-6KAC
UDtBeV8_TlD6b0U,1571651375,–í—ñ–¥: –í–ª–∞–¥–∏—Å–ª–∞–≤ –ß.,—Å–ø–ª–∏—Ç–≤–∞–π–∑,4829,4829,10000,10000,980,0,0,1421855,True
L36bSdj168h8lUg,1571642696,portmone.com.ua,4816,4816,-20400,-20400,980,0,0,1411855,False,CB50-9494-5X49-5A97
l23wS9yj0HeQ7bQ,1571641612,–ú—ñ—Å—å–∫–µ –∫–∞—Ñ–µ ¬´–•–∞—Ä–º—Å¬ª (–ö–Ω–∏–∂–∫–æ–≤–∞ –∫—Ä–∞–º–Ω–∏—Ü—è ¬´–•–∞—Ä–º—Å¬ª),5814,5814,-3760,-3760,980,0,112,1432255,False,5PEX-E8X3-XXT3-KHC1
rx-ZyOLZ4CGKvvM,1571569098,EKOTOVARY,5411,5411,-9900,-9900,980,0,198,1436015,False,1CC1-TCX4-E3XX-5T8A
FGnlXJ2tqeInQmI,1571568891,KOLO,5499,5499,-2600,-2600,980,0,52,1445915,False,4B3P-04X3-K3KE-M33X
0-iBYhLfWlDgHVk,1571567723,"–ü–∏—Ä—ñ–∂–∫–æ–≤–∞ ""–¢—ñ—Ç–∫–∞ –ö–ª–∞—Ä–∞""",5814,5814,-17300,-17300,980,0,519,1448515,False,17EB-5EB5-199E-ME01
Vh9cVdHAyIDU4U0,1571487182,–°—ñ–ª—å–ø–æ,5411,5411,-18000,-18000,980,0,360,1465815,False,B5X3-EHA3-K9E0-P6T0
1O13MUw4-O4I3q4,1571487096,–°—ñ–ª—å–ø–æ,5411,5411,-29637,-29637,980,0,592,1483815,False,8KCP-KMB6-AB5M-0K2A
5oOu_z5NEHFbfO8,1571475424,–ê–¢–ë,5411,5411,-56460,-56460,980,0,1129,1513452,False,8KK2-3HKH-688X-C6B4
KXF-9hyLi7Ym9TI,1571425250,–ê–ª–µ–∫—Å–µ–π –í—ã–∫–∞–ª—é–∫ BCD,4829,4829,-20000,-20000,980,0,0,1569912,True,920P-4755-B7XT-32E3
10J8caJ0KIMtNXM,1571424795,Wine and health,5921,5921,-26300,-26300,980,0,526,1589912,False,409H-2HX3-22K1-T763
rmKrkYouVEhlk8I,1571385051,–ú—ñ—Å—å–∫–µ –∫–∞—Ñ–µ ¬´–•–∞—Ä–º—Å¬ª (–ö–Ω–∏–∂–∫–æ–≤–∞ –∫—Ä–∞–º–Ω–∏—Ü—è ¬´–•–∞—Ä–º—Å¬ª),5814,5814,-3760,-3760,980,0,112,1616212,False,0P49-4CAX-2TC4-KC07
Sp63JSaRiBiLp4s,1571384103,ProduktiJArVal19,5499,5499,-9700,-9700,980,0,194,1619972,False,6E2C-ABC0-3K1C-2M2X
mhY0iReL7fmB_To,1571341788,–°—É–ø–µ—Ä–º–∞—Ä–∫–µ—Ç,5411,5411,-4500,-4500,980,0,90,1629672,False,33A4-A8X5-842K-ECB6
meD_yEb2xw9jVWw,1571339915,ITALYANSKAYA REDAKTSIY,5812,5812,-162800,-162800,980,0,4884,1634172,False,7H92-0655-MTPB-27PK
Dit1XkQ5IZI-KGk,1571332802,Bolt,4121,4121,-9400,-9400,980,0,0,1796972,False,X45B-1ATM-20BH-05H4
8Nad0B1iIkiXjYY,1571310809,TOV MILARIUS,8999,8999,-25000,-25000,980,0,0,1806372,False,865E-34XM-48C8-77XM
cMq4A76lI0HZVFY,1571306211,–î–æ—Å—Ç–∞–≤–∫–∞ –ê—à–∞–Ω,5411,7278,-142300,-142300,980,0,2846,1831372,False,92A5-53K8-7TPM-XP78
x8uv-V0NiXz08KI,1571303618,–ú—ñ—Å—å–∫–µ –∫–∞—Ñ–µ ¬´–•–∞—Ä–º—Å¬ª (–ö–Ω–∏–∂–∫–æ–≤–∞ –∫—Ä–∞–º–Ω–∏—Ü—è ¬´–•–∞—Ä–º—Å¬ª),5814,5814,-37500,-37500,980,0,1125,1973672,False,1H97-458P-5P3H-0KKP
vyq-EuoBFMbd3s8,1571228503,–ú—ñ—Å—å–∫–µ –∫–∞—Ñ–µ ¬´–•–∞—Ä–º—Å¬ª (–ö–Ω–∏–∂–∫–æ–≤–∞ –∫—Ä–∞–º–Ω–∏—Ü—è ¬´–•–∞—Ä–º—Å¬ª),5814,5814,-7520,-7520,980,0,225,2011172,False,4HTM-T3XH-B9T5-M38T
3ZGX9B7NmiYuBlw,1571216490,Lesya,4829,4829,-500000,-500000,980,0,0,2018692,True,H89B-T5TC-8E6K-7KM5
YlJEMi1Iq9zSDE4,1571215244,iHerb,5977,5499,-205474,-205474,980,0,0,2518692,False,0K4P-7B47-1T9A-3M25
8mCJxJg0Hbfs27U,1571215138,–ù–∞ –¥–æ–ª–∞—Ä–æ–≤—É –∫–∞—Ä—Ç–∫—É,4829,4829,-107721,-4300,840,0,0,3224166,True
C87wTJYFyvP-UJE,1571214932,–íi–¥: –ü–†–ò–•–û–î–¨–ö–û –ï.–í. –§–û–ü,4829,4829,3000000,3000000,980,0,0,3331887,True
sa04mSYPweDWoaA,1571162194,KOLO,5499,5499,-9000,-9000,980,0,90,331887,False,H868-XBKE-84M1-H433
g6Nh1-OB26SdNmE,1571144940,–í—ñ–¥: –í–∞–¥–∏–º –ê.,4829,4829,23000,23000,980,0,0,340887,True
OdFX1ISvFbJGUT4,1571132125,Glovo,4215,4215,-23200,-23200,980,0,0,317887,False,C2KX-7098-82PE-AETX
198nIA-Yhsf3WUA,1571129523,–ú—ñ—Å—å–∫–µ –∫–∞—Ñ–µ ¬´–•–∞—Ä–º—Å¬ª (–ö–Ω–∏–∂–∫–æ–≤–∞ –∫—Ä–∞–º–Ω–∏—Ü—è ¬´–•–∞—Ä–º—Å¬ª),5814,5814,-7520,-7520,980,0,75,341087,False,BBKB-9EPC-71C5-973A
N51E4lfTnyeduSI,1571128943,–í—ñ–¥: –û–ª–µ–∫—Å—ñ–π –í.,4829,4829,5000,5000,980,0,0,348607,True
1JXbQdZHr92BYww,1571128414,–°–∏–≥–∞—Ä–Ω—ã–π –¥–æ–º ¬´–§–æ—Ä—Ç—É–Ω–∞¬ª,5993,5993,-27000,-27000,980,0,0,343607,False,0M4H-C6X7-3T3T-60KK
2QNnEoG-e75_m8o,1571079913,Glovo,4215,4215,-28200,-28200,980,0,0,370607,False,T3MH-63MX-5TB1-9XX7
n9MRNvOdnYoVm3o,1571079889,–°–∫–∞—Å—É–≤–∞–Ω–Ω—è. Glovo,4215,4215,100,100,980,0,0,398807,False
C8LYi0aZ1seCdSg,1571079866,Glovo,4215,4215,-100,-100,980,0,0,398707,False
4ys8SWVmdAhtAIc,1571062966,–ê–¢–ë,5411,5411,-1640,-1640,980,0,16,398807,False,T709-TA7P-5C13-K6AA
OlNmRrOMOw0Q4uw,1571055938,Right Coffee Bar,5814,5814,-8500,-8500,980,0,85,400447,False,CC86-XAM4-E367-A413
FsJM54Vnktxp2Ks,1571040063,Right Coffee Bar,5814,5814,-22800,-22800,980,0,228,408947,False,7X4P-E8CK-4APM-B9TA
8oCkxcTlSlrlfl8,1571037180,KOLO,5499,5499,-13500,-13500,980,0,135,431747,False,1C55-5CCE-93MH-61E5
gAbYjGYUklYcFWs,1570986968,–ï–ø—ñ—Ü–µ–Ω—Ç—Ä,5211,5211,-144569,-144569,980,0,0,445247,False,2341-32PE-9K2P-622K
NyKnpHRVelp1k1k,1570964993,Novus,5411,5411,-28913,-28913,980,0,578,89816,False,ETMX-K5MB-8A8H-HP03
OQlzZFxdIxMfa1I,1570881298,LIQPAY*BagatoLososya,5411,5411,-50500,-50500,980,0,1010,118729,False,0HAE-01EA-XT03-2MTC
wNezzQSPhvs2ZUs,1570877920,KOLO,5499,5499,-35650,-35650,980,0,713,169229,False,E44P-3CX8-218M-K129
NTK-Yoji9tWboeU,1570866040,Right Coffee Bar,5814,5814,-28400,-28400,980,0,852,204879,False,AA71-3E4H-HTP5-5246
SX8WZGSsBTvhqts,1570839425,MOKRIVUSA,5814,5814,-14700,-14700,980,0,441,233279,False,29T1-H3H4-6BCC-2P8A
oCQrxJVPRrX-jc0,1570818856,–í—ñ–¥: –î–µ–Ω–∏—Å –ö.,4829,4829,18000,18000,980,0,0,247979,True
63PePhlb5o49cbs,1570818798,–î–µ–Ω–∏—Å –ö.,–∫–µ–¥—ã,4829,4829,-33000,-33000,980,0,0,229979,True,K4EK-94MT-P34M-MH7A
frjWFdE8Dy_Lw_4,1570797778,Lesya,4829,4829,-50000,-50000,980,0,0,262979,True,8AH3-375T-0B7T-7CX6
ja95SyyYOOqSd20,1570797036,Uklon,4121,4121,-10000,-10000,980,0,0,312979,False,EHMA-PC66-KCMT-E0T8
W3RIKahVqJ6AEVU,1570779778,Lesya,4829,4829,-50000,-50000,980,0,0,322979,True,7H6H-KBM3-TCEA-09KM
tYakr2QxvNzQ1xc,1570736875,KOLO,5499,5499,-18850,-18850,980,0,377,372979,False,0TKK-X632-58T1-A99H
MgX8r_omciYZE3I,1570725297,–ü—Ä–∏–≤–∞—Ç24: Teryaev Georgiy,6536,6536,8500,8500,980,0,0,391829,False
q-95VeWsuwEGz9Q,1570699559,–°–∫–∞—Å—É–≤–∞–Ω–Ω—è. Uklon,4121,4121,7100,7100,980,0,0,383329,False
U--_sUIfmqYGlSU,1570699394,–ú—ñ—Å—å–∫–µ –∫–∞—Ñ–µ ¬´–•–∞—Ä–º—Å¬ª (–ö–Ω–∏–∂–∫–æ–≤–∞ –∫—Ä–∞–º–Ω–∏—Ü—è ¬´–•–∞—Ä–º—Å¬ª),5814,5814,-3760,-3760,980,0,112,376229,False,C0TH-6C6K-KCT7-M551
IPJRiK4dlid6I6c,1570696984,Uklon,4121,4121,-7100,-7100,980,0,0,379989,False
Ze0_jX84Lh7zvcM,1570696917,–§–∞—É–Ω–∞ –°–µ—Ä–≤—ñ—Å / Fauna Service (–§–∞—É–Ω–∞ –°–µ—Ä–≤—ñ—Å),742,742,-39500,-39500,980,0,0,387089,False,X534-P2AC-K7X2-EA0M
Qsu1vaaPMD4h9Xk,1570642563,Uklon,4121,4121,-8800,-8800,980,0,0,426589,False,4EH9-2MCB-EB1A-4P3K
i20Og1rEAOA901M,1570642491,–§–∞—É–Ω–∞ –°–µ—Ä–≤—ñ—Å / Fauna Service (–§–∞—É–Ω–∞ –°–µ—Ä–≤—ñ—Å),742,742,-113500,-113500,980,0,0,435389,False,BBP7-1AEK-A82B-51K2
N-bQRcR6f6qgN8s,1570637669,Uklon,4121,4121,-8900,-8900,980,0,0,548889,False,EHMC-E56E-C85X-19T1
qCWQ005h2QjNnHk,1570627236,Bolt,4121,4121,-8200,-8200,980,0,0,557789,False,A729-AKH9-B3K4-EM96
4roV1uc489U2T2E,1570557255,KOLO,5499,5499,-5650,-5650,980,0,113,565989,False,2MKM-1664-739T-36P4
Qhan3y5F6OLgVGM,1570556594,–°—ñ–ª—å–ø–æ,5411,5411,-6957,-6957,980,0,139,571639,False,A3HM-700M-508X-C8MK
22AlcPg_DDZPZmM,1570534910,–í—ñ–¥: –î–µ–Ω–∏—Å –ö.,üçîüçîüçî,4829,4829,4900,4900,980,0,0,578596,True
9lHZsONa38lTGBM,1570528232,Bolt,4121,4121,-5600,-5600,980,0,0,573696,False,EXAP-1XA2-7BC3-A41C
xdyYHyNF25woOkU,1570471915,KOLO,5499,5499,-18500,-18500,980,0,370,579296,False,AXB8-4EE9-P462-42X8
y0n0aYjShfzriJ4,1570457548,Glovo,4215,4215,-49500,-49500,980,0,0,597796,False,25B1-T582-0P8E-27E9
9tw7fbWiw2llJxk,1570437796,–ú—ñ—Å—å–∫–µ –∫–∞—Ñ–µ ¬´–•–∞—Ä–º—Å¬ª (–ö–Ω–∏–∂–∫–æ–≤–∞ –∫—Ä–∞–º–Ω–∏—Ü—è ¬´–•–∞—Ä–º—Å¬ª),5814,5814,-3760,-3760,980,0,112,647296,False,MK7X-98XE-3X57-AH23
chcH3j38nJHfz9Y,1570437265,–°–∏–≥–∞—Ä–Ω—ã–π –¥–æ–º ¬´–§–æ—Ä—Ç—É–Ω–∞¬ª,5993,5993,-27000,-27000,980,0,0,651056,False,T3TM-3BBK-56HK-XH2H
i_fODb6JlxULILY,1570436412,Cookietone,5812,5814,-35500,-35500,980,0,1065,678056,False,M3EE-39EH-A53P-8A9C
fqFmIHNjjj5wTbo,1570378582,Bolt,4121,4121,-8100,-8100,980,0,0,713556,False,HC8E-8XTB-5BB7-6E8T
9RpF3k7777I6504,1570373740,Uklon,4121,4121,-16500,-16500,980,0,0,721656,False,AC2C-0EH0-E1CX-H2EA
SQb5iske64Au5K0,1570369026,Bolt,4121,4121,-25800,-25800,980,0,0,738156,False,17T1-3T11-BHB6-61KB
O2TssoCVkDcWXIA,1570353016,Wayforpay,5995,5995,-95600,-95600,980,0,0,763956,False,ATK0-0T48-2EXH-KMA7
gBDg0lczrZudbC4,1570273569,Right Coffee Bar,5814,5814,-12400,-12400,980,0,372,859556,False,932X-9458-P655-M5T3
KFJOLHZF0NAva7s,1570260352,Wayforpay,5499,5499,-42650,-42650,980,0,853,871956,False,KTTE-X5EE-0502-EM09
Dh1uKVyMPBzFLGc,1570234392,–ö—É–ø–ø–µ—Ä –ü–∞–± / Copper Pub (–ö—É–ø–ø–µ—Ä –ü–∞–±),5814,5814,-32000,-32000,980,0,960,914606,False,AE9H-BA8A-901T-07H0
1HX2FhJ9oH68BCc,1570221733,Who&Why. Drinkery,5814,5814,-179700,-179700,980,0,5391,946606,False,XA7A-P8P5-XCAT-5417
-Pvb4NnG_VtdC8g,1570186590,LIQPAY*cipollino,5812,5812,-25550,-25550,980,0,766,1126306,False,TPX7-BX5C-9A8E-6B2K
nYqLAFd5OIAsn9Y,1570181948,Lesya,4829,4829,-200000,-200000,980,0,0,1151856,True,9K81-HBXE-EX1T-BE99
D0xk2IB0ts-t90s,1570172675,KOLO,5499,5499,-18650,-18650,980,0,373,1351856,False,6487-4PK9-4MK2-19M7
ScvjC4vZbmD7uVI,1570131387,Bolt,4121,4121,-11100,-11100,980,0,0,1370506,False,THXP-EXX3-4T14-8K0K
oBP3GSqfUdo3m84,1570130097,–ö—ñ–Ω–æ–º–∞—Ä–∫–µ—Ç –ü–ª–∞–Ω–µ—Ç–∞ –ö—ñ–Ω–æ,5411,5411,-8500,-8500,980,0,170,1381606,False,BKP8-TEAM-30BA-9AAX
enDbH_oI9WQ5W9I,1570121383,–ö—ñ–Ω–æ–º–∞—Ä–∫–µ—Ç –ü–ª–∞–Ω–µ—Ç–∞ –ö—ñ–Ω–æ,5411,5411,-10900,-10900,980,0,218,1390106,False,1TC7-KCC7-4355-XT3B
qF1h3KSrwOIStrE,1570118606,–ö–∏—ó–≤—Å—å–∫–µ –º–µ—Ç—Ä–æ,4111,4111,-800,-800,980,0,0,1401006,False,HK6M-2971-3266-209X
i6H-sv3Y7qzRybw,1570092802,–í—ñ–¥: –í–ª–∞–¥–∏—Å–ª–∞–≤ –ß.,–±–ª–µ–∫—Å–µ–¥ –∫–æ–º–∏–∫—Å,4829,4829,25000,25000,980,0,0,1401806,True
m997VCx-CdW7Dwg,1570085525,–ö–∞—à—Ç–∞–Ω,5814,5814,-8500,-8500,980,0,255,1376806,False,915M-7PCP-1EB1-APC4
wwLdEFBa6MDHiHM,1570084541,KOLO,5499,5499,-9000,-9000,980,0,180,1385306,False,5BBM-C094-B7E6-C9K8
V6XJIYXjNjJ_rzo,1570015076,Business COFFEE,5812,5812,-3000,-3000,980,0,90,1394306,False,A81P-E914-B0MX-13BH
zdN8hn6N2NVCexI,1569997144,METRO,5411,7278,-148269,-148269,980,0,2965,1397306,False,B9E0-8T30-HTM0-TB2X
ZeA9vbVaNGbK3wGb5AoIJlY9,1569977212,–°–∫–∞—Å—É–≤–∞–Ω–Ω—è. ZAMPETAKI NEKTARIA,5812,5812,6809,250,978,0,-204,1545575,False
UF22x5RVcQtqTrQ,1569956164,KOLO,5499,5499,-16100,-16100,980,0,322,1538766,False,KAKE-KB4E-B981-81BP
CGgX8zo6Cv2_0WY,1569932107,Lesya,4829,4829,-1000000,-1000000,980,0,0,1554866,True,P24P-TK8A-63C8-B3H4
VaupTAE7KdVM798,1569925455,Lesya,4829,4829,-500000,-500000,980,0,0,2554866,True,91PB-P770-HC15-KKMK
x6RRhXU-QYTLcK8,1569922419,–ù–∞ –¥–æ–ª–∞—Ä–æ–≤—É –∫–∞—Ä—Ç–∫—É,4829,4829,-91317,-3700,840,0,0,3654866,True
eLWIJEUl0_j2XmA,1569922367,–íi–¥: –ü–†–ò–•–û–î–¨–ö–û –ï.–í. –§–û–ü,4829,4829,3500000,3500000,980,0,0,3746183,True
e1P9DdScGci6JeQ,1569917873,Wayforpay,5995,5995,-63500,-63500,980,0,0,246183,False,HT9C-93C6-TMM0-HB42
RAmyp366Co6RqjE,1569892837,–í—ñ–¥—Å–æ—Ç–∫–∏ –∑–∞ –≤–µ—Ä–µ—Å–µ–Ω—å,4829,4829,2625,2625,980,0,0,309683,True
CvCqyXA1BxzvpmE,1575022183,Harms1,5814,5814,-3760,-3760,980,0,37,195924,False,TAHE-4E5A-TXCX-1KHT
_2U7FqLsjauWL8k,1575021681,Bolt,4121,4121,-7600,-7600,980,0,0,199684,False,5PE3-K05P-C1B7-6H45
O_G6u2V0J9vOHAo,1575018486,WFP.CONCERT,7922,7922,-254188,-254188,980,0,0,207284,False,837K-M73K-EEE8-T3P2
xCUgkv6LV_zy7X4,1574966820,–î–µ–Ω–∏—Å –ö–æ—Ç–æ–≤,4829,4829,-17680,-17680,980,680,0,461472,True,CP65-820K-HB20-445B
mA4AHDYfRkQ9W0o,1574964006,–°—É–ø–µ—Ä–º–∞—Ä–∫–µ—Ç,5499,5499,-23700,-23700,980,0,0,479152,False,51AE-TCHE-1ME9-24A9
Xe0OsoveKhH1Vak,1574935530,Bolt,4121,4121,-6300,-6300,980,0,0,502852,False,T91B-C8PC-8005-M41X
eEdRoqKdUSlC5vQ,1574884286,KOLO,5499,5499,-6800,-6800,980,0,0,509152,False,AXM2-PPM5-E857-MH75
NjjwM6QqttwGX0g,1574768374,Harms1,5814,5814,-3760,-3760,980,0,37,515952,False,31PT-9C5T-BXTM-X1B5
WfjVj5SvYRIC7iI,1574762075,–°–∏–≥–∞—Ä–Ω—ã–π –¥–æ–º ¬´–§–æ—Ä—Ç—É–Ω–∞¬ª,5993,5993,-22500,-22500,980,0,0,519712,False,K6PK-BP3K-B7E6-956E
UQIqicqI5Go5jWg,1574761610,–°–æ–∫—Ä–∞—Ç,5943,5943,-5970,-5970,980,0,0,542212,False,PT6H-H35M-2974-XA7T
tAMj-kagajkudvU,1574690020,Harms1,5814,5814,-3760,-3760,980,0,37,548182,False,PAA9-M0KP-X41X-6A64
yQxqFUuTX_tZU2E,1574687499,Business COFFEE,5812,5812,-4500,-4500,980,0,45,551942,False,1788-B4HK-AE72-8PEM
QgRqmNYcrpD5POs,1574671794,Kashtan,5814,5814,-4500,-4500,980,0,45,556442,False,P94B-HBK3-TE75-82T7
rgy65ISyDX-VhDE,1574619733,ANP,5541,5541,-70015,-70015,980,0,0,560942,False,91MM-HC74-7CAH-M07H
bY2Ac54DVceiz1s,1574610938,–ê–¢–ë,5499,5499,-127290,-127290,980,0,0,630957,False,95KX-HMXH-8K61-AE24
SogotH-E25V_s-c,1574604849,McDonalds,5814,5814,-38300,-38300,980,0,1149,758247,False,4966-MM66-E3BX-CX2A
m539oowrH_0U2UQ,1574602318,KOLO,5499,5499,-9000,-9000,980,0,0,796547,False,K5BP-32PA-H17P-TAE6
MfBPqY7DwTQOo-I,1574593043,CULT BEAUTY,5977,5977,-133919,-4287,826,0,0,805547,False,XC87-56KT-T1XA-MP9B
oFFVe1zlopCer8g,1574533387,414950****1143,4829,4829,-100000,-100000,980,0,0,939466,True,2T1A-9H25-03XT-1TP9
FVJyYknoC1jeGFE,1574531376,–°—ñ–ª—å–ø–æ,5411,5411,-43693,-43693,980,0,0,1039466,False,4CKH-5CM8-512E-7625
bHpqI0INLlct2ZE,1574496542,KOLO,5499,5499,-10900,-10900,980,0,0,1083159,False,XP2A-CB0E-KEAE-61K3
NFg1j_181vl2qFg,1574455113,–íi–¥: –û–ª–µ—Å—è –°.,4829,4829,500,500,980,0,0,1094059,True
iBCCMprBy5QfvYU,1574451204,Sam's Steak House Prime,5812,5812,-162300,-162300,980,0,4869,1093559,False,CH63-5K2A-A13A-88TT
HeEjCu956H7WzTg,1574412130,KOLO,5499,5499,-5500,-5500,980,0,0,1255859,False,1TM3-BXXX-X530-M51K
sVsDtaGVMiXtNRM,1574410750,AIRBNB,7011,7011,-325699,-13425,840,0,0,1261359,False,XMMK-7T0E-K06X-64M1
sLXY41ZkeHps_ag,1574360982,–ê–ø—Ç–µ–∫–∞ –ù–∏–∑—å–∫–∏—Ö –¶—ñ–Ω,5912,5912,-380,-380,980,0,0,1587058,False,TT1H-2XPH-K2HT-BT73
uABWLlgWZ3zMnyY,1574329986,Harms1,5814,5814,-9400,-9400,980,0,282,1587438,False,2863-3HEP-X3B6-ETMH
UyQtAlrPmLZ27KU,1574261435,Harms1,5814,5814,-7520,-7520,980,0,225,1596838,False,7HK2-4KX8-K61T-KXE5
t04SEqjnMV-HpwA,1574247159,portmone.com.ua,4816,4816,-20400,-20400,980,0,0,1604358,False,91C9-9E1H-ACHK-3H48
a9_G3se_06bcE7Q,1574190464,KOLO,5499,5499,-22000,-22000,980,0,0,1624758,False,E6XH-81EH-X02X-TXP9
1BncfaDu49neKuM,1574173963,414962****4667,4829,4829,-600000,-600000,980,0,0,1646758,True,BXP6-1HCX-545M-AETA
FzNA0VjsqFqIaos,1574158032,–°–æ–∫—Ä–∞—Ç,5943,5943,-9970,-9970,980,0,0,2246758,False,5082-B6K8-K57C-6KKX
bd-80f2X-3B90Ks,1574096388,–ê–ª–µ–∫—Å–µ–π –í—ã–∫–∞–ª—é–∫ BCD,4829,4829,-100000,-100000,980,0,0,2256728,True,H8M9-ATKX-248T-CK62
YkTxkYhaUlq-BlI,1574074484,–ù–∞ –¥–æ–ª–∞—Ä–æ–≤—É –∫–∞—Ä—Ç–∫—É,4829,4829,-46095,-1900,840,0,0,2356728,True
btP_SYba6EcQhUo,1574074470,Lesya,4829,4829,-1200000,-1200000,980,0,0,2402823,True,564E-9KT8-9BKC-6ECE
J_QIr9dwrv8zkiA,1574074423,–íi–¥: –ü–†–ò–•–û–î–¨–ö–û –ï.–í. –§–û–ü,4829,4829,3600000,3600000,980,0,0,3602823,True
v8ygIfMhNdkHt6g,1573912497,–ê–¢–ë,5411,5411,-3280,-3280,980,0,0,2823,False,542P-3K06-E7PP-BEA8
2cG1F1tdFpe2lkg,1573842316,Produktovayalavka,5499,5499,-7400,-7400,980,0,0,6103,False,P909-484B-MXH6-1XM0
Ddi9JHVxHKsw06A,1573837522,–î–µ–Ω–∏—Å –ö–æ—Ç–æ–≤,4829,4829,-6240,-6240,980,240,0,13503,True,9027-K18X-MEX0-ABCB
iUK4RynvLKHbI0Y,1573802881,Wayforpay,5995,5995,-40800,-40800,980,0,0,19743,False,HAB8-BEB1-EP56-BE62
onKHkMRp87nagpo,1573724656,–°–∏–≥–∞—Ä–Ω—ã–π –¥–æ–º ¬´–§–æ—Ä—Ç—É–Ω–∞¬ª,5993,5993,-45000,-45000,980,0,0,60543,False,K762-XE59-51AM-PBA4
jT3LYJlwOPxYjDA,1573723993,ProduktiJArVal19,5499,5499,-2300,-2300,980,0,0,105543,False,08EA-77CK-H7P1-TA1A
Nu4P2dlbkKvWQsM,1573664361,–ü—Ä–∏–≤–∞—Ç24: Teryaev Georgiy,6536,6536,13000,13000,980,0,0,107843,False
BI9oPy99gdpU1vY,1573652188,–í—ñ–¥: –ú–∞–∫—Å–∏–º –§.,üëΩ,4829,4829,11000,11000,980,0,0,94843,True
ho3LWbnBA2p79aI,1573652175,Glovo,4215,4215,-42100,-42100,980,0,0,83843,False,MB98-47T3-MB79-79AB
ZzQAyn4SRSg-smc,1573645531,–î–æ—Å—Ç–∞–≤–∫–∞ –ê—à–∞–Ω,5411,7278,-142560,-142560,980,0,0,125943,False,HT5K-2HAA-060M-8E8H
fkufg7Jwo3KyF3c,1573639605,–ú—ñ—Å—å–∫–µ –∫–∞—Ñ–µ ¬´–•–∞—Ä–º—Å¬ª (–ö–Ω–∏–∂–∫–æ–≤–∞ –∫—Ä–∞–º–Ω–∏—Ü—è ¬´–•–∞—Ä–º—Å¬ª),5814,5814,-3760,-3760,980,0,37,268503,False,09TH-1C2C-5P68-K872
NZWw8ykzarSLi6I,1573631173,–ê–ø—Ç–µ–∫–∞ –ù–∏–∑—å–∫–∏—Ö –¶—ñ–Ω,5912,5912,-12450,-12450,980,0,0,272263,False,3857-PBT3-C243-2424
vvOgzMAGNUEcQgY,1573495553,–°—ñ–ª—å–ø–æ,5411,5411,-13500,-13500,980,0,0,284713,False,PKH3-B14P-5613-PT19
psSnT8_RvwGGxeI,1573495503,–°—ñ–ª—å–ø–æ,5411,5411,-54097,-54097,980,0,0,298213,False,M800-K81M-HHP6-13TM
_MeSk59gudyHYD8,1573460488,KOLO,5499,5499,-9000,-9000,980,0,0,352310,False,TMCC-K1E5-3CE9-8E97
rt3f5iG8e4YaJNw,1573319826,BeerMarket,5921,5921,-10598,-10598,980,0,0,361310,False,7KTX-840B-75C1-0TH2
s9X8B5QLoTMOLeI,1573319018,Roshen,5441,5441,-8023,-8023,980,0,0,371908,False,P8X3-MBE8-960B-30KX
X3xN5vZNl5HeGM8,1573297620,EKO-LAVKA,5999,5999,-29800,-29800,980,0,0,379931,False,820A-K6B7-8593-704P
402dSGHhadT9tfg,1573231097,Bolt,4121,4121,-42000,-42000,980,0,0,409731,False,49BX-B7TX-6X0M-8X23
8r-OcefGQldczLA,1573227750,KOLO,5499,5499,-37850,-37850,980,0,0,451731,False,44T1-P36T-BPA8-1HEX
3yVTNwFanFrJJKk,1573226150,Glovo,4215,4215,-33500,-33500,980,0,0,489581,False,BE1P-82K2-8TK6-214T
AO56uYiJolatZoQ,1573204132,Bolt,4121,4121,-68276,-10663,985,0,0,523081,False,76AT-P65C-0M37-M94H
1II24m4TAjUKZ1c,1573201387,Bu≈Çkƒô przez Bibu≈Çkƒô,5812,5812,-32015,-5000,985,0,320,591357,False,060H-4710-458P-6967
BGOVJqA86qvBRy8,1573198495,ZABKA Z5046 K.2,5499,5499,-11584,-1810,985,0,0,623372,False,613K-MTX3-BBP8-K8MH
x2VDWmKB8xs_Rt8,1573135886,MIDI EGZOTIK Moliera,5499,5499,-6993,-1090,985,0,0,634956,False,E078-6250-6X04-E1B7
sPX2R-ZuKSUypcc,1573117807,ZABKA Z5046 K.2,5499,5499,-10259,-1599,985,0,0,641949,False,C5T9-X912-T416-2P7X
T3NkHuOMIijNqvA,1573117012,CITY SAM,5812,5812,-59668,-9300,985,0,834,652208,False,85XK-9KTM-M7KB-4C6M
Ba3zPQw4rQMS36M,1573073203,ZABKA Z5046 K.2,5499,5499,-9170,-1419,985,0,0,711876,False,TTBM-EKEK-41BH-P5EC
B47hz7gmzf5G6Gc,1573071517,Palladium,5813,5813,-3231,-500,985,0,96,721046,False,3HPT-C5B1-TAMT-EB9H
BpDSRJ-M5UtL_S8,1573067621,Hybrydy,5813,5813,-12925,-2000,985,0,387,724277,False,PP2M-66M0-758P-278T
6W6OB2gpr5p7PNY,1573059287,CAFE LOFT,5812,5812,-61392,-9500,985,0,1841,737202,False,EPB5-87K0-CA4C-E2A4
ntXCfgCREi1_qaI,1573043624,KOMPUTRONIK S.A.,5732,5732,-64623,-10000,985,0,0,798594,False,EX44-0CKH-CB80-56MC
Lo4_aDJIWRdAiYQ,1573043239,KOMPUTRONIK S.A.,5732,5732,-3230518,-499900,985,0,0,863217,False,7C6H-T550-5EH1-CE29
GetDl6cfcjWuqLw,1573041027,Lesya,4829,4829,-150000,-150000,980,0,0,4093735,True,B77A-7BC1-2MXB-P6T1
19AjZWb9GM4BdKA,1573040539,The Cold Pressed Juices,5812,5812,-7755,-1200,985,0,232,4243735,False,1X7E-T645-XMH0-XX8T
b9AxI2W44FwH3QA,1573040197,Bu≈Çkƒô przez Bibu≈Çkƒô,5812,5812,-23911,-3700,985,0,717,4251490,False,5HE6-71P6-AMXA-157T
KcyvM_EZj_GV3Zk,1573038040,–°–∫–∞—Å—É–≤–∞–Ω–Ω—è. Bolt,4121,4121,70375,10890,985,0,0,4275401,False
l642JMnr_laofZE,1573037996,Bolt,4121,4121,-70426,-10898,985,0,0,4205026,False,10PH-1CE7-B568-PT4H
h19tTcueLaFwO9c,1573034452,Bolt,4121,4121,-70375,-10890,985,0,0,4275452,False
dDUl-JBvBjZLuPM,1573034418,"–ö–∏—ó–≤—Å—Ç–∞—Ä
+380978495150",4814,4814,-1500,-1500,980,0,0,4345827,True,P1A9-XMAP-4TE6-3T58
-nHlSYPaCAQ9HNM,1573015894,Uklon,4121,4121,-34500,-34500,980,0,0,4347327,False,73MH-X6HM-BC71-M1AP
Ydn8O991-HdNgEB0FIZEHQqg,1572920259,–°–∫–∞—Å—É–≤–∞–Ω–Ω—è. Alitalia,3013,3013,930416,33508,978,0,0,4381827,False
hTnTdwrNcLUE_FmRXcw,1572920259,"0552347770003 WWW.ALIT, PIAZZA ALMERICO DA SCHIO, ROMA, IT",3013,3013,-465364,-16754,978,0,0,3451411,True
FE7CCI8DA6IyMqphPlk,1572920259,"0552347770002 WWW.ALIT, PIAZZA ALMERICO DA SCHIO, ROMA, IT",3013,3013,-465364,-16754,978,0,0,3916775,True
uJWwBiPqqwE-gx4,1572897601,–ù–∞ –¥–æ–ª–∞—Ä–æ–≤—É –∫–∞—Ä—Ç–∫—É,4829,4829,-96972,-3900,840,0,0,4382139,True
K8cu3khCWpJF7oo,1572897461,–í—ñ–¥: –û–ª–µ—Å—è –°.,4829,4829,700000,700000,980,0,0,4479111,True
RMQqe7YPzdJP1M8,1572897439,–û–ª–µ—Å—è –°–∞—á–µ–Ω–∫–æ,4829,4829,-300000,-300000,980,0,0,3779111,True,PMTM-PE80-34CB-85A9
BlG2OBqmCydHC00,1572897394,–û–ª–µ—Å—è –°–∞—á–µ–Ω–∫–æ,4829,4829,-600000,-600000,980,0,0,4079111,True,3908-PAP9-A7TX-K64M
3sngxO1lW-hEpZU,1572891405,–ê–ø—Ç–µ–∫–∞ –ù–∏–∑—å–∫–∏—Ö –¶—ñ–Ω,5912,5912,-14150,-14150,980,0,0,4679111,False,4E28-36A5-8708-68KX
bfl41-HMolhPqIk,1572863943,–íi–¥: –ü–†–ò–•–û–î–¨–ö–û –ï.–í. –§–û–ü,4829,4829,3700000,3700000,980,0,0,4693261,True
NfMidhQn1SmumZQ,1572855999,–û–ª–µ—Å—è –°–∞—á–µ–Ω–∫–æ,4829,4829,-200000,-200000,980,0,0,993261,True,KX5C-KK86-04C2-9K79
OZJfNmr1ITnkIhY,1572855976,–í—ñ–¥: –û–ª–µ—Å—è –°.,4829,4829,200000,200000,980,0,0,1193261,True
caChws8plua8zvA,1572855929,–í—ñ–¥: –û–ª–µ—Å—è –°.,4829,4829,500,500,980,0,0,993261,True
hkOGZYWN-ttqybs,1572855911,–í—ñ–¥: –û–ª–µ—Å—è –°.,4829,4829,8,8,980,0,0,992761,True
EqFNQpnal1h2zUc,1572855906,–û–ª–µ—Å—è –°–∞—á–µ–Ω–∫–æ,4829,4829,-200500,-200500,980,0,0,992753,True,B6C1-B6AE-3E9E-3800
plp2xoeO_KVdJKI,1572809170,KOLO,5499,5499,-18200,-18200,980,0,0,1193253,False,9C42-C82T-6ET3-43H6
B2WS6JReRsjxAek,1572792278,AIRBNB,7011,7011,-334638,-13425,840,0,0,1211453,False,2B68-A975-XK0H-5KBE
mvyQUTWHnv0_7pg,1572784851,portmone.com.ua,6300,6300,-9920,-9920,980,0,0,1546091,False,1B0X-9C79-PAK9-H5PH
BPGCcxaCJeNaaL4,1572784331,Alitalia,3013,3013,-930416,-33508,978,0,0,1556011,False
Ju3-1nlPlDdUTc4,1572718669,Bolt,4121,4121,-5500,-5500,980,0,0,2486427,False,88HC-3M94-E7X5-6754
xEhQbgNbxhYWLLA,1572716946,Bolt,4121,4121,-10900,-10900,980,0,0,2491927,False,0CXE-C0PH-X186-M5E2
TCHARpEbgew8LUQ,1572714358,–ù–∞ –¥–æ–ª–∞—Ä–æ–≤—É –∫–∞—Ä—Ç–∫—É,4829,4829,-42375,-1700,840,0,0,2502827,True
7Q9-ebwkI7-qYk8,1572713946,–ü–£–ú–ë Online,6536,6536,53400,53400,980,0,0,2545202,False
xhI96tmumzSFsmU,1572712417,Persha Socialyna Aptek,5912,5912,-28552,-28552,980,0,0,2491802,False,E91K-3KH8-CAK7-1PH5
BXndgK0lbCljH58,1572712176,–ê–¢–ë,5411,5411,-69260,-69260,980,0,0,2520354,False,HA3X-PP41-A313-96M1
OZHIAr4LQsT3TU8,1572711680,Bolt,4121,4121,-10700,-10700,980,0,0,2589614,False,6999-HH5K-E60A-A12M
8XxOhDW44Pp3EwQ,1572707146,Gogi,5812,5812,-4900,-4900,980,0,147,2600314,False,2M3X-7BTE-M9C2-XB49
-O3JPwyUeAndHJ8,1572707120,Gogi,5812,5812,-113900,-113900,980,0,3417,2605214,False,9A2K-X0E5-910C-A8AT
ysGPgBY-0C6TBY8,1572686717,Bolt,4121,4121,-6800,-6800,980,0,0,2719114,False,M12C-P6PC-P0H0-A102
bamVtS7uSWH0_AE,1572685419,Bolt,4121,4121,-6200,-6200,980,0,0,2725914,False,189A-1CAB-TX8X-6TX7
6zFDVofXp7kk4cY,1572679636,Lesya,4829,4829,-150000,-150000,980,0,0,2732114,True,5TPP-P7AT-8T5K-2PXA
RXAHyh_XP_9ZtMI,1572679593,–î–æ—Å—Ç–∞–≤–∫–∞ –ê—à–∞–Ω,5411,7278,-200290,-200290,980,0,0,2882114,False,893C-8M3K-5571-MM03
7qeQ5vYuUGPMRZg,1572612105,–•–ª–µ–±–Ω—ã–π,5812,5812,-17700,-17700,980,0,531,3082404,False,C3MT-81T1-HH66-A4EK
-sVnhXfkMSy6Edc,1572603762,–°–∏–≥–∞—Ä–Ω—ã–π –¥–æ–º ¬´–§–æ—Ä—Ç—É–Ω–∞¬ª,5993,5993,-45000,-45000,980,0,0,3100104,False,19MP-19PC-9C96-C91A
LZkuG-vQzXUUyYw,1572599075,–ú—ñ—Å—å–∫–µ –∫–∞—Ñ–µ ¬´–•–∞—Ä–º—Å¬ª (–ö–Ω–∏–∂–∫–æ–≤–∞ –∫—Ä–∞–º–Ω–∏—Ü—è ¬´–•–∞—Ä–º—Å¬ª),5814,5814,-3760,-3760,980,0,0,3145104,False,9ACA-CTA5-4K13-9782
EIYtaqxNOKfih-U,1572596403,Lesya,4829,4829,-400000,-400000,980,0,0,3148864,True,E678-22TX-BM2K-PHB4
HsyG4dR3DV2h7no,1572579467,–í—ñ–¥—Å–æ—Ç–∫–∏ –∑–∞ –∂–æ–≤—Ç–µ–Ω—å,4829,4829,3722,3722,980,0,0,3548864,True
iics0u5HDZikfzx7XV5Y,1572573028,"–°–∫–∞—Å—É–≤–∞–Ω–Ω—è. emag.pl, emag.pl Warszawa, Warszawa, PL",5311,5311,3194926,497300,985,0,-10779,3545142,False
Lre2iYQ4o6iD9g4,1577731828,EKO-LAVKA,5999,5999,-4900,-4900,980,0,0,774483,False,P5C9-EX3H-MMT1-04K3
-Cs52exoBNu1f3I,1577731336,–°—ñ–ª—å–ø–æ,5411,5411,-5000,-5000,980,0,0,779383,False,7C1H-430A-A020-933A
Wa7gQyzemjQDXbs,1577731335,–°—ñ–ª—å–ø–æ,5411,5411,-97645,-97645,980,0,0,784383,False,HE66-X15C-3E8P-0K0H
Nvc6SqZxJdukbek,1577712646,–ü—Ä–∏–≤–∞—Ç24: Locman Danilo,6536,6536,9200,9200,980,0,0,882028,False
T9GIsOjX9zRPTOs,1577711905,iPay.ua,6536,6536,14000,14000,980,0,0,872828,False
m_Z_T05jRyPQo4o,1577706542,Glovo,4215,4215,-45200,-45200,980,0,0,858828,False,P873-CCT3-504H-59PH
pfBK8dgfQ4VEdS0,1577705279,Harms1,5814,5814,-3760,-3760,980,0,112,904028,False,1A53-B98E-P95T-PM6K
Cf254kTd763w99Y,1577697006,SHOP MAUGLI,5945,5945,-37900,-37900,980,0,0,907788,False,PBTX-6EP0-7E1E-7B9C
ArBdlJkSZNSY3F4,1577696234,Lesya,4829,4829,-200000,-200000,980,0,0,945688,True,990B-6K8H-8C0E-94EK
mN9j5UIJWQnbmno,1577696107,Bolt,4121,4121,-5000,-5000,980,0,1000,1145688,False,H2P7-C51B-P528-6A01
1IZKW4n_Xn_wipY,1577695014,482Store,5651,5651,-23000,-23000,980,0,0,1150688,False,X79X-M729-4A42-KA87
rHZDqBXCHSl_Z48,1577694853,Krem,5814,5814,-9800,-9800,980,0,294,1173688,False,KX7C-9E29-CT7C-C4E9
TZ2wayzOuYmWdg0,1577692267,Bolt,4121,4121,-5000,-5000,980,0,1000,1183488,False,E2B7-9848-6AKE-CTAX
kFWWW9EJYrz2Fxk,1577658566,Bolt,4121,4121,-7600,-7600,980,0,1520,1188488,False,A46B-1XH9-MC13-P2E8
T7K_q5BjJOJeArs,1577626739,FOP Mogoryan A.V.,5732,5732,-4500,-4500,980,0,0,1196088,False,HAKP-H3B2-CKP3-B094
v_DYcVckvx_rHUY,1577625330,Kakaobar,5814,5814,-20000,-20000,980,0,600,1200588,False,71XH-40H3-EE67-45X7
sOMIWMQTXk1peOU,1577617875,Dizyngoff1,5812,5812,-75000,-75000,980,0,2250,1220588,False,K9H2-2X74-92PX-7H4K
uugrqwffFRnUicw,1577613703,FRAPOLLI21,7011,7011,-26554,-26554,980,0,0,1295588,False,TKM4-C20E-5991-BM8E
VBZYr_5Us7ocq6E,1577564831,–î–≤–∞ –®–∞–≥–∞,5499,5499,-1050,-1050,980,0,0,1322142,False,MA7T-0571-426E-0B39
fymN1PFLSGPLh80,1577563860,–ì–æ—Ä–æ–¥—Å–∫–æ–π –†—ã–Ω–æ–∫ –ï–¥—ã,5812,5812,-22600,-22600,980,0,678,1323192,False,7M3X-MEA0-4A04-96EK
n73HZov6rk-DskA,1577562267,–ì–æ—Ä–æ–¥—Å–∫–æ–π –†—ã–Ω–æ–∫ –ï–¥—ã,5814,5814,-8000,-8000,980,0,240,1345792,False,P535-6MP5-43MH-C79M
rv8mZ9c6waxZm84,1577562135,CHeburekiPlov,5814,5814,-11500,-11500,980,0,345,1353792,False,T723-PMHK-X5B2-9H26
hMIRjqbBInMAOEQ,1577560614,Clar√©t,5814,5814,-61800,-61800,980,0,1854,1365292,False,K886-0E9T-0339-PE41
JvdqIZq5yNkdUSk,1577554657,Itis Flowers Cafe,5814,5814,-17800,-17800,980,0,534,1427092,False,8EA6-CBHM-1EK1-09T4
M1oPavzUhmunfiY,1577535290,–°—ñ–ª—å–ø–æ,5411,5411,-46064,-46064,980,0,0,1444892,False,A30X-E20A-0ETE-XTK8
UZbOG6PRtZp_tqA,1577533712,Bolt,4121,4121,-5000,-5000,980,0,1000,1490956,False,822A-M5BP-C121-B1MX
6NpTG6BvWYv5XpI,1577529763,Lou Lou,5814,5814,-39420,-39420,980,0,1182,1495956,False,797M-09TM-TBPT-H98K
1en5g5q1mpur6eBNtsZASy-Y,1577502378,–°–∫–∞—Å—É–≤–∞–Ω–Ω—è. –ú–æ—Ä–µ –ü–∏–≤–∞,5921,5411,45587,45587,980,0,0,1535376,False
biOg5M7Iy0ZrgPIZlNs,1577502378,–ú–æ—Ä–µ –ü–∏–≤–∞,5921,5411,-35970,-35970,980,0,0,1489789,True
uvfhL_cE4OzsguE,1577471275,Foundation Coffee Roasters,5812,5812,-8600,-8600,980,0,258,1525759,False,34P6-XBBB-A325-EXX3
QyXWGJHdKiYq0R0,1577458493,Dizyngoff1,5812,5812,-90000,-90000,980,0,2700,1534359,False,874X-X78B-T9BH-7004
ehvILgXauH6loYc,1577454703,Lesya,4829,4829,-60000,-60000,980,0,0,1624359,True,88P2-K83B-B8KA-8EAX
ECoXpd5JF-pzzno,1577426010,Bolt,4121,4121,-8000,-8000,980,0,1600,1684359,False,850H-52M7-79A8-X9H4
LmX1srpzzSkVCkM,1577375596,535128****0471,4829,4829,-9000,-9000,980,0,0,1692359,True,PMK1-8B4M-38KH-632B
S6BO_velkeHd37Y,1577371711,–°–∏–≥–∞—Ä–Ω—ã–π –¥–æ–º ¬´–§–æ—Ä—Ç—É–Ω–∞¬ª,5993,5993,-50000,-50000,980,0,0,1701359,False,P5CH-HAXA-B559-C50E
QVz9U4vUiN2Upf4,1577366767,Harms1,5814,5814,-7500,-7500,980,0,225,1751359,False,197E-K9P3-15T4-H0K0
CQ5xT6ZtIfcJgio,1577366733,Harms1,5814,5814,-7520,-7520,980,0,225,1758859,False,591T-4C61-951H-21K2
JaewuoL0UhFE-KU,1577363301,–ú–æ—Ä–µ –ü–∏–≤–∞,5921,5411,-45587,-45587,980,0,0,1766379,False
QIGCvm5Sxt-QOsU,1577360353,–ù–∞ –¥–æ–ª–∞—Ä–æ–≤—É –∫–∞—Ä—Ç–∫—É,4829,4829,-60578,-2600,840,0,0,1811966,True
QoQUyRU_kd8_2PQ,1577356688,–íi–¥: –ü–†–ò–•–û–î–¨–ö–û –ï.–í. –§–û–ü,4829,4829,1700000,1700000,980,0,0,1972544,True
SeR0J_YlsPlXt9w,1577355644,TOV YAROSLAVNA,5814,5814,-6000,-6000,980,0,180,272544,False,276A-16A6-6T7M-H0KK
-7dS9DMQC61Y1Vg,1577354746,Lesya,4829,4829,-200000,-200000,980,0,0,278544,True,3CHK-P140-6557-B5TA
Lwrtpuc6wyPvfDg,1577300624,–í—ñ–¥: –û–ª–µ—Å—è –°.,4829,4829,100,100,980,0,0,478544,True
3blvm_icyBRVgKA,1577300618,–í—ñ–¥: –û–ª–µ—Å—è –°.,4829,4829,100,100,980,0,0,478444,True
Otk-8E-MYKktaLU,1577300607,–í—ñ–¥: –û–ª–µ—Å—è –°.,4829,4829,100,100,980,0,0,478344,True
yJyJy5v7t_5i_Ps,1577300597,–í—ñ–¥: –û–ª–µ—Å—è –°.,4829,4829,100,100,980,0,0,478244,True
vgl7x1I-c68Exdk,1577276848,–ê–¢–ë,5411,5411,-15030,-15030,980,0,0,478144,False,KAMK-379P-0K0A-AXM6
hdVoWNkB-M3LYHo,1577268155,–û–∫—Å–∞–Ω–∞ –ì.,—à–∞–ª—Ñ–µ–π,4829,4829,-42000,-42000,980,0,0,493174,True,9PMK-449B-KAB6-TH6P
6YH7-yuVlnWST7U,1577265650,Bolt,4121,4121,-4500,-4500,980,0,900,535174,False,H246-25E1-KAAM-XX47
_6IxWOw7PMkFqFc,1577218739,Bolt,4121,4121,-7600,-7600,980,0,1520,539674,False,X6AP-2XCX-80BX-X69X
4J7SIJf9djdSSpk,1577187496,Hlibnijkaphe,5814,5814,-35500,-35500,980,0,1065,547274,False,HA4A-B1K3-HB77-CB16
HJfxemTAAqlTed8,1577181672,Bolt,4121,4121,-7700,-7700,980,0,1540,582774,False,BPP6-8627-0PHB-1P0E
WKsC5BGqPj1abi0,1577132796,BOLT.EU /O/1912232211,4121,4121,-7000,-7000,980,0,1400,590474,False,HT58-7PE4-B66A-PX0K
cHugYwSKWXj6ZlA,1577120595,BOLT.EU /O/1912231829,4121,4121,-8900,-8900,980,0,1780,597474,False,2PEX-AK56-BBXC-05X9
riB31HLkVo7faFk,1577105663,Business COFFEE,5812,5812,-3000,-3000,980,0,90,606374,False,B4C2-1E63-MAT0-7KTE
j0sb00mHlGncKIQ,1577104941,–ù–∞ –¥–æ–ª–∞—Ä–æ–≤—É –∫–∞—Ä—Ç–∫—É,4829,4829,-39609,-1700,840,0,0,609374,True
Qflq_7iemxAj_Xc,1577100989,Lesya,4829,4829,-1100000,-1100000,980,0,0,748983,True,94HB-PEMT-MEP3-X62C
edXGlzMtHoe8vrY,1577100825,–íi–¥: –ü–†–ò–•–û–î–¨–ö–û –ï.–í. –§–û–ü,4829,4829,1600000,1600000,980,0,0,1848983,True
pNlOGv2WJo_LuAM,1577093414,Harms1,5814,5814,-3760,-3760,980,0,37,248983,False,2603-56K9-MHE9-ABBE
ZtOPp5MKt40vfjI,1577092834,Bolt,4121,4121,-13400,-13400,980,0,134,252743,False,X2E6-X9T6-EE12-T1AM
jo9kbFrQvnHtsxA,1577091124,–ö–∏—ó–≤—Å—å–∫–µ –º–µ—Ç—Ä–æ,4111,4111,-800,-800,980,0,0,266143,False,BB3B-4TAE-PP4E-81P4
tfxQ1KGQIB-QEKY,1577086311,–ö–∏—ó–≤—Å—å–∫–µ –º–µ—Ç—Ä–æ,4111,4111,-800,-800,980,0,0,266943,False,765H-8K6T-CX1H-K9C6
H2dJt4Q1IIStzio,1577083820,TOV NVP MTM,8071,8071,-50000,-50000,980,0,0,267743,False,04K5-1TC4-917C-AM2E
p2YfeBERsotc_lQ,1577083770,TOV NVP MTM,8071,8071,-50000,-50000,980,0,0,317743,False,840B-7P6H-H02A-AEPH
oG7RxePHtKuS4w0,1577030365,–°—ñ–ª—å–ø–æ,5411,5411,-52423,-52423,980,0,0,367743,False,7XB9-7C4M-E4P8-04AT
Zn1pfGeiGYfuNOE,1577028664,KOLO,5499,5499,-10000,-10000,980,0,0,420166,False,8A04-38TE-H78H-C1H4
I1djHHYOLBPlWnk,1577020506,KOLO,5499,5499,-10900,-10900,980,0,0,430166,False,ATE3-8928-XKBK-28M1
78jV-99-jcYQ1Dw,1577004567,portmone.com.ua,4899,4899,-20400,-20400,980,0,0,441066,False,HHAA-01MH-16KE-8H9H
NHttZHpIEo0kEEI,1576959530,–ü–ª–∞—Ç—ñ–∂ –ê–õ–õ–û,4829,4829,-47475,-47475,980,0,0,461466,True
0Ur4VWXqa6KNJH0,1576936603,EKO-LAVKA,5999,5999,-20058,-20058,980,0,0,508941,False,89CC-4984-H92B-0CA2
v-3_ipH4vWp7tfU,1576936388,KOLO,5499,5499,-9250,-9250,980,0,0,528999,False,6KCK-B9E7-X34T-MK7T
yIBh6k11ljnxoJc,1576848768,Lesya,4829,4829,-50000,-50000,980,0,0,538249,True,KCP6-81CH-9XX5-5BH4
bTm2gF5WNWBPnhc,1576838190,Harms1,5814,5814,-3760,-3760,980,0,112,588249,False,8682-266A-48M4-8976
2_0jk17hkw7Edp4,1576837648,Business COFFEE,5812,5812,-3000,-3000,980,0,90,592009,False,E43A-1CE8-70EH-X34E
0oIkSgsoxK6uBpg,1576835925,McDonalds,5814,5814,-22300,-22300,980,0,669,595009,False,C7BE-3K76-8KHT-HME0
esFyo_H-Q6EFr30,1576774767,–ö–∏—ó–≤—Å—å–∫–µ –º–µ—Ç—Ä–æ,4111,4111,-800,-800,980,0,0,617309,False,9T22-415H-XEB8-H1EP
wYpBKDJ15Eot6WI,1576749160,ProduktiJArVal19,5499,5499,-2300,-2300,980,0,0,618109,False,52M8-CC37-9149-35M2
_bvgHohLifoG6VQ,1576743387,–ü—Ä–æ–¥—É–∫—Ç–æ–≤—ã–π,5499,5499,-3400,-3400,980,0,0,620409,False,XHBB-KACC-CPPX-12T9
aFkGTzTQ3CqCEFQ,1576695901,Mira Cafe,5814,5814,-18830,-18830,980,0,564,623809,False,X471-B63H-BT1E-M007
RTQ5E3Av6kNKg6U,1576658936,–°–∏–≥–∞—Ä–Ω—ã–π –¥–æ–º ¬´–§–æ—Ä—Ç—É–Ω–∞¬ª,5993,5993,-65000,-65000,980,0,0,642639,False,553T-K2T7-CCB5-P54P
KdFYDEyLPxhG19Q,1576658031,–ù–æ–≤–∞ –ø–æ—à—Ç–∞,4214,4214,-3900,-3900,980,0,0,707639,False,BCTP-1B3M-1TK2-22EM
HLqQncELgeZ6yYc,1576657991,–ù–∞–∫–ª–∞–¥–µ–Ω–∏–π –ø–ª–∞—Ç—ñ–∂ (–ù–æ–≤–∞ –ø–æ—à—Ç–∞),6538,6538,-84700,-84700,980,0,0,711539,False,2685-T927-2B5K-3EX0
6ILLX6aKdZkG33c,1576657266,Lesya,4829,4829,-400000,-400000,980,0,0,796239,True,214H-4CE8-B859-H4P8
KWxF6PpV_eXmaf8,1576656479,–ù–æ–≤–∞ –ø–æ—à—Ç–∞,4215,4215,-22900,-22900,980,0,0,1196239,False,3ET8-XX0E-4AA6-84BH
g13eQIEk4bzk8wU,1576579898,Bolt,4121,4121,-5900,-5900,980,0,1180,1219139,False,X9KC-6124-0A77-7C1B
yiHTDsLnrkPWggQ,1576527093,Bolt,4121,4121,-6100,-6100,980,0,1220,1225039,False,1X81-4CM8-67E3-4H0B
h4vwAVlrN2p6ORg,1576522306,EKO-LAVKA,5999,5999,-8700,-8700,980,0,0,1231139,False,52A8-AXT2-4ECB-A436
RhYFVdVFJA1q8JM,1576519722,Honey. Cafe-confectionery,5812,5812,-36600,-36600,980,0,1098,1239839,False,PME1-B13M-HX56-HPKC
n73Gb4T7qkGDskU,1576519354,–í–∏–Ω–Ω–∞—è –ª–∞–≤–∫–∞,5921,5921,-28100,-28100,980,0,0,1276439,False,5HX1-7AT0-27BA-70A9
mmHfFfiTPlFvAE0,1576511749,Harms1,5814,5814,-3760,-3760,980,0,112,1304539,False,02M6-AB92-6747-1T81
t-TRXdyj8GgLuJ4,1576506955,–í—ñ–¥: –í–∞–¥–∏–º –ê.,4829,4829,35500,35500,980,0,0,1308299,True
OadYVcwFSuzQwFw,1576504066,LIQPAY*Foundation Coff,5411,5411,-71050,-71050,980,0,0,1272799,False,E0XA-9EEB-E8CE-C791
puh_hVMMhgmQpMU,1576497335,Lesya,4829,4829,-1000000,-1000000,980,0,0,1343849,True,98PC-EP1T-PB2B-M973
qRbRGUsAWzLDe5w,1576497191,–ù–∞ –¥–æ–ª–∞—Ä–æ–≤—É –∫–∞—Ä—Ç–∫—É,4829,4829,-87018,-3700,840,0,0,2343849,True
Nj4lYQL8IaSWVv4,1576496751,–íi–¥: –ü–†–ò–•–û–î–¨–ö–û –ï.–í. –§–û–ü,4829,4829,2200000,2200000,980,0,0,2430867,True
Ohw6zthmzCt8Ltk,1576489224,Harms1,5814,5814,-3760,-3760,980,0,37,230867,False,3EP3-7191-7XH8-HH16
ttqtZRra1w2O-qE,1576420945,–ú–µ–≥–∞–º–∞—Ä–∫–µ—Ç,5411,5411,-182500,-182500,980,0,0,234627,False,3168-E8A1-3412-2KC3
0_P7PI46LUKKts4,1576414950,KOLO,5499,5499,-10000,-10000,980,0,0,417127,False,1M2X-2129-EXH0-C2K0
v77jNAjP0mwSC8M,1576347205,Bolt,4121,4121,-8900,-8900,980,0,1780,427127,False,4HCM-1791-78P6-93A6
d6-XbmTqqwpHIJs,1576329444,Bolt,4121,4121,-6400,-6400,980,0,1280,436027,False,HE82-4501-B6M4-BMHX
11LsciUrCLeT3aI,1576327368,McDonalds,5814,5814,-27000,-27000,980,0,810,442427,False,BC4X-4B7K-75XC-64MA
NuVphXNdl3PgTn4,1576324347,KOLO,5499,5499,-10450,-10450,980,0,0,469427,False,28M6-67K5-1776-TC08
TJqw_Ws_q88JIcY,1576324093,Barbershop Daboroda,7230,7230,-60000,-60000,980,0,0,479877,False,BTKP-BXH6-77T4-ME2K
VzvZBYZWDNhAzG4,1576324048,–°–∫–∞—Å—É–≤–∞–Ω–Ω—è. Barbershop Daboroda,7230,7230,60000,60000,980,0,0,539877,False
9GiLKpRTchmpAos,1576324047,Barbershop Daboroda,7230,7230,-60000,-60000,980,0,0,479877,False
wVMeA3kn8n5QPz0,1576310924,–ê–ø—Ç–µ–∫–∞ –ù–∏–∑—å–∫–∏—Ö –¶—ñ–Ω,5912,5912,-6300,-6300,980,0,0,539877,False,6EP6-MB0B-XX3E-2PCB
T4252Nyr2tPxBY0,1576250484,PRODUKTI 3,5399,5399,-3600,-3600,980,0,0,546177,False,164A-3T21-9HB1-PXKE
sYllamDbC3NL8w8,1576156554,Lesya,4829,4829,-620000,-620000,980,0,0,549777,True,T4P4-1387-EKAX-ABBP
8abqaXS7OVLPouM,1576149549,–ù–∞ –¥–æ–ª–∞—Ä–æ–≤—É –∫–∞—Ä—Ç–∫—É,4829,4829,-26054,-1100,840,0,0,1169777,True
9eY_Joq1-s65M88,1576149118,–íi–¥: –ü–†–ò–•–û–î–¨–ö–û –ï.–í. –§–û–ü,4829,4829,1200000,1200000,980,0,0,1395831,True
5w4HsG31F2M48-g,1576136206,Right Coffee Bar,5814,5814,-9500,-9500,980,0,95,195831,False,9TP9-T7K5-KB1C-47PM
gDsTA4QZysp_raY,1576048255,Bolt,4121,4121,-6500,-6500,980,0,65,205331,False,A48E-EC22-2525-E475
2ZHqkGCkojgF3vo,1575987693,Glovo,4215,4215,-29600,-29600,980,0,0,211831,False,T6P7-X5B8-CHCT-5T12
b167Md5atG9bC0I,1575975096,Right Coffee Bar,5814,5814,-25200,-25200,980,0,252,241431,False,E433-M820-25M0-6417
vUjlQkIjRI7678s,1575974516,–°–∫–∞—Å—É–≤–∞–Ω–Ω—è. Glovo,4215,4215,29600,29600,980,0,0,266631,False
-Sikn3tpXLbmHM8,1575974447,Glovo,4215,4215,-29600,-29600,980,0,0,237031,False
4ET2SH9TBlayZ60,1575973965,Right Coffee Bar,5814,5814,-13700,-13700,980,0,137,266631,False,32C1-0EAE-M6A2-T32B
ThRj1MNZ69ZfQ4k,1575973670,PHotosalonMAN,7221,7221,-14000,-14000,980,0,0,280331,False,80H7-62C9-460H-7670
M21ZiM3GjPS-nes,1575970541,Bolt,4121,4121,-9700,-9700,980,0,97,294331,False,APEP-HTB4-9B89-A24C
7MOMjKMjlReznN0,1575966511,Bolt,4121,4121,-8000,-8000,980,0,80,304031,False,5MXH-T947-65BH-69PB
w_c-Ai_8RUB2Z_o,1575963733,Novus,5411,5411,-10000,-10000,980,0,0,312031,False,H095-C1CT-K37A-1768
iDSsWL5EUoG6NKo,1575961195,Bolt,4121,4121,-7600,-7600,980,0,76,322031,False,AB77-CM67-939M-ET71
QYE5JjIktCVf3lk,1575927581,Bolt,4121,4121,-9000,-9000,980,0,90,329631,False,XP50-0P37-KK42-HEKB
qQx2feXiSwArtKc,1575892334,Bolt,4121,4121,-6700,-6700,980,0,67,338631,False,BPXH-B5T7-AA46-0EBP
I0nGqg6-oGFAxE4,1575889723,Bolt,4121,4121,-7200,-7200,980,0,72,345331,False,KE15-2MKA-2BAE-H2A4
fjVqw8gB73r144U,1575883814,Bolt,4121,4121,-9000,-9000,980,0,90,352531,False,2AHA-BHTH-K285-846H
W_9y7WVUzglVK54,1575882331,Bolt,4121,4121,-10100,-10100,980,0,101,361531,False,5EPK-5MB9-7922-MK7H
AvGYiXprYHH9oOw,1575826927,KOLO,5499,5499,-18000,-18000,980,0,0,371631,False,8E98-A051-CH7A-CX01
_xM8-_5C-ascuk0,1575817752,Bolt,4121,4121,-8900,-8900,980,0,89,389631,False,T73P-M989-X45E-760X
_SYxLSmJcbOagNw,1575812627,Persha Socialyna Aptek,5912,5912,-5112,-5112,980,0,0,398531,False,7TPK-853B-2PBT-623E
7vaHcCP70haqmM8,1575812478,–ê–¢–ë,5411,5411,-30410,-30410,980,0,0,403643,False,A2HM-4TC0-5KBH-3KTC
8K0T2wFDBHRZIPA,1575793479,Bolt,4121,4121,-8100,-8100,980,0,81,434053,False,X0KB-H529-8MH3-E5K7
nEv-meQFaiV2rCE,1575792467,WFP.ZOO.MOTO,5995,5995,-40800,-40800,980,0,0,442153,False,M0CT-5AXX-7C5M-PK97
UGsw7_LpSwaHcbI,1575752214,WFP.AQUAMAR.,5499,5499,-18525,-18525,980,0,0,482953,False,AEA7-XKC9-PT26-EH5C
KqoqFxJGZShrGRQ,1575752039,Lesya,4829,4829,-630000,-630000,980,0,0,501478,True,1EEM-4K7T-MET9-PEX8
mHfXObQRiYeGqd0,1575725479,Glovo,4215,4215,-30600,-30600,980,0,0,1131478,False,AKA3-T3P2-1B72-EK4P
aRHlL3ZxI_FhL9o,1575717680,APTEKA 7,5912,5912,-13690,-13690,980,0,0,1162078,False,8E94-CC40-6P58-9E56
_GcRWxTqdxxGoMg,1575717008,–ê–¢–ë,5411,5411,-25210,-25210,980,0,0,1175768,False,7P39-T0CM-KP69-K27E
zzdibh27FvoOWb0,1575714414,–ú–æ–ª–æ–∫–æ –í—ñ–¥ –§–µ—Ä–º–µ—Ä–∞,5451,5451,-6325,-6325,980,0,0,1200978,False,56E4-MB1A-3EC8-7TBB
RC6fgsNBgQYXDiY,1575708524,Mary,5441,5441,-6400,-6400,980,0,0,1207303,False,P8C6-K9A7-AM06-K63B
WhP8wWmwj34a4dE,1575660999,KOLO,5499,5499,-21150,-21150,980,0,0,1213703,False,4K79-5P64-AM59-6C7T
RWRZIeX9wViwBuM,1575653861,EKO-LAVKA,5999,5999,-9235,-9235,980,0,0,1234853,False,47TB-7770-P715-46PE
Bv1hfXBXAz39z6g,1575646752,414962****4667,4829,4829,-500000,-500000,980,0,0,1244088,True,9PEM-3KKH-P3H8-3PM3
KnFej0lxE7lOFew,1575573813,Glovo,4215,4215,-25000,-25000,980,0,0,1744088,False,K0X2-AE02-173T-TC94
Tw128CCbp4KUjJk,1575572384,KOLO,5499,5499,-17200,-17200,980,0,0,1769088,False,C835-H826-2P7A-5AEB
sg41AKPBJjCdLEY,1575554089,516874****1366,4829,4829,-270000,-270000,980,0,0,1786288,True,6B2A-P12B-H755-XH3M
dmTa4sXValaTQZQ,1575539869,TOV YAROSLAVNA,5814,5814,-6300,-6300,980,0,189,2056288,False,4982-9XP9-MXE9-MXE8
AAYVd-VyrlUCl-4,1575493541,–ú–∏–∫–æ–ª–∞ –û–≥–æ–π–∫–æ,4829,4829,-50000,-50000,980,0,0,2062588,True,4TA4-K8K2-A26M-B6XT
_GcRWBjrchxOoME,1575491594,Bolt,4121,4121,-5500,-5500,980,0,1100,2112588,False,23A5-8X3M-2MPA-0853
bGQlPlDybOUafH0,1575454790,Larksandowlscoffeeandp,5441,5441,-12500,-12500,980,0,0,2118088,False,714X-B2TE-X4BA-96HH
4zk7sbM4wAEqxkY,1575392493,–ú—ñ—Å—å–∫–µ –∫–∞—Ñ–µ ¬´–•–∞—Ä–º—Å¬ª (–ö–Ω–∏–∂–∫–æ–≤–∞ –∫—Ä–∞–º–Ω–∏—Ü—è ¬´–•–∞—Ä–º—Å¬ª),5814,5814,-3760,-3760,980,0,112,2130588,False,1956-94CP-X82K-34HP
tzqYQ6vQLmp0CV0,1575364742,TOV YAROSLAVNA,5814,5814,-6350,-6350,980,0,190,2134348,False,9E5P-7KE5-XBEX-M19K
SEe9aP0TlP8qsag,1575302675,–°–∏–≥–∞—Ä–Ω—ã–π –¥–æ–º ¬´–§–æ—Ä—Ç—É–Ω–∞¬ª,5993,5993,-27000,-27000,980,0,0,2140698,False,995T-XPX7-BTCX-T040
OTcSGGJYksV4nIc,1575290410,Lesya,4829,4829,-1000000,-1000000,980,0,0,2167698,True,5T23-H6E8-503T-1B3B
cBvPSglroDr3plY,1575284629,–ù–∞ –¥–æ–ª–∞—Ä–æ–≤—É –∫–∞—Ä—Ç–∫—É,4829,4829,-45762,-1900,840,0,0,3167698,True
3PYJnysAoI-OUUI,1575282854,–íi–¥: –ü–†–ò–•–û–î–¨–ö–û –ï.–í. –§–û–ü,4829,4829,3300000,3300000,980,0,0,3413460,True
KciH_2SxHJnYr6o,1575278899,–ú—ñ—Å—å–∫–µ –∫–∞—Ñ–µ ¬´–•–∞—Ä–º—Å¬ª (–ö–Ω–∏–∂–∫–æ–≤–∞ –∫—Ä–∞–º–Ω–∏—Ü—è ¬´–•–∞—Ä–º—Å¬ª),5814,5814,-3760,-3760,980,0,37,113460,False,5537-M8E5-M5ET-KX24
ms38l6D_hblQMYQ,1575272156,–íi–¥: –ü–†–ò–•–û–î–¨–ö–û –ï.–í. –§–û–ü,4829,4829,10000,10000,980,0,0,117220,True
Y75um66EETV89_8,1575210612,BeerMarket,5921,5921,-9139,-9139,980,0,0,107220,False,9B7B-97A7-9T71-H95K
fPMmPUpHOPIqZjc,1575210524,–ú–æ–ª–æ–∫–æ –í—ñ–¥ –§–µ—Ä–º–µ—Ä–∞,5451,5451,-14088,-14088,980,0,0,116359,False,EA68-92C3-KT7M-4P4B
oAYTNnVRbsngIF8,1575207570,–ù–æ–≤–∞ –ø–æ—à—Ç–∞,4214,4214,-4100,-4100,980,0,0,130447,False,X9CM-C7B7-EE6E-1958
iUYohDEJPI-Gzak,1575207526,–ù–∞–∫–ª–∞–¥–µ–Ω–∏–π –ø–ª–∞—Ç—ñ–∂ (–ù–æ–≤–∞ –ø–æ—à—Ç–∞),6538,6538,-31720,-31720,980,1220,0,134547,False,C979-194H-X2KH-2PEH
gviszZsaB7zMv30,1575205958,Bolt,4121,4121,-7000,-7000,980,0,70,166267,False,9C6K-P5P3-23HB-21PA
Sm0BD5IXHtRRj4o,1575203761,–ú–æ–ª–æ–∫–æ –í—ñ–¥ –§–µ—Ä–º–µ—Ä–∞,5451,5451,-13500,-13500,980,0,0,173267,False,BTP1-4BA0-MXA7-X879
QLBWsmDs-kOtkTQ,1575172353,–í—ñ–¥—Å–æ—Ç–∫–∏ –∑–∞ –ª–∏—Å—Ç–æ–ø–∞–¥,4829,4829,2643,2643,980,0,0,186767,True
SVqIBQ6jan7bnOQ,1580388825,TOV YAROSLAVNA,5814,5814,-4500,-4500,980,0,0,264764,False,C6M4-5B31-407E-66MC
w5utN8xJUV1QlM8,1580387914,TOVTORGOVIJDIMTORGSITI,5499,5499,-20000,-20000,980,0,400,269264,False,7872-0H6H-863X-A7CA
8T48VAVIPKvUjtk,1580387809,BeerMarket,5921,5921,-23653,-23653,980,0,473,289264,False,T374-C72X-8T89-43PX
-y0S0SCmiJtcBpU,1580324118,KOLO,5499,5499,-10300,-10300,980,0,206,312917,False,58TP-KAK6-55H7-6810
zByQRU4DPhep4zI,1580305825,–°—Ç–µ–π–∫—Ö–∞—É—Å,5814,5814,-18800,-18800,980,0,0,323217,False,74H3-MA81-TBP9-58X8
ifzBBYpw-fQpYQM,1580288002,414962****4667,4829,4829,-350000,-350000,980,0,0,342017,True,43K6-X4E8-56XB-T171
rCbe8PBH00x24Kc,1580240517,"Lifecell
+380631692598",4814,4814,-15000,-15000,980,0,0,692017,True,T23E-PAXC-510P-C8C7
P38H6WPn9TC4gbE,1580236828,BeerMarket,5921,5921,-6149,-6149,980,0,122,707017,False,4557-6BBT-0B7X-106M
O6C90vKxtLAnOA8,1580236572,Roshen,5441,5441,-7846,-7846,980,0,156,713166,False,2X4C-PX7C-P344-1A22
IgAmxQkpjohc4AY,1580235968,–ù–∞ –¥–æ–ª–∞—Ä–æ–≤—É –∫–∞—Ä—Ç–∫—É,4829,4829,-34724,-1400,840,0,0,721012,True
CZEAYjGKUugaxvs,1580210946,–íi–¥: –ü–†–ò–•–û–î–¨–ö–û –ï.–í. –§–û–ü,4829,4829,750000,750000,980,0,0,755736,True
sYDKAS_6AU5cA4k,1580196455,KOLO,5499,5499,-14500,-14500,980,0,290,5736,False,1442-P04E-T0KB-466A
u-9JBa7LrabTpLY,1580156822,KOLO,5499,5499,-10000,-10000,980,0,200,20236,False,TP1C-PAEK-EABT-B77T
QNpnUMokDGUcmfw,1580043243,Roshen,5441,5441,-22468,-22468,980,0,449,30236,False,6P45-03BB-527M-BX0K
n28cx6AjctfrmOU,1580041798,PHotovramke,7221,7221,-22500,-22500,980,0,0,52704,False,K3TE-A0EA-3M52-P4B8
1IoSj7p7UJkW7pc,1580041028,414962****1123,4829,4829,-190000,-190000,980,0,0,75204,True,HCK1-80A5-KBPP-3T54
LPZ2tCNvNzxvKN8,1580038670,Bolt,4121,4121,-40800,-40800,980,0,0,265204,False,EA5A-2T27-701P-ABE8
xUj2i23UyzrapsY,1580037600,LIQPAY*RoastersHub,5200,5200,-183800,-183800,980,0,0,306004,False,B3A5-16E0-KPH1-3275
IfI9ZeNO7amFXB8,1580029437,Lesya,4829,4829,-30000,-30000,980,0,0,489804,True,HBEM-PM62-X3E6-MHX1
nF8u2Aj_o5J9apo,1579966422,Lesya,4829,4829,-100000,-100000,980,0,0,519804,True,C631-P394-H99P-X441
AZsFIoc_s6RHHCw,1579965809,FUNKY BAKERS ALENI ALI,5813,5813,-18428,-680,978,0,0,619804,False,2K32-HT4M-BA9H-AB51
afmg0qoKAvC2UQg,1579962058,TINASOLGRACIA,5812,5812,-71274,-2630,978,0,0,638232,False,H4X1-HB05-4PP5-TK8T
0uTuMSznMq9lrq8,1579958417,HIBERNIAN BOOKS,5942,5942,-69648,-2570,978,0,0,709506,False,1TK2-A401-THX4-9BP5
pUEtb711FRIrKqk,1579954497,METRO BARCELONA,4111,4111,-13008,-480,978,0,0,779154,False,12M6-EH29-9119-TXAK
KgL9tK-ik9K5S9Q,1579947021,SATANS COFFEE,5813,5813,-45528,-1680,978,0,0,792162,False,K776-XPP1-6K4K-PCPP
ziCVUitF9gy08Ac,1579945784,MORNING GLORY,5814,5814,-43902,-1620,978,0,0,837690,False,B742-H933-C6PA-219T
ij4IvdYPPSCfy-k,1579889953,COALIMENT MARQUEZ ARG,5411,5411,-42385,-1564,978,0,847,881592,False,0078-61B5-C3EP-AE9E
f3A-q52RZJZP8-g,1579885793,SATANS COFFEE,5813,5813,-23306,-860,978,0,0,923977,False,42H6-M8KA-9719-PK3C
JvsIqft6xsIXEko,1579883370,EL BITXO,5812,5812,-14905,-550,978,0,0,947283,False,A155-E95T-9027-EMK5
lSpLefCDv_TnmDQ,1579880013,DUNNE IRISH BAR SL,5812,5812,-24390,-900,978,0,0,962188,False,E749-36PH-8K3A-EE04
d7go2wv9Rq3PBgU,1579876177,TLAXCAL,5812,5812,-146341,-5400,978,0,0,986578,False,T56K-B9A2-X65P-P50T
7E50bR2rRG_bXxs,1579871661,KONIG EL BORN,5812,5812,-18378,-680,978,0,0,1132919,False,K565-5TKP-0KEH-C69M
DF-2jLm-wMizht4,1579864632,LA TORNA,5812,5812,-28378,-1050,978,0,0,1151297,False,KE4K-1469-P488-10BA
p5gm_ibt8pWA7q8,1579859715,BRU BARCELONA,5812,5812,-81081,-3000,978,0,0,1179675,False,2E7X-EX15-0380-8E72
uhCWPtOMNQ63qEo,1579811685,Lesya,4829,4829,-200000,-200000,980,0,0,1260756,True,K2MC-A0MB-M97K-18CH
VVhYWrlTRpEjbWE,1579804030,COALIMENT MARQUEZ ARG,5411,5411,-32957,-1213,978,0,659,1460756,False,8M1K-K6T0-K23C-AE90
tf-xtzu2zzHWKFc,1579801406,DECIBEL DISCOS,5722,5722,-92379,-3400,978,0,0,1493713,False,4HPB-HX87-43CH-1E8A
TsdkbSCKSoSkzAk,1579798850,SATANS COFFEE,5813,5813,-29887,-1100,978,0,0,1586092,False,BTH5-E0T3-7990-CBBT
Vk435-47H2zt0rM,1579798532,SATANS COFFEE,5813,5813,-8151,-300,978,0,0,1615979,False,9CC7-6E33-3801-65T6
KsSqAApLE8TowqM,1579794162,LA DOROTEA,5812,5812,-14400,-530,978,0,0,1624130,False,1C7T-PAH4-2A0H-HCC7
u_1_GiIThru6FjE,1579787382,BAR JOAN,5813,5813,-77921,-2860,978,0,0,1638530,False,2CH1-PH0C-3E2C-7XBH
sbS_J-MJpa1nQ0E,1579779965,PARK GUELL,7832,7832,-54490,-2000,978,0,0,1716451,False,B9HP-MTC6-35X1-6C13
wE8dIJ6E8TcC7wo,1579775264,Mafia,5812,5812,-17709,-650,978,0,0,1770941,False,76MX-0KC5-6XAB-57E3
Vsc8KtSE_LB6P9Y,1579769195,Mafia,5812,5812,-35418,-1300,978,0,0,1788650,False,TK7M-P4KK-3TCK-AE91
VwKxP3WpBujp8l4,1579767398,Lesya,4829,4829,-100000,-100000,980,0,0,1824068,True,4PHE-7195-XA13-KMCX
R_bXh3sIBIx9uHg,1579712800,FARMACIA TEIXIDOR VENT,5912,5912,-38310,-1410,978,0,0,1924068,False,372E-T265-9T67-105B
1h_yfTNxRVU0M-E,1579712247,BORMUTH,5812,5812,-108681,-4000,978,0,0,1962378,False,652E-8090-B972-5649
bSoEKEoYKehDZb8,1579708699,DEMASIE PRINCESA,5411,5411,-32604,-1200,978,0,652,2071059,False,7XK8-5199-78TB-CK13
2kE4Y0rYhM2CBIE,1579699599,M 69,5651,5651,-311653,-11500,978,0,0,2103663,False,7ET4-97E8-1C5E-E2H1
Wui9gajVB0tqwMY,1579697860,LUSH COSMETICS,5977,5977,-26965,-995,978,0,0,2415316,False,XE5T-B0X9-656H-TE4K
iDOZlB40Bzl3i80,1579693434,MUSEU PICASSO,7991,7991,-37940,-1400,978,0,0,2442281,False,9PAE-B10M-4270-1977
1AH1A6UbG6yO9aY,1579688377,ALSUR CAFE TLF ALSUR 1,5814,5814,-94851,-3500,978,0,0,2480221,False,0KH1-KEB3-6EC7-E7AH
QDhuptJvDzK6EsQ,1579633462,Carrefour Market,5411,5411,-35772,-1320,978,0,715,2575072,False,TH85-A4TP-03BH-7CBC
h6GiEAz9cmFlJXc,1579630778,GRANJA M  VIADER,5813,5813,-40244,-1485,978,0,0,2610844,False,BKT8-75HT-TP1B-P6EC
WgIiuzgtEhdLSNw,1579628696,BAR LOBO,5812,5812,-141734,-5230,978,0,0,2651088,False,XB85-T3X2-EXK5-H46P
u2Y1lgE3RNqGDFQ,1579619493,SATANS COFFEE,5813,5813,-16260,-600,978,0,0,2792822,False,M8K5-9756-9P0H-H489
0Rr1wNbXuW64Nz4,1579601051,KARYALA,5411,5411,-33062,-1220,978,0,661,2809082,False,KK0M-929P-3XTT-HT5C
JKKGOISXQutjWTs,1579600485,SIMPLY BASIC,5411,5411,-18591,-686,978,0,371,2842144,False,AXKX-HCPE-H0P2-C088
Hk6dMxqEdrM4qeM,1579598736,CAPPUCCINO,5813,5813,-35908,-1325,978,0,0,2860735,False,1T91-E34P-B9MX-K258
K6_t2aKyku9iGNo,1579591492,–ü–ª–∞—Ç—ñ–∂ –ê–õ–õ–û,4829,4829,-47475,-47475,980,0,0,2896643,True
FM0d7ctjVcnLKGo,1579554879,SIETE PUERTAS S A,5812,5812,-266125,-9820,978,0,0,2944118,False,993E-4492-H06T-B640
8A33trsOe-PUAb4,1579543734,HOTEL OASIS,7011,7011,-796504,-29391,978,0,0,3210243,False,M581-867K-XK9E-3C0X
7RfoQ_DyNUQyNvA,1579524784,–¢–µ—Ä–º—ñ–Ω–∞–ª F (KBP) (–¢–µ—Ä–º—ñ–Ω–∞–ª F),5814,5814,-15000,-15000,980,0,0,4006747,False,MCK2-99XX-42X0-X10X
7FrhzGf3fnWDyJY,1579521741,Lesya,4829,4829,-300000,-300000,980,0,0,4021747,True,8M64-62PE-X5X0-781E
dJH38dNjnNFpKAE,1579521494,Bolt,4121,4121,-42100,-42100,980,0,0,4321747,False,6M12-552E-1B10-C436
D7UiN6oATmYC6M4,1579518878,–ë–†–°–ú,5541,5541,-7200,-7200,980,0,0,4363847,False,PEB3-8HA4-MHC4-0219
vwnFCnhEWQkWIxg,1579518151,–°–∫–∞—Å—É–≤–∞–Ω–Ω—è. Uklon,4121,4121,35000,35000,980,0,0,4371047,False
ep3287aMJbD91rQ,1579516231,Uklon,4121,4121,-35000,-35000,980,0,0,4336047,False
jZOZItoyTXwFreA,1579458271,Lesya,4829,4829,-50000,-50000,980,0,0,4371047,True,A5K2-T6HT-70TP-X5EB
R7Qze3Ua7-AjRFg,1579457381,414949****8957,4829,4829,-35000,-35000,980,0,0,4421047,True,1B21-T8CX-PH03-5K60
4Fs_Y5XPcaQKsiE,1579456171,portmone.com.ua,4899,4899,-25500,-25500,980,0,0,4456047,False,83X0-9HC6-9MT4-T825
7MONjasslhO_ndw,1579433281,Lesya,4829,4829,-100000,-100000,980,0,0,4481547,True,T5XK-2AM6-8B50-69MA
AUHMUidHsmIqIgs,1579427602,KOLO,5499,5499,-2800,-2800,980,0,56,4581547,False,TT0B-28E1-0XE6-MAB6
3OfPluC0D_j9wGw,1579427553,KOLO,5499,5499,-18800,-18800,980,0,376,4584347,False,5X8A-0TT6-55HK-1M60
tYLErdbMkL8Yt6I,1579370395,–ß—ñ—á—ñ–∫–æ,5812,5812,-52300,-52300,980,0,0,4603147,False,705P-9A41-H203-62H9
hkZM3GGFm30wOK0,1579370374,restoranChChKO1,5812,5812,-107002,-107002,980,0,0,4655447,False,H93T-HKT4-7066-0HCX
qoHxb7OAa7c2BzI,1579339254,KOLO,5499,5499,-12250,-12250,980,0,245,4762449,False,7PM8-C3KB-0086-0EEB
xnQyifq722yra50,1579266170,536354****4735,4829,4829,-25000,-25000,980,0,0,4774699,True,3888-6BEX-X811-6P13
McJmBLS4I0CFIfE,1579265373,–ê–¢–ë,5499,5499,-32060,-32060,980,0,641,4799699,False,9CBH-EHX2-61C0-0T13
AuU6s5Gau_OZLgg,1579254731,Bolt,4121,4121,-14900,-14900,980,0,0,4831759,False,2AP1-5KAT-734T-568H
qfqXJEGHlj6WGjo,1579250335,Bolt,4121,4121,-9000,-9000,980,0,0,4846659,False,XC14-7APX-9B4X-1KM4
u6i3D9DYwb2xeD0,1579218860,Bar /13,5814,5814,-46500,-46500,980,0,0,4955659,False,08AM-M63P-P63M-1T23
uJ_RuhY3QdSKh9s,1579176414,–ù–∞ –¥–æ–ª–∞—Ä–æ–≤—É –∫–∞—Ä—Ç–∫—É,4829,4829,-128582,-5300,840,0,0,5002159,True
-tG3lMaAA8HU7F4,1579174867,–íi–¥: –ü–†–ò–•–û–î–¨–ö–û –ï.–í. –§–û–ü,4829,4829,5100000,5100000,980,0,0,5130741,True
VdzW3uOinqY6eRU,1579172033,–í—ñ–¥: –î–µ–Ω–∏—Å –ö.,4829,4829,12900,12900,980,0,0,30741,True
03SqxmE1iBwhnDg,1579075540,WFP.AQUAMAR.,5499,5499,-39225,-39225,980,0,392,17841,False,7AKC-B364-CC78-888C
gOjJSx9VFIOYE04,1579075387,–í–∏–≤–µ–¥–µ–Ω–Ω—è –∫–µ—à–±–µ–∫—É 499.45‚Ç¥,4829,4829,40204,40204,980,0,0,57066,True
wOqZhaEQ3str00c,1579005607,–û–ª–µ–Ω–∞ –°.,üçîüêü,4829,4829,-9360,-9360,980,360,0,16862,True,49H5-9CM9-TBA7-EXTT
9V65P6WAXM3CQFA,1578911725,–ú—ñ—Å—å–∫–µ –∫–∞—Ñ–µ ¬´–•–∞—Ä–º—Å¬ª (–ö–Ω–∏–∂–∫–æ–≤–∞ –∫—Ä–∞–º–Ω–∏—Ü—è ¬´–•–∞—Ä–º—Å¬ª),5814,5814,-3760,-3760,980,0,0,26222,False,3C7A-82XT-PM31-496M
BXFmWjk02uPDm4Y,1578745015,–ö–∏—ó–≤—Å—å–∫–µ –º–µ—Ç—Ä–æ,4111,4111,-800,-800,980,0,0,29982,False,290P-K6XH-27TM-7581
zXJD-8fREEeuxd0,1578652413,–ü–ª–∞—Ç—ñ–∂–Ω–∏–π —Å–µ—Ä–≤—ñ—Å –ö–û–ù–ö–û–†–î –±–∞–Ω–∫,4829,4829,12000,12000,980,0,0,30782,True
KpI08ofzhXUFX2k,1578600622,–ü—Ä–∏–≤–∞—Ç24: Khalyavka Aleksey,6536,6536,5000,5000,980,0,0,18782,False
ftIm2oZY9DwrSdU,1578584524,–í—ñ–¥: –û–ª–µ–Ω–∞ –°.,"–æ—Å—Ç–∞—Ç–æ–∫ –∑–∞ –Ω–∞–≥–µ—Ç—Å—ã, –º–∞—Ç–µ–º–∞—Ç–∏–∫–∞ –Ω–µ –º–æ—ë üòÇ",4829,4829,1000,1000,980,0,0,13782,True
svBVC8IT3dq6wu4,1578579507,–°–∫–∞—Å—É–≤–∞–Ω–Ω—è. Glovo,4215,4215,3900,62800,980,0,0,12782,False
zGqv5-o84tpVnMo,1578578308,Glovo,4215,4215,-62800,-62800,980,0,0,8882,False
gxdFXDaUqZIKC3c,1578578234,–í—ñ–¥: –ú–∞–∫—Å–∏–º –ú.,4829,4829,10600,10600,980,0,0,71682,True
dfbVLrCfAJOk5yc,1578578028,–í—ñ–¥: –û–ª–µ–Ω–∞ –°.,–ù–∞–≥–µ—Ç—Å—ã,4829,4829,7000,7000,980,0,0,61082,True
UiDe1O_2Y2PoXa4,1578514946,KOLO,5499,5499,-10550,-10550,980,0,105,54082,False,P888-5AHM-071A-CM12
_HZY9lZRInUvYj0,1578512451,KOLO,5499,5499,-15000,-15000,980,0,150,64632,False,7C7A-53K9-7PP6-0XAT
LAWfDKu7BV5dGYk,1578485187,–û–ª–µ–Ω–∞ –°.,–±—É—Ç–µ—Ä —Å üêü,4829,4829,-9360,-9360,980,360,0,79632,True,X6P9-4H5H-BTBX-110B
JmkvyXB-kC--UZA,1578456438,Uklon,4121,4121,-12200,-12200,980,0,0,88992,False,6TA1-H14M-M546-PMXB
wZo0SQkrfBrmCa0,1578427265,–ê–ª–µ–∫—Å–µ–π –í—ã–∫–∞–ª—é–∫ BCD,4829,4829,-32000,-32000,980,0,0,101192,True,CP3C-B0B7-3MKH-554A
XPiiTPoXq0UTna8,1578426720,–í—ñ–¥: –ú–∞–∫—Å–∏–º –ó.,Thanks,4829,4829,15000,15000,980,0,0,133192,True
rCBmd6l98nYGu_Y,1578420689,White Coffee Bar,5814,5814,-34200,-34200,980,0,0,118192,False,938B-X745-7T3B-PAHA
crfbH9PFlAorXCE,1578418535,White Coffee Bar,5814,5814,-19000,-19000,980,0,0,152392,False,PE0P-P30K-EX2T-C188
pJyT_oHppI4t-DE,1578417431,White Coffee Bar,5814,5814,-19500,-19500,980,0,0,171392,False,0K5X-8CX2-6EC9-ME6K
DqzrgwvaDVhIEyw,1578401082,Bolt,4121,4121,-16600,-16600,980,0,0,190892,False,KH9P-1B78-5113-ETKA
R_5_DITliRqr8g0,1578390789,Bolt,4121,4121,-14800,-14800,980,0,0,207492,False,155X-5E49-BEPA-AAB9
7lB5NnfehZnLjEY,1578344954,–ê–ª–µ–∫—Å–µ–π –í—ã–∫–∞–ª—é–∫ BCD,üçîüöÇ,4829,4829,-5000,-5000,980,0,0,222292,True,4BTP-1HCX-H31H-02HK
6Ti90UKyPwZ8034,1578337253,–ê—Å–ø–∏—Ä–∏–Ω,5912,5912,-5680,-5680,980,0,0,227292,False,186K-P25C-MM4B-94T4
U2omFQ31khiIhpc,1578336382,Bolt,4121,4121,-5100,-5100,980,0,0,232972,False,0C10-HEK5-H09C-6428
-GL2r2fNJjj-hbg,1578327698,KOLO,5499,5499,-27600,-27600,980,0,552,238072,False,81PE-944C-8HPC-BCKE
Rcw2tK_vo2QjmIE,1578320071,–û–ª–µ–Ω–∞ –°.,—Ö–æ—Ç –¥–æ–≥ üå≠,4829,4829,-8000,-8000,980,0,0,265672,True,H665-KCH1-P4C0-8X2P
BSbXw49zisXa1lI,1578258284,–í—ñ–¥: –û–ª–µ—Å—è –°.,4829,4829,200000,200000,980,0,0,273672,True
XytgsYCmfRmj37Q,1578227446,–°—ñ–ª—å–ø–æ,5411,5411,-15000,-15000,980,0,150,73672,False,T9M9-T93E-KPX5-1279
Flx1Zcwngzd8LJM,1578227324,–°—ñ–ª—å–ø–æ,5411,5411,-63650,-63650,980,0,1159,88672,False,EXKT-KEB3-E3T4-XAMX
2nv4tnDA4ycN-Q4,1578145250,EKO-LAVKA,5999,5999,-10806,-10806,980,0,0,152322,False,6X46-K869-91E5-T83E
FDTHTwybhzUlfI8,1578144997,KOLO,5499,5499,-13200,-13200,980,0,264,163128,False,P9P2-P9H0-388B-2471
hqEB510rFqBYB-s,1578144795,Bolt,4121,4121,-6900,-6900,980,0,0,176328,False,C4KC-081H-2HMA-PTTE
3VegDgG2Thryy2Y,1578138297,Bolt,4121,4121,-7200,-7200,980,0,0,183228,False,TCCP-X302-3K47-H0XE
7VAWy2QJHgzKU3w,1578059525,–ü—Ä–∏–≤–∞—Ç24: Kabakchey Dmitriy,6536,6536,19000,19000,980,0,0,190428,False
BoxhH-QKBoCqkfQ,1578055255,–ú—ñ—Å—å–∫–µ –∫–∞—Ñ–µ ¬´–•–∞—Ä–º—Å¬ª (–ö–Ω–∏–∂–∫–æ–≤–∞ –∫—Ä–∞–º–Ω–∏—Ü—è ¬´–•–∞—Ä–º—Å¬ª),5814,5814,-3760,-3760,980,0,0,171428,False,M6T1-A3P2-6204-0EBA
lvMd7RRiPxNmt1s,1578054846,Glovo,4215,4215,-55600,-55600,980,0,0,175188,False,MC7P-XBKT-9MX8-63H1
3pVIupmnBDlKvXs,1578047496,–°–∏–≥–∞—Ä–Ω—ã–π –¥–æ–º ¬´–§–æ—Ä—Ç—É–Ω–∞¬ª,5993,5993,-5000,-5000,980,0,0,230788,False,12HC-K3PH-3921-ABC2
iPmkeUrzjqLZahI,1578039535,–ù–æ–≤–∞ –ø–æ—à—Ç–∞,4214,4214,-5500,-5500,980,0,0,235788,False,CEE9-C525-9B1E-32ME
tt_xdzWtJW0DGKk,1577994003,KOLO,5499,5499,-5800,-5800,980,0,116,241288,False,24PM-BACT-9288-8C58
3HwrAfjTBVhBfhY,1577975958,–ö–∏—Ç–∞–π—Å–∫–∏–π –ü—Ä–∏–≤–µ—Ç,5812,5812,-8000,-8000,980,0,0,247088,False,5M94-KAEP-10T1-1798
v0703xaiIP4Suos,1577975943,–ö–∏—Ç–∞–π—Å–∫–∏–π –ü—Ä–∏–≤–µ—Ç,5812,5812,-64500,-64500,980,0,0,255088,False,XH64-EAKK-CECE-53XT
r8j9TIo0qkrrh8k,1577975929,–ö–∏—Ç–∞–π—Å–∫–∏–π –ü—Ä–∏–≤–µ—Ç,5814,5814,-7500,-7500,980,0,0,319588,False,13HX-E2A4-PA5T-K4E6
ClaSRIE7GXooNG8,1577964363,516933****9078,4829,4829,-274600,-274600,980,0,0,327088,True,B7CE-2649-2M37-P185
Yx0gpETybRmERZk,1577956885,KOLO,5499,5499,-5000,-5000,980,0,100,601688,False,XE3B-7658-B091-86HC
IX_L7VurJLXGT5s,1577898675,KOLO,5499,5499,-7350,-7350,980,0,147,606688,False,EB00-TXXA-5X30-37X8
WnrlR1TxtxMEaLA,1577846519,–í—ñ–¥—Å–æ—Ç–∫–∏ –∑–∞ –≥—Ä—É–¥–µ–Ω—å,4829,4829,2905,2905,980,0,0,614038,True
3D4jYP-07jNEcUU,1582913981,Bolt,4121,4121,-7700,-7700,980,0,0,3146675,False,339T-KTC3-EM21-EH5P
5JucRSZZmv-XEtU,1582911870,–ú–æ–ª–æ–∫–æ –í—ñ–¥ –§–µ—Ä–º–µ—Ä–∞,5451,5451,-12002,-12002,980,0,0,3154375,False,THH7-MCMM-HP7C-X069
Qa6nGpJeyhl1ZfQ,1582897176,–ü–∏—Ä—ñ–∂–∫–æ–≤–∞ ¬´–¢—ñ—Ç–∫–∞ –ö–ª–∞—Ä–∞¬ª,5814,5814,-12600,-12600,980,0,378,3166377,False,P5H0-4CK6-46CM-T9M8
xHUoJk0vr1m2nUM,1582896981,–ì–∞—Å—Ç—Ä–æ–Ω–æ–º –¢–µ–∞—Ç—Ä–∞–ª—å–Ω—ã–π,5499,5499,-5200,-5200,980,0,0,3178977,False,M35M-CX85-P80X-EP2T
oSdHKDT580qzaBk,1582895823,Small Talking,5814,5814,-16800,-16800,980,0,504,3184177,False,T2BE-EMXA-7392-229A
hcjRcLxQjyp3JK8,1582885663,–íi–¥: –ü–†–ò–•–û–î–¨–ö–û –ï.–í. –§–û–ü,4829,4829,950000,950000,980,0,0,3200977,True
gEIwQteXsXnia1s,1582881648,–°–∏–≥–∞—Ä–Ω—ã–π –¥–æ–º ¬´–§–æ—Ä—Ç—É–Ω–∞¬ª,5993,5993,-50000,-50000,980,0,0,2250977,False,113C-4P7T-AH9C-TECA
xeUoNOUcILr12LU,1582835220,516874****6033,4829,4829,-160804,-160804,980,0,0,2300977,True,XXE2-PA6T-T487-K9MM
diFkf3PrFUmz7m0,1582823619,KOLO,5499,5499,-4300,-4300,980,0,0,2461781,False,E649-BB60-HCM4-4682
A8CDbgbZ5uR7Ta4,1582823063,–ë—É–ª–∞–Ω–∂–µ—Ä–∏,5814,5411,-3000,-3000,980,0,90,2466081,False,HM7M-59C0-P3C6-6C64
D2GiA_KIuj0vQ0g,1582822426,–°—É–ø–µ—Ä–º–∞—Ä–∫–µ—Ç,5411,5411,-2600,-2600,980,0,0,2469081,False,5C01-C2T3-2PHM-M4T6
3Re72d8Q8ycEfpU,1582808191,Glovo,4215,4215,-32900,-32900,980,0,0,2471681,False,7841-M6A1-38A9-5X5B
b_3X66bLdoFD2Oo,1582793728,High Five,7230,7230,-61750,-61750,980,0,2470,2504581,False,4K47-4K56-TMME-4PA6
BGlSop2kri3rudw,1582791732,"Lifecell
+380631692598",4814,4814,-10000,-10000,980,0,0,2566331,True,E6EH-43K7-E6BH-51X8
xxfkph2J3nWLdNM,1582785213,Mary,5441,5441,-7300,-7300,980,0,0,2576331,False,B235-49HH-98TP-KXH4
Mf7R1Nhp-42uQRg,1582742560,BeerMarket,5921,5921,-10698,-10698,980,0,0,2583631,False,3PT6-K6K0-TKE8-TE0P
QlLd1mYCCoCNpf8,1582741774,Cosmo,5977,5977,-14040,-14040,980,0,561,2594329,False,3AA8-0244-C99T-KAB5
OqTm1U0_eyRFpTk,1582724704,–ú–∞—Ä–º–µ–ª–∞–¥,5499,5499,-4400,-4400,980,0,0,2608369,False,47AB-C793-EH1X-9291
cfZw0UkKya2mXq8,1582724210,–ü–∏—Ä—ñ–∂–∫–æ–≤–∞ ¬´–¢—ñ—Ç–∫–∞ –ö–ª–∞—Ä–∞¬ª,5814,5814,-33500,-33500,980,0,1005,2612769,False,6T57-6C04-03CC-TAA9
KuMnF-3KJLZQ1Ro,1582716293,Lesya,4829,4829,-100000,-100000,980,0,0,2646269,True,TA2H-0400-M986-PACH
EjZhza5Q6IjBg4w,1582656402,Roshen,5441,5441,-6903,-6903,980,0,0,2746269,False,749T-MEM6-4674-K6X8
Rz6PjjeaLXpWyP8,1582655925,–ê–ø—Ç–µ–∫–∞ –ù–∏–∑—å–∫–∏—Ö –¶—ñ–Ω,5912,5912,-10450,-10450,980,0,418,2753172,False,573E-BHA5-AXX8-A992
0tabLJ8pZRz70nk,1582628300,Lesya,4829,4829,-200000,-200000,980,0,0,2763622,True,2C9K-1E10-8A0T-E21B
oi00KwDH7u4g4FM,1582565588,–ü—Ä–∏–≤–∞—Ç24: Teryayev Georgii,6536,6536,8500,8500,980,0,0,2963622,False
PjEiTfRIvrGB7Sg,1582555869,–í—ñ–¥: –ú–∞–∫—Å–∏–º –ú.,4829,4829,7800,7800,980,0,0,2955122,True
YUCMYa0ZMZMXP8s,1582551025,Glovo,4215,4215,-35900,-35900,980,0,0,2947322,False,87BX-E54E-9E32-BKKT
3-nQ-jEoTHUUFj0,1582548587,Lesya,4829,4829,-100000,-100000,980,0,0,2983222,True,5M5K-5MA1-T3XX-0A8M
P4HczDfqq6IWx6o,1582548227,Glovo,4215,4215,-22200,-22200,980,0,0,3083222,False,2MCC-89MM-2K2P-P340
I5XRcBO98Vl-C_0,1582537646,–°–∏–≥–∞—Ä–Ω—ã–π –¥–æ–º ¬´–§–æ—Ä—Ç—É–Ω–∞¬ª,5993,5993,-50000,-50000,980,0,0,3105422,False,0A40-1450-0B5H-B1P2
D7m0WkwOaTIWRhw,1582484006,–ï–∫–æ-–õ–∞–≤–∫–∞,5411,5999,-4600,-4600,980,0,0,3155422,False,CPTK-K530-K00K-1A74
bSMj0dvFOMf-Eh0,1582476186,–ê–ø—Ç–µ–∫–∞ –î–æ–±—Ä–æ–≥–æ –î–Ω—è,5912,5912,-3790,-3790,980,0,151,3160022,False,AEEB-X7TB-1P41-4071
D7qTRtk-l7DFiYM,1582475939,Roshen,5441,5441,-17375,-17375,980,0,0,3163812,False,H857-HK6P-8599-HH47
9fkRAcMrMWIQMOQ,1582462790,Glovo,4215,4215,-27800,-27800,980,0,0,3181187,False,X4CT-86AH-0E88-BM47
Wej-cZsPNVoh464,1582446410,KOLO,5499,5499,-1800,-1800,980,0,0,3208987,False,52AC-CMHM-EX38-X1C7
GO07-GR6BZ9yJ1s,1582446328,KOLO,5499,5499,-13250,-13250,980,0,0,3210787,False,20H2-343C-97XB-B84H
KWlc9CwQItrfDPE,1582382510,–ï–ø—ñ—Ü–µ–Ω—Ç—Ä,5211,5211,-40000,-40000,980,0,0,3224037,False,BA6P-MCPB-2T7A-KHM1
VQ7X0tM4hQQlSJo,1582366871,MAGAZYNShop 72,5499,5499,-4250,-4250,980,0,0,3264037,False,92P7-7E70-00BK-A100
T1-Wh5lohGnOd-06rBInkc7J,1582336287,–°–∫–∞—Å—É–≤–∞–Ω–Ω—è. –ú–æ—Ä–µ –ü–∏–≤–∞,5921,5411,62736,62736,980,0,0,3268287,False
_MAU-5wi5M38GOlMp_4j,1582336287,–ú–æ—Ä–µ –ü–∏–≤–∞,5921,5411,-57240,-57240,980,0,0,3205551,True
_NCFnZLPdX_gMCw,1582310611,KOLO,5499,5499,-18200,-18200,980,0,0,3262791,False,AT9B-HHP6-64T1-8P0M
fVnHkvtS37rfNSo,1582293357,–í–∞—Å–∏–ª—å –•–æ–º–∏—á,üö∞,4829,4829,-36000,-36000,980,0,0,3280991,True,7PT3-T1AM-M881-PK5B
oWV2DZm9BY-JOaQ,1582286280,MAKEUP,5977,5977,-78600,-78600,980,0,3144,3316991,False,6TM5-AP7P-3MT1-CP7A
JoweuXGZp7-NVwU,1582279702,–í—ñ–¥: –°–µ—Ä–≥—ñ–π –Æ.,–ü–∏–≤–∞—Å—ñ–∫,4829,4829,6000,6000,980,0,0,3395591,True
S4QK1VW9XjvQX_w,1582278585,–í—ñ–¥: –ú–∞–∫—Å–∏–º –ú.,4829,4829,15000,15000,980,0,0,3389591,True
qc8R6cTJZrvwz70,1582278263,–í—ñ–¥: –û–ª–µ–Ω–∞ –°.,üçª,4829,4829,6000,6000,980,0,0,3374591,True
SP59-JMhqGNS2i4,1582277798,535128****0471,4829,4829,-11000,-11000,980,0,0,3368591,True,7KP0-BX5T-K5KA-M8X5
_JAPUTS8yxOIfb4,1582269780,KOLO,5499,5499,-13800,-13800,980,0,0,3379591,False,PXA8-M886-PT8C-MXP2
EVuLysNT2SoTG_U,1582269271,–ü–ª–∞—Ç—ñ–∂ –ê–õ–õ–û,4829,4829,-47475,-47475,980,0,0,3393391,True
qgDiRtJjL-OVA6o,1582206413,"–ü–∏—Ä—ñ–∂–∫–æ–≤–∞ ""–¢—ñ—Ç–∫–∞ –ö–ª–∞—Ä–∞""",5814,5814,-15400,-15400,980,0,462,3440866,False,B394-M9EA-11B1-5M0T
SvljUeekS_sFQrc,1582198299,–ú–æ—Ä–µ –ü–∏–≤–∞,5921,5411,-62736,-62736,980,0,0,3456266,False
EGuCwAQTSGhaGe4,1582190488,TOV YAROSLAVNA,5814,5814,-4500,-4500,980,0,135,3519002,False,B881-T2EM-986K-KCBE
ymrzTRl0nWFfXQ0,1582190246,"–Ø—Ä–æ—Å–ª–∞–≤—ñ–≤ –í–∞–ª, 19",5499,5499,-3600,-3600,980,0,0,3523502,False,E373-MM1M-K6AB-66HM
jJ-N4OfQrEqjTvk,1582143219,KOLO,5499,5499,-9200,-9200,980,0,0,3527102,False,41BB-K482-KK1H-X7PT
I7BURQducnyju9c,1582095226,–§–∞—Ä–º–∞—Ü—ñ—è,5912,5912,-6530,-6530,980,0,261,3536302,False,485C-T539-E6ME-4K4X
79K_yEOt8g7XSkk,1582064161,–ù–∞ –¥–æ–ª–∞—Ä–æ–≤—É –∫–∞—Ä—Ç–∫—É,4829,4829,-41649,-1700,840,0,0,3542832,True
YD94q6aNMhSpZVQ,1582055870,KOLO,5499,5499,-20350,-20350,980,0,0,3584481,False,X1K8-62T7-5014-CB99
8fNNZYI-nicH0kE,1582031462,–•–ª–µ–±–Ω—ã–π,5812,5812,-4000,-4000,980,0,120,3604831,False,80EM-C642-XEK3-CMHB
5vqZuvjGTeksSi0,1582031261,Lesya,üòò,4829,4829,-800000,-800000,980,0,0,3608831,True,P59X-B2T7-XB39-3KE8
4A_K8TffNZ5Tzy0,1582029413,–•–ª–µ–±–Ω—ã–π,5812,5812,-28000,-28000,980,0,840,4408831,False,5P2M-XB8K-A8B4-E7HX
6OLzbuf7O008v-I,1582022395,–íi–¥: –ü–†–ò–•–û–î–¨–ö–û –ï.–í. –§–û–ü,4829,4829,2600000,2600000,980,0,0,4436831,True
uUuFhWBUXjmBnG4,1582018059,Uklon,4121,4121,-7600,-7600,980,0,0,1836831,False,8A8P-C10E-X6H7-A77M
3_ZQheC65rUdbXQ,1581961465,KOLO,5499,5499,-10000,-10000,980,0,0,1844431,False,KK33-1C4A-1CPB-3M09
JdsuJFbjQhtNkPM,1581942952,KAFE BLUE CUP,5812,5812,-15600,-15600,980,0,156,1854431,False,C758-3BA5-BE94-XK08
JcaKfLRANK-xvc8,1581942404,Rozetka,5399,5399,-32500,-32500,980,0,0,1870031,False,C875-0M29-752C-MKX3
ObhE6x-JsHeM8FY,1581941111,McDonalds,5814,5814,-15200,-15200,980,0,152,1902531,False,68B3-0M30-T7MH-1CTC
JgMLnAJMN-hnx8o,1581851390,KOLO,5499,5499,-18850,-18850,980,0,0,217731,False,EC06-MMC6-1TBA-6K22
SwjaXfI0AeC6Ag8,1581847686,WFP.AQUAMAR.,5499,5499,-33010,-33010,980,0,0,236581,False,KXP9-PT3B-4A1P-X8XK
QcNA-sdax94nvdY,1581785754,Glovo,4215,4215,-28800,-28800,980,0,0,269591,False,5152-8138-7TXH-1K14
0CBZk86tIPtSAis,1581769330,–ú–æ–ª–æ–∫–æ –í—ñ–¥ –§–µ—Ä–º–µ—Ä–∞,5451,5451,-21365,-21365,980,0,0,298391,False,MPAE-0P51-064X-MX2P
TETyC4MPdveVxbs,1581768364,EKOTOVARY,5411,5411,-13600,-13600,980,0,0,319756,False,M601-P001-7050-5KCX
wMBGIZlVMec_DjY,1581765385,Apteka2tovValena,5912,5912,-21450,-21450,980,0,858,333356,False,H9M7-C7BH-EETT-863A
Un0on6k8pKRgOh0,1581765182,–í—ñ–¥: –û–ª–µ—Å—è –°.,4829,4829,40000,40000,980,0,0,354806,True
1SU4Ej_5TjYGpsk,1581764741,–í–æ–ª–æ–¥–∏–º–∏—Ä –û.,–°–∞—á–µ–Ω–∫–æ. –ü—Ä–∏—Ö–æ–¥—å–∫–æ,4829,4829,-400000,-400000,980,0,0,14806,True,K02K-2EAX-MCX0-9E8C
Vdpg6ipG8hfxlBU,1581684997,–ö–æ—Å—Ç—è–Ω—Ç–∏–Ω –ü—Ä–∞—Å–æ–ª–æ–≤,üêü,4829,4829,-10900,-10900,980,0,0,414806,True,TPEK-1XEK-TXC6-18BM
3GsYFr8UJEQEwP0,1581682716,Lesya,4829,4829,-600000,-600000,980,0,0,425706,True,2B5B-B312-PBA3-C547
nJBDh0oQkxVMxt0,1581677258,–íi–¥: –ü–†–ò–•–û–î–¨–ö–û –ï.–í. –§–û–ü,4829,4829,800000,800000,980,0,0,1025706,True
avdRBcQpL3uF2ig,1581672884,–ú—ñ—Å—å–∫–µ –∫–∞—Ñ–µ ¬´–•–∞—Ä–º—Å¬ª (–ö–Ω–∏–∂–∫–æ–≤–∞ –∫—Ä–∞–º–Ω–∏—Ü—è ¬´–•–∞—Ä–º—Å¬ª),5814,5814,-20000,-20000,980,0,600,225706,False,B800-EKH5-9T30-CBAM
pylVK9VLRDp-1_s,1581668054,Right Coffee Bar,5814,5814,-9000,-9000,980,0,270,245706,False,11A7-H3AH-0PA0-27EM
KQyJYlYlUQg_uSo,1581614611,–ü—Ä–∏–≤–∞—Ç24: Teryayev Georgii,6536,6536,13600,13600,980,0,0,254706,False
ud3ypNDEIhv4kuA,1581612563,–í—ñ–¥: –†–æ–¥—ñ–æ–Ω –ú.,4829,4829,14400,14400,980,0,0,241106,True
SW69iYaJQQywXTE,1581597308,Glovo,4215,4215,-42200,-42200,980,0,0,226706,False,50EX-M0AK-K2E5-7EP6
z4batX6PQyXJcic,1581518509,–ü–∞–≤–ª–æ –ö.,–í–ª–∞–¥–∏–º–∏—Ä—Å–∫–∞—è,4829,4829,-47500,-47500,980,0,0,268906,True,583E-H2KE-AX27-HK94
8JP1qDYeCowOIG0,1581515267,Business COFFEE,5812,5812,-4000,-4000,980,0,120,316406,False,4P35-73A5-C9BB-MT1H
WnRDAQBzPDxAfDo,1581505088,516874****7317,4829,4829,-45000,-45000,980,0,0,320406,True,EMK5-PK7B-B6C3-17XC
NRbbE4KcPQN0_Ck,1581495134,MAKEUP,5977,5977,-37800,-37800,980,0,1512,365406,False,CE4C-54BK-0553-9X5A
pROHE0tL_LVtZX4,1581449645,–í—ñ–¥: –û–ª–µ—Å—è –°.,4829,4829,100000,100000,980,0,0,403206,True
dlIjNfQrG7MdtpQ,1581441659,Tabletochki,8398,8398,-20000,-20000,980,0,0,303206,False,6MPH-896C-B5K4-B927
CfzmVrU8s5kXEoo,1581412215,TOV YAROSLAVNA,5814,5814,-7800,-7800,980,0,234,323206,False,8BB8-1XX5-BP10-196B
NwuZhwcfiwCWP8k,1581361578,KOLO,5499,5499,-8850,-8850,980,0,0,331006,False,15T6-2939-0T12-B71T
2FGp176hNL0Vcag,1581356570,Bolt,4121,4121,-5500,-5500,980,0,0,339856,False,AX6T-BCX7-1079-H1HX
TefPSGWLHKo66yQ,1581319227,KOLO,5499,5499,-16900,-16900,980,0,0,345356,False,KP44-9B93-580K-6279
33-pmuoBGFkA-Uw,1581273361,516874****1366,4829,4829,-290000,-290000,980,0,0,362256,True,B687-KX25-B393-CPMA
SwXpz1x_Od4E6iY,1581264936,–í—ñ–¥: –í–∞–¥–∏–º –ê.,–∑–∞ –∫–æ—Ñ–µ,4829,4829,32000,32000,980,0,0,652256,True
p-RYshFb4OFvpEg,1581232303,–í—ñ–¥: –û–ª–µ–Ω–∞ –°.,‚òïÔ∏è,4829,4829,32000,32000,980,0,0,620256,True
7xwLPa858SzPa5I,1581228918,–ö–∏—ó–≤—Å—å–∫–µ –º–µ—Ç—Ä–æ,4111,4111,-800,-800,980,0,0,588256,False,MM05-595E-PA53-H36H
XaL6AbvMNOcvWRU,1581226907,–ö–∏—ó–≤—Å—å–∫–µ –º–µ—Ç—Ä–æ,4111,4111,-800,-800,980,0,0,589056,False,2M9H-H2KC-5454-7PH6
wWEhdHP7grAAyCU,1581226769,–ê–ø—Ç–µ–∫–∞ –î–æ–±—Ä–æ–≥–æ –¥–Ω—è,5912,5912,-236450,-236450,980,0,9458,589856,False,MEPM-06MM-6K6E-EB43
SQvbeMjq0w1pXzI,1581169383,–ê–ø—Ç–µ–∫–∞ –ù–∏–∑—å–∫–∏—Ö –¶—ñ–Ω,5912,5912,-5740,-5740,980,0,229,826306,False,3001-8H88-448E-0X61
Zq-MYf_YuYRp2RY,1581167904,Bolt,4121,4121,-9000,-9000,980,0,0,832046,False,X5AE-3351-KHH6-8EA3
wXEV55_7AnRZbKM,1581164428,–ú–µ–≥–∞–º–∞—Ä–∫–µ—Ç,5411,5411,-85200,-85200,980,0,0,841046,False,KTCB-HT7H-HAEK-AMK1
zxADUP6IlyZv0FQ,1581121188,–°—ñ–ª—å–ø–æ,5411,5411,-33276,-33276,980,0,0,926246,False,X671-X6M8-260A-CA23
YdnxMdV2_nVIhEE,1581118861,–û–ª–µ–∫—Å—ñ–π –í–∏–∫–∞–ª—é–∫,–≥–æ–ª–¥–µ–Ω –≥–µ–π—Ç,4829,4829,-30000,-30000,980,0,0,959522,True,XM1T-878M-MAM5-65BK
_CJOMctMPP6wcvE,1581114466,–î–µ–Ω–∏—Å –ö–æ—Ç–æ–≤,—à–∞–≤–∞,4829,4829,-9000,-9000,980,0,0,989522,True,B5A4-71T8-4EXH-HKBB
hzX5zBG2rd4N2js,1581063477,–ü–ª–∞—Ç—ñ–∂–Ω–∏–π —Å–µ—Ä–≤—ñ—Å WayForPay,4829,4829,58000,58000,980,0,0,998522,True
UYmy2Kw1WNZlCC0,1581020483,KOLO,5499,5499,-17900,-17900,980,0,0,940522,False,T084-T28M-6XT7-E935
pGIYutYWcTJ8cIs,1580997536,–¢—Ä—ñ—à–∫–∏ –±—ñ–ª—å—à–µ,5814,5814,-6800,-6800,980,0,204,958422,False,1PE0-XK6K-CX19-05CC
WGa97mEFgcXddOM,1580997515,TrishkiBilyshe1,5814,5814,-41500,-41500,980,0,1245,965222,False,KX3T-3BPA-3253-E8XE
ZSm3DKvarOg9lMQ,1580984064,LIQPAY*Foundation Coff,5411,5411,-151825,-151825,980,0,0,1006722,False,7701-2E40-3C10-T9AP
K5NDBuiIxLjs4p8,1580981364,–°–∏–≥–∞—Ä–Ω—ã–π –¥–æ–º ¬´–§–æ—Ä—Ç—É–Ω–∞¬ª,5993,5993,-30000,-30000,980,0,0,1158547,False,T140-61P3-1TKP-HPBE
TuWOj2bh390ABxc,1580841146,KOLO,5499,5499,-8150,-8150,980,0,0,1188547,False,9XEK-0H5K-MPAH-5526
Dm9tcSdcpSSw9OA,1580835261,High Five,7230,7230,-61750,-61750,980,0,2470,1196697,False,435X-3HC4-P1K8-0APB
Zh5ZwKE6hctd84U,1580812673,Lush,5977,5977,-156020,-156020,980,0,6240,1258447,False,K39X-67T3-B7HE-9TAM
fewCKeZdagCHUiE,1580803694,KOLO,5499,5499,-7550,-7550,980,0,0,1414467,False,H6AT-AA9K-XKPT-3XAT
mQuaq4PeYwxeB_0,1580803297,Mary,5441,5441,-5600,-5600,980,0,0,1422017,False,M9P4-MB59-15K8-C126
OAxHrbJJbyJHMcY,1580751752,KOLO,5499,5499,-7600,-7600,980,0,0,1427617,False,7B89-BXEP-1EC3-CHK4
9-_PNfsgV4g0Ct4,1580732740,"–ü–∏—Ä—ñ–∂–∫–æ–≤–∞ ""–¢—ñ—Ç–∫–∞ –ö–ª–∞—Ä–∞""",5814,5814,-19100,-19100,980,0,573,1435217,False,0MB6-3M83-1C6P-TE1E
-QSNQ5WfL3hbs1I,1580732416,–°–∏–≥–∞—Ä–Ω—ã–π –¥–æ–º ¬´–§–æ—Ä—Ç—É–Ω–∞¬ª,5993,5993,-25000,-25000,980,0,0,1454317,False,1C1K-E743-HA82-AX2B
XGDiDv47qaFEbIk,1580729391,Lesya,4829,4829,-550000,-550000,980,0,0,1479317,True,0MX2-M7E3-KA30-C382
iegSc9BZWIfDiTY,1580728879,–ù–∞ –¥–æ–ª–∞—Ä–æ–≤—É –∫–∞—Ä—Ç–∫—É,4829,4829,-98195,-3900,840,0,0,2029317,True
GlJBDBLalmiNzRs,1580728517,Lesya,4829,4829,-500000,-500000,980,0,0,2127512,True,2AE5-428H-410E-H2M2
DlIhd0FLwQEp27c,1580728458,–û–∫—Å–∞–Ω–∞ –ü.,4829,4829,-500000,-500000,980,0,0,2627512,True,AH7P-7417-MK62-MCA8
ysTsPbd5f6jv8RM,1580727421,–íi–¥: –ü–†–ò–•–û–î–¨–ö–û –ï.–í. –§–û–ü,4829,4829,3100000,3100000,980,0,0,3127512,True
IubNu5QQaW60xw0,1580657030,–í–µ–ª–∏–∫–∞ –ö–∏—à–µ–Ω—è,5411,5411,-17537,-17537,980,0,0,27512,False,2084-T002-18H4-1526
THEXSEBMRa7Nnfk,1580646135,Barbershop Daboroda,7230,7230,-35000,-35000,980,0,1400,45049,False,7P7P-HT09-XC34-T6C3
puz4du8rm5LI5_I,1580635817,Roshen,5441,5441,-14008,-14008,980,0,0,80049,False,HE1H-CA65-6E70-3CB1
AIbqY5aKpjUEaVA,1580574168,–°—ñ–ª—å–ø–æ,5411,5411,-20000,-20000,980,0,0,94057,False,BX2P-4MBB-3B6T-41X9
_TEfj1WeLb5JWcw,1580574079,–°—ñ–ª—å–ø–æ,5411,5411,-29597,-29597,980,0,0,114057,False,CHP3-XPH7-8H01-E7E7
9ZHoc5bJz001PJ4,1580561738,–ö–æ–ª—è –û–≥–æ–π–∫–æ,splitwise,4829,4829,-14900,-14900,980,0,0,143654,True,EE61-9H87-A9TT-1802
ZPWY4LhMtbk3jKg,1580553752,–ú–æ–ª–æ–∫–æ –í—ñ–¥ –§–µ—Ä–º–µ—Ä–∞,5451,5451,-4942,-4942,980,0,0,158554,False,TBP0-48HM-8E3H-H6E2
BUk_ZRdsz58OSEM,1580529317,–í—ñ–¥—Å–æ—Ç–∫–∏ –∑–∞ —Åi—á–µ–Ω—å,4829,4829,5632,5632,980,0,0,163496,True
tKg5xlO4vwSois0,1585573495,BeerMarket,5921,5921,-24196,-24196,980,0,0,1668800,False,HC69-P7P6-1APM-P8H3
WKTj8lgnHILcLOE,1585573094,Roshen,5441,5441,-21257,-21257,980,0,0,1692996,False,X3AT-7C78-1M7K-MT39
S0kwFm5xqAiLXwc,1585554092,Tabletochki,8398,8398,-50000,-50000,980,0,0,1714253,False,2768-X6K5-9BT6-0H03
pnWfFVG9x-iHJxc,1585477584,WFP.AQUAMAR.,5499,5499,-150600,-150600,980,0,0,1764253,False,8738-0098-2TA6-H227
eLWEIEcj0PjxW24,1585383614,–ï–∫–æ-–õ–∞–≤–∫–∞,5411,5999,-11700,-11700,980,0,0,1914853,False,0M18-K2T8-TATM-M147
dlyGMvIf5seZKHQ,1585314115,BeerMarket,5921,5921,-15198,-15198,980,0,0,1926553,False,B5C9-T5P1-4HC3-6075
3OZ6fL4TyeUdMdc,1585225066,WFP.PETHOUSE.M,5995,5995,-28964,-28964,980,0,0,1941751,False,X86E-7HBE-58MA-TT57
s8gb7SiAjNCjZHQ,1585155491,Glovo,4215,4215,-47700,-47700,980,0,0,1970715,False,045C-78A1-03H6-9P68
J8bPLxwthUhc5LI,1585137302,WFP.PETHOUSE,5995,5995,-163000,-163000,980,0,19710,2018415,False,PM0T-H13B-12T4-BMP1
_tVCefF_d6b24Xo,1585137164,–í—ñ–¥: 516798****8598,4829,4829,210000,210000,980,0,0,2181415,True
I7gE7UNp_lznJVk,1584974647,BeerMarket,5921,5921,-23837,-23837,980,0,0,1971415,False,T7MB-1BT4-M509-AK6T
yF4yai0bf3j48Ms,1584974480,–ú–æ–ª–æ–∫–æ –í—ñ–¥ –§–µ—Ä–º–µ—Ä–∞,5451,5451,-25886,-25886,980,0,0,1995252,False,B1P3-H22T-2M3B-P5BH
6hqs_JeYI_fxNNM,1584961720,Lesya,4829,4829,-20000,-20000,980,0,0,2021138,True,TC1P-8H0K-0220-EC4C
MLNqUHyPokHlSss,1584825236,JYSK,5200,5200,-7000,-7000,980,0,0,2041138,False,523P-93PK-BEA1-1661
4AAQdUAAO0Ammsw,1584810594,Lesya,4829,4829,-3000,-3000,980,0,0,2048138,True,8067-PAEM-KT50-1B5E
Es31U7jZ4mTXMto,1584801981,Uklon,4121,4121,-13200,-13200,980,0,0,2051138,False,H33T-1HB1-63T1-XHKM
TvRhHQfB5R9CNuo,1584787808,516875****6731,4829,4829,-420000,-420000,980,0,0,2064338,True,KM33-72M7-6668-8M1T
dJ1cVWAa4HrROyY,1584775709,–ü–ª–∞—Ç—ñ–∂ –ê–õ–õ–û,4829,4829,-47475,-47475,980,0,0,2484338,True
zR3jabmn4chdtKY,1584715352,BeerMarket,5921,5921,-9139,-9139,980,0,0,2531813,False,1H7P-9PM8-019C-21PB
CMBRj_hWNqzNIVQ,1584714650,Roshen,5441,5441,-48149,-48149,980,0,0,2540952,False,H14C-X9XM-EC64-M5XP
RI0fB5XUb--T6WM,1584627313,kvitkarnjaOnel,5992,5992,-15000,-15000,980,0,2250,2589101,False,K4P1-2A88-9T73-812C
278MrdujRVdDfZ8,1584624000,Lesya,4829,4829,-300000,-300000,980,0,0,2604101,True,TM08-BCP3-T4M9-M2MP
UZ5NqkhrL22Y2Bk,1584519286,–ù–æ–≤–∞ –ø–æ—à—Ç–∞,7399,7399,-4800,-4800,980,0,0,2904101,False,1AMB-X6PB-91H2-AEK4
lIwUQVicvQ5SPXo,1584453150,Lesya,4829,4829,-1000000,-1000000,980,0,0,2908901,True,1A5M-9242-527K-T651
R_eTedX84uk4AeA,1584452107,516874****6033,4829,4829,-80402,-80402,980,0,0,3908901,True,C57H-CTC3-0HMX-4B5X
6k9d6xsztaqX5o4,1584452005,516874****1366,4829,4829,-250000,-250000,980,0,0,3989303,True,E462-9M89-PTT9-XE52
1rrUY7eEF14_I8c,1584451919,WFP.PETHOUSE,5995,5995,-140200,-140200,980,0,28040,4239303,False,EAXM-83H9-K8CT-H1MX
zL_MXhPK8SArgo4,1584451675,516933****6250,4829,4829,-1640000,-1640000,980,0,0,4379503,True,080M-9198-M785-TB6C
th6LY7F0Yf1Cjko,1584451145,–ù–∞ –¥–æ–ª–∞—Ä–æ–≤—É –∫–∞—Ä—Ç–∫—É,4829,4829,-139079,-4800,840,0,0,6019503,True
1KXKcnfK3MgdnGU,1584441279,–íi–¥: –ü–†–ò–•–û–î–¨–ö–û –ï.–í. –§–û–ü,4829,4829,5100000,5100000,980,0,0,6158582,True
Y75hnauIGjJ39fw,1584380601,KOLO,5499,5499,-30200,-30200,980,0,0,1058582,False,8675-8CHK-507P-TB3P
McN61sA0LN2TdU4,1584379831,–°—ñ–ª—å–ø–æ,5411,5411,-21393,-21393,980,0,0,1088782,False,49H9-AAKC-38E2-MTBX
1FnZS770QCiic_g,1584374950,LIQPAY*HitTrejd,5732,5732,-150000,-150000,980,0,0,1110175,False,BA80-6H61-6110-P119
5PReQI9J2rBBC34,1584374794,High Five,7230,7230,-45600,-45600,980,0,0,1260175,False,KK79-K3MC-6HA3-C7CC
tYfWliwaKwiFqns,1584374781,Uklon,4121,4121,-20000,-20000,980,0,0,1305775,False,75AX-926X-3C18-T4P0
Xgp4qPFURGxSK24,1584370546,MAKEUP,5977,5977,-83900,-83900,980,0,0,1325775,False,KH9E-3XMK-13M1-628X
IkgYHdCbWfJr1YQ,1584348473,LIQPAY*Luxury Beauty,5977,5977,-55755,-55755,980,0,0,1409675,False,CHA6-6APE-5K0E-TC1B
3YDfK5Tl2IOn6Og,1584301152,KOLO,5499,5499,-21750,-21750,980,0,0,1465430,False,MT31-KAK2-AKMP-1A6B
Tz1a18mCjNK4764,1584285968,ColourPop Cosmetics,5977,5691,-111649,-4155,840,0,0,1487180,False,9BTC-B5HP-A5H1-93C8
hBeTjGPqvSxnzs0,1584273839,Karnivora1,5814,5814,-79900,-79900,980,0,0,1598829,False,5KXA-A414-7E45-AHK7
xuiSej_bmH12shA,1584273267,ORANGUTAN,5814,5814,-33500,-33500,980,0,0,1678729,False,MHB4-4E80-19K7-K413
O9ftLKCLLBaSfsQ,1584203991,BWTC,5814,5814,-8000,-8000,980,0,0,1712229,False,X530-ET73-907K-8477
_IK_3kZtAEWzHOs,1584202786,KOLO,5499,5499,-16150,-16150,980,0,0,1720229,False,6X8X-858T-AAET-7194
KrAIv9W7eGLd4gs,1584192513,EKOTOVARY,5411,5411,-9000,-9000,980,0,0,1736379,False,A2B9-T7BX-3114-2451
qW6RyJWw5ixlZxE,1584121377,Cosmo,5977,5977,-3940,-3940,980,0,0,1745379,False,BH9H-B44B-BM07-973X
s22BtdC8BA9uIr8,1584105628,JetBrains,5817,5817,-178557,-6675,840,0,0,1749319,False,07E9-C8TB-3835-M8H8
udchqAvLA3jNA0A,1584086979,KOLO,5499,5499,-10000,-10000,980,0,0,1927876,False,2P4C-E41K-876A-3E63
OXGdmXhDrBDnGlg,1583996049,KOLO,5499,5499,-15000,-15000,980,0,0,1937876,False,09E3-9645-0K6M-5K86
CeqpeQtwdd46veU,1583957235,–ú–∏–∫–æ–ª–∞ –û.,4829,4829,-24200,-24200,980,0,0,1952876,True
qTRGcr7ExePzm8E,1583956521,McDonalds,5814,5814,-12300,-12300,980,0,0,1977076,False,BCC8-P40T-PC25-6X6B
yGA7WXdkMmGsokQ,1583917286,–íi–¥: –ê–Ω–¥—Ä—ñ–π –ù.,4829,4829,7300,7300,980,0,0,1989376,True
SEtxerySPQ1qQ_M,1583917137,–ú—ñ—Å—å–∫–µ –∫–∞—Ñ–µ ¬´–•–∞—Ä–º—Å¬ª (–ö–Ω–∏–∂–∫–æ–≤–∞ –∫—Ä–∞–º–Ω–∏—Ü—è ¬´–•–∞—Ä–º—Å¬ª),5814,5814,-14600,-14600,980,0,0,1982076,False,T954-9TCT-991P-M1EM
L0I6_d_hWkl2E8M,1583864057,KOLO,5499,5499,-20150,-20150,980,0,0,1996676,False,T81A-P293-X1EA-C03T
a4uemim3Ji7ueXU,1583840213,Lesya,4829,4829,-2370000,-2370000,980,0,0,2016826,True,0AC8-02KM-9K6A-04KC
N9NQrWN-_CtV3U0,1583840066,–ù–∞ –¥–æ–ª–∞—Ä–æ–≤—É –∫–∞—Ä—Ç–∫—É,4829,4829,-31156,-1200,840,0,0,4386826,True
fr6TWndMCKUMctM,1583836023,–íi–¥: –ü–†–ò–•–û–î–¨–ö–û –ï.–í. –§–û–ü,4829,4829,4100000,4100000,980,0,0,4417982,True
uSKvG3IdjUgLSgs,1583786651,Bolt,4121,4121,-7200,-7200,980,0,0,317982,False,X7MK-9A7C-M82C-KC20
EQN7bLoDf5Wl22g,1583786587,McDonalds,5814,5814,-17900,-17900,980,0,0,325182,False,49B4-53A1-A158-TK06
x8kKgRrUnb8GMEE,1583783643,McDonalds,5814,5814,-12300,-12300,980,0,0,343082,False,26HB-5496-CC3K-4T1H
nEf9fJAjX6mEJAs,1583782269,Bitnik,5814,5814,-51000,-51000,980,0,0,355382,False,3HX1-C443-MPP8-MT30
L1DS17HN52KVTTw,1583770902,–ö–∏—ó–≤—Å—å–∫–µ –º–µ—Ç—Ä–æ,4111,4111,-800,-800,980,0,0,406382,False,26KT-TK54-KPE2-7XP1
akrNLyjy4_HBmyo,1583737112,KOLO,5499,5499,-18800,-18800,980,0,0,407182,False,1MMT-B3B2-C120-P80E
Z1TJkNUrbj9_y0E,1583685588,McDonalds,5814,5814,-35228,-1237,978,0,0,425982,False,085E-44K8-M1TK-KBMA
HcxtPAW4O_DhxDo,1583666435,Ryan Air,4511,3246,-142393,-5000,978,0,0,461210,False,9XBT-MCK4-PTKE-6582
_r6fbDE3m0qpBJE,1583663469,BIRD OF PASSAGE,5812,5812,-46420,-1630,978,0,0,603603,False,0E23-AHP5-CM32-2K02
5FVfEFvfw1yNfpA,1583612826,PINGO DOCE,5411,5411,-25716,-903,978,0,0,650023,False,5BK6-M1AH-KMA8-9P61
3WqDqwPkoLlHlB0,1583611438,LADO B CAFE,5812,5812,-56957,-2000,978,0,0,675739,False,H2MB-H251-BA1P-BC0C
jznJgnJ3JrxmhmM,1583602526,SumUp  *GOMES SILVA CA,7922,7922,-85436,-3000,978,0,0,732696,False,C395-H18C-EC4E-5M5E
TwrdY8OWIYU7O-s,1583592482,FABRICA CHIADO,5812,5812,-16518,-580,978,0,0,818132,False,7T66-C932-MPCE-PETK
LT4QZV7MJNFdAJA,1583590802,LIVRARIA LELLO,5942,5942,-67779,-2380,978,0,0,834650,False,6M63-PCX2-MX2B-0TK7
whB1XVYqqVZXA5U,1583586962,TANTOMELHOR LDA,5812,5812,-80595,-2830,978,0,0,902429,False,9K12-TTE8-ATXA-A2H1
n5_qwZBuwT6ZBuE,1583583529,CASTRO PORTO,5812,5812,-15378,-540,978,0,0,983024,False,7EBK-EBC1-M36P-P67P
y3FacPSNr1QZR8o,1583574506,REST NEGRA CAFE,5812,5812,-62368,-2190,978,0,0,998402,False,5H93-5CPK-EBPT-1938
HvoaYUtm0etOfQo,1583522554,CLAREL CEDOFEITA,5411,5411,-60603,-2128,978,0,0,1060770,False,TA2M-M69T-MBK7-E9P0
Qsdh9_wts3T7VI4,1583521542,CONFEITARIA PRIMAR,5499,5499,-5696,-200,978,0,0,1121373,False,0KH3-P475-KEA7-9BBX
k_oPy4nvUXS49aw,1583520086,LIVRARIA LELLO,5942,5942,-28479,-1000,978,0,0,1127069,False,T1K0-3MXC-KEHE-2386
KWCM7Z8qm61xhvI,1583519714,MURALHAS PAO QUENTE,5462,5462,-19935,-700,978,0,0,1155548,False,KMC4-AKX3-MT7H-K281
LKGOjurdJf2_pmc,1583518019,BACALHAU,5411,5411,-31327,-1100,978,0,0,1175483,False,1P5P-E8XT-C34E-P253
zJGuJfd-zrZyycg,1583514325,Starbucks,5812,5812,-28194,-990,978,0,0,1206810,False,XECH-PH6E-CBM6-HH87
kM0srRQRTSRGzGA,1583512525,CERVEJARIA GAZELA,5812,5812,-42718,-1500,978,0,0,1235004,False,K8BH-3M9A-PHB3-E18B
Qv1oqM-Ti2SjlqQ,1583491713,CP LISBOA,4111,4111,-141752,-5020,978,0,0,1277722,False,11BK-0MA0-50T3-P568
WfYGtm3CUD_lDwU,1583483923,portmone.com.ua,4899,4899,-42840,-42840,980,0,0,1419474,False,5PEP-B7B4-22X2-50MH
RFqUiz66-knGE_Q,1583442566,Lesya,4829,4829,-104,-104,980,4,0,1462314,True,2B2X-463X-T77E-8PP6
5W5yjq2oLAJFEBg,1583442367,Wizz Air,3301,3301,-153830,-153830,980,0,0,1462418,False,P84K-AM39-7577-A276
NcRiYYQl6-jzW1M,1583431114,–ê—à–∞–Ω,5411,5411,-51119,-1841,978,0,0,1616248,False,2BXP-61T8-4A2A-7108
H7mCoR1J9slNqAA,1583429532,SPUTNIK BAR,5813,5813,-27212,-980,978,0,0,1667367,False,A6C9-100T-326C-0A71
i_YHRk4a5OQ7qQA,1583424409,CONFEITARIA NACIONAL,5812,5812,-6386,-230,978,0,0,1694579,False,1M52-2761-P2C4-EE31
wyAds2GQAtoVIYs,1583423986,MUJI CHIADO,5311,5311,-27628,-995,978,0,0,1700965,False,XX5E-TCXH-9908-C0TK
xFkaccN-wtUtjVA,1583421982,JAMIE OLIVIER PIZZER,5812,5812,-91631,-3300,978,0,0,1728593,False,74M5-85KH-6K63-48T2
zreWrwo949eiWvY,1583414811,BANANA CAFE,5499,5499,-13845,-500,978,0,0,1820224,False,1B4T-TXH9-TXT1-E1B9
W2R8K5UgFck-LS4,1583411504,LISBON DUCK STORE,5945,5945,-24783,-895,978,0,0,1834069,False,KKM7-AH23-M49A-H690
sGAv4ZEKbxyWg8I,1583410899,THE MILL,5812,5812,-81132,-2930,978,0,0,1858852,False,PH61-PH1B-3XM2-90B6
l9Ww84Mp-zr0sRg,1583359125,VICENTE BY CARNALENT,5812,5812,-180485,-6500,978,0,0,1939984,False,PT53-A02E-8C51-16C9
jF2EggFVy8A3YhI,1583342837,FABRICA AVENIDA,5812,5812,-43039,-1550,978,0,0,2120469,False,MK18-X43A-0P71-MPK5
jilrjw7Y2a8GI3k,1583338290,A.S. ALFRAGIDE (AMAD,5172,5172,-39429,-1420,978,0,0,2163508,False,3ME9-P6B6-X9EB-H2B5
ZXJ3_WQS1lk1BIs,1583259867,CAFE BELGA,5812,5812,-42118,-1500,978,0,0,2202937,False,H8T9-4TTH-CT46-A968
A_qPHZYV-oHxSEg,1583175043,CONFEITARIA NACIONAL,5812,5812,-8861,-320,978,0,0,2245055,False,MT98-P61T-54M2-59MM
bDRylKnFQAZ6mVc,1583156042,LEITARIA AVIZ,5812,5812,-51633,-1875,978,0,0,2253916,False,XK51-4944-5T0B-T5T4
hLxJb2Goy2C9j9U,1583092371,–ê—à–∞–Ω,5411,5411,-36950,-1364,978,0,0,2305549,False,MXX0-T625-7K77-891T
88Rs-3MxBRckZ0Q,1583066240,LAGARDERE T.R.DEUTSCHL,5994,5994,-10023,-370,978,0,0,2342499,False,1HEE-2T80-MB8T-6P4A
Ra7XYCO5Xr6roP0,1583049865,Ryan Air,4511,3246,-43343,-1600,978,0,0,2352522,False,EPMB-2T6C-TXHM-T891
dyMACKKjNB2UY7E,1583049714,Ryan Air,4511,3246,-43343,-1600,978,0,0,2395865,False,H63T-1P72-XX15-4AB7
SwedvhUnkSvByk4,1583033274,–í—ñ–¥—Å–æ—Ç–∫–∏ –∑–∞ –ª—é—Ç–∏–π,4829,4829,3760,3760,980,0,0,2439208,True
RsG868XqKqhz9kE,1583013922,Lesya,4829,4829,-200000,-200000,980,0,0,2435448,True,M9X3-702A-H4TP-54P6
a9Ltmnl_6x_Lo_xJ,1588074518,LIQPAY*HitTrejd,5732,5732,-200000,-200000,980,0,0,1736434,False,4KEB-5C53-X3PX-0KPE
Be0LiXeaVtyoBaGw,1588070081,Glovo,4215,4215,-35000,-35000,980,0,0,1936434,False,C6HH-PX5X-98X0-4XX9
4oMytCY84UGISY4h,1587976751,Glovo,4215,4215,-38331,-38331,980,0,0,1971434,False,28CP-5MK4-AH78-8MB9
IATal5ibPdZoLjEb,1587976750,–°–∫–∞—Å—É–≤–∞–Ω–Ω—è. Glovo,4215,4215,34648,34648,980,0,0,2009765,False
UKEJedtCScxOmmbn,1587974838,Glovo,4215,4215,-34648,-34648,980,0,0,1975117,False
AGHxO78gaMYMCK_o,1587907982,LIQPAY*FreshMart,5411,5411,-94100,-94100,980,0,1882,2009765,False,0B4E-P353-T0X2-63TB
L3TCWhCJE7UIWGCq,1587907933,–í—ñ–¥: –û–ª–µ—Å—è –°.,4829,4829,100000,100000,980,0,0,2103865,True
60L1rrjdyobL8CZc,1587896162,zakaz.ua,7278,7278,-261542,-261542,980,0,0,2003865,False,C2C3-7H4X-08A6-8CTH
QwALdxSU9zm9sKJy,1587896110,–í—ñ–¥: –û–ª–µ—Å—è –°.,4829,4829,13000,13000,980,0,0,2265407,True
2xwpbo4MSLFuluGU,1587896058,–í—ñ–¥: –û–ª–µ—Å—è –°.,4829,4829,300000,300000,980,0,0,2252407,True
Xr2eSFDftIPpOmLO,1587831435,KOLO,5499,5499,-69550,-69550,980,0,915,1952407,False,2912-M45E-A8T6-34X9
7tQcFrZK20IN-duB,1587813891,516874****1218,4829,4829,-29900,-29900,980,0,0,2021957,True,2097-XCXA-83T4-CT51
dzCIXNPnLDHkQiw3,1587633847,Lesya,4829,4829,-300000,-300000,980,0,0,2051857,True,9KT9-6H53-K66M-5BC8
OdfgrPAMUnJouft3,1587545570,Lesya,4829,4829,-40000,-40000,980,0,0,2351857,True,0MTC-71XK-61BK-CK36
IWOTlSjAluWlx8Zj,1587486392,–û–ª–µ—Å—è –°.,4829,4829,-80000,-80000,980,0,0,2391857,True,MA2B-KCHB-8A4E-6TCA
2hEsVvi1wAvNKOtlu6j24Q,1587425590,"LIQPAY*Lerua Merlen Br, LIQPAY*Lerua Merlen Br,DN-SK,UA, DN-SK, UA",5211,5211,-94145,-94145,980,0,0,2471857,True
QqlTpHwDppKfzHlqB_ImUIRmCA,1587425590,–°–∫–∞—Å—É–≤–∞–Ω–Ω—è. LIQPAY*Lerua Merlen Br,5211,5211,97445,97445,980,0,0,2566002,False
bcV1wU2UPD6NiP4N,1587371212,–í—ñ–¥: –û–ª–µ—Å—è –°.,4829,4829,100,100,980,0,0,2468557,True
BhUhFRm7oGnmeBwT,1587371172,Lesya,4829,4829,-100000,-100000,980,0,0,2468457,True,HK19-9KAP-M83K-1TA8
07MC78bbWXQJ-Z3L,1587243590,LIQPAY*Lerua Merlen Br,5211,5211,-97445,-97445,980,0,0,2568457,False
mDtS4mPNmjsDAMO6,1587210702,–°–∫–∞—Å—É–≤–∞–Ω–Ω—è. Netflix,7841,4899,2976,100,978,0,0,2665902,False
TowPW2BHHCP5b3LI,1587210686,Netflix,7841,4899,-2976,-100,978,0,0,2662926,False
Nl7PT7O7mVX_LoT5,1587210517,WFP.AQUAMAR.,5499,5499,-114700,-114700,980,0,2294,2665902,False,6HC5-X41E-MBCX-2T2T
FuwjQWBepuU3tZId,1587203852,Glovo,4215,4215,-45611,-45611,980,0,0,2780602,False,CE8M-53MM-2B40-HXB7
1D0q9m7Y-R2X-NDH,1587203851,–°–∫–∞—Å—É–≤–∞–Ω–Ω—è. Glovo,4215,4215,42750,42750,980,0,0,2826213,False
P8U4PQWGp-h11dK2,1587201229,Glovo,4215,4215,-42750,-42750,980,0,0,2783463,False
E-uDEtaM_-Zzh6UT,1587136657,–ù–∞ –¥–æ–ª–∞—Ä–æ–≤—É –∫–∞—Ä—Ç–∫—É,4829,4829,-106549,-3900,840,0,0,2826213,True
UfvmU0bZjktOlVv2,1587129402,Lesya,4829,4829,-500000,-500000,980,0,0,2932762,True,7T64-CKBC-231E-A2P0
9wZ5okHQyKJSRgoB,1587119712,–íi–¥: –ü–†–ò–•–û–î–¨–ö–û –ï.–í. –§–û–ü,4829,4829,1600000,1600000,980,0,0,3432762,True
yQxtFk-WUfBdUmNO,1587108830,CafeBoutique,5399,5399,-94600,-94600,980,0,946,1832762,False,648H-KATK-PAP6-XBHT
skz4l5R9yIVZpx1s,1586958268,STORE J061,5200,5200,-54500,-54500,980,0,0,1927362,False,K3MM-61T5-CCP8-9MA2
KKwvc4hW4GrnVOz9,1586937995,Pirogitadruzi,5814,5814,-18141,-18141,980,0,0,1981862,False,E92C-KC31-KE59-CTB3
dbxnBQkV8KPZxZ_O,1586886001,Lesya,4829,4829,-248000,-248000,980,0,0,2000003,True,6P94-P297-X591-X64K
787xdosd8uqd9oOL,1586868237,–°–∫–∞—Å—É–≤–∞–Ω–Ω—è. Glovo,4215,4215,68900,68900,980,0,0,2248003,False
GeQZBs_l-y_4TBfN,1586863267,–ù–∞ –¥–æ–ª–∞—Ä–æ–≤—É –∫–∞—Ä—Ç–∫—É,4829,4829,-32785,-1200,840,0,0,2179103,True
-OET6vGMAYDMm2dD,1586863216,Lesya,4829,4829,-400000,-400000,980,0,0,2211888,True,X98M-CXKH-0577-P2A5
3uLQz_cwDmnyr2I7,1586862687,Glovo,4215,4215,-68900,-68900,980,0,0,2611888,False
Ghm-Jn6Z6MJ9A4S3,1586859842,–íi–¥: –ü–†–ò–•–û–î–¨–ö–û –ï.–í. –§–û–ü,4829,4829,1100000,1100000,980,0,0,2680788,True
17eBaiXooiWT4nbS,1586804227,Steam,7994,7994,-4500,-4500,980,0,45,1580788,False,KEPX-H6HM-4KC5-E857
-xaK2CRU4EXNvqK_,1586698433,Pirogitadruzi,5814,5814,-22000,-22000,980,0,0,1585288,False,EB9T-CC5A-1651-P4AA
9qHgPmfzVrnjKBit,1586620159,WFP.AQUAMAR.,5499,5499,-399160,-399160,980,0,4056,1607288,False,HXHT-19K4-39M0-5373
HjxGWcUFDj42E_zY,1586620069,Lesya,4829,4829,-360000,-360000,980,0,0,2006448,True,769K-2E6K-M57K-M2A8
VhSgKyC8SJv3vBU,1586529201,473121****5881,4829,4829,-53467,-53467,980,0,0,2366448,True,573C-75BA-09A0-69C6
3zFV0M_B9OUc810,1586511193,–°–∫–∞—Å—É–≤–∞–Ω–Ω—è. –ï–ø—ñ—Ü–µ–Ω—Ç—Ä,5211,5211,45220,45220,980,0,0,2419915,False
JMo-nD_hPtEL7aI,1586462879,–ï–ø—ñ—Ü–µ–Ω—Ç—Ä,5211,5211,-45220,-45220,980,0,0,2374695,False
Yfz_ygxc6ytbAKg,1586437112,414943****6985,4829,4829,-44500,-44500,980,0,0,2419915,True,6TTP-5304-TX1E-6M5H
8Eswp1kqalWtedg,1586367599,414943****7599,4829,4829,-160000,-160000,980,0,0,2464415,True,6836-PEK5-8796-T2KC
KYxrnP12cBQExqH0PTgGUVfx,1586218225,–°–∫–∞—Å—É–≤–∞–Ω–Ω—è. Glovo,4215,4215,47300,47300,980,0,0,2624415,False
zV6mvBYzWJ4FWLRxYvbk0A,1586218225,Glovo,4215,4215,-45370,-45370,980,0,0,2577115,True
0P6lW7VIQrPBNA0,1586172460,portmone.com.ua,4899,4899,-15300,-15300,980,0,0,2622485,False,3P9X-0CHT-B9MT-T9X2
57YsciT4IfUKWEY,1586169669,–ù–∞ –¥–æ–ª–∞—Ä–æ–≤—É –∫–∞—Ä—Ç–∫—É,4829,4829,-57688,-2100,840,0,0,2637785,True
UsFs6eKSEcFN3kI,1586167642,–íi–¥: –ü–†–ò–•–û–î–¨–ö–û –ï.–í. –§–û–ü,4829,4829,400000,400000,980,0,0,2695473,True
KpI6_oH7g3cPW2M,1586002434,Glovo,4215,4215,-47300,-47300,980,0,0,2295473,False
6hqs8ZSeJ_b5MNE,1585994332,Uklon,4121,4121,-16100,-16100,980,0,0,2342773,False,765K-3183-279B-B9AA
6rBSu4q44_jNCwc,1585901520,LIQPAY*HitTrejd,5732,5732,-200000,-200000,980,0,0,2358873,False,A0B9-T742-77KB-795M
2WjmTZl3zpWsWLg,1585896124,KOLO,5499,5499,-17450,-17450,980,0,349,2558873,False,1C5T-EMP2-5E4K-X9H7
_fYMV1Gw_tx9bnE,1585840424,LIQPAY*Foundation Coff,5411,5411,-53760,-53760,980,0,1075,2576323,False,4CHA-9KMX-E78T-B5H8
vMTbyRydwd2AFCU,1585741752,Glovo,4215,4215,-37100,-37100,980,0,0,2630083,False,AM0M-AEPM-7287-8PEP
0zkvUq4RTwXii4M,1585740043,–ù–∞ –¥–æ–ª–∞—Ä–æ–≤—É –∫–∞—Ä—Ç–∫—É,4829,4829,-156854,-5600,840,0,0,2667183,True
d3ptXJsD6OIT-fM,1585733926,WINETIME,5411,5411,-209871,-209871,980,0,4197,2824037,False,400P-T154-9H44-7A46
EieolzDvN9V3wxo,1585730801,Lesya,4829,4829,-700000,-700000,980,0,0,3033908,True,XB9X-10X4-ME89-5A8H
yi615zyMpPvVRQk,1585730654,–íi–¥: –ü–†–ò–•–û–î–¨–ö–û –ï.–í. –§–û–ü,4829,4829,2000000,2000000,980,0,0,3733908,True
p4p6JVw6tDy-5Ho,1585730508,"Lifecell
+380631692598",4814,4814,-12000,-12000,980,0,0,1733908,True,8P27-17B9-PP99-2PBX
ASPFHluOLvKc-8k,1585720809,–í–∏–≤–µ–¥–µ–Ω–Ω—è –∫–µ—à–±–µ–∫—É 950.06‚Ç¥,4829,4829,76478,76478,980,0,0,1745908,True
vF3H2cs8xezx0hY,1585710181,–í—ñ–¥—Å–æ—Ç–∫–∏ –∑–∞ –±–µ—Ä–µ–∑–µ–Ω—å,4829,4829,630,630,980,0,0,1669430,True
il8j4V_fzTm1UKBB,1590857771,Glovo,4215,4215,-29300,-29300,980,0,0,1143416,False,E119-BTEB-2HPA-AA3M
qg85xPRcpB0N9OrB,1590842027,KOLO,5499,5499,-24700,-24700,980,0,247,1172716,False,0X6H-HHCT-6H2X-5E08
MzcmF19_-bS6srY-,1590829571,–ü–∏—Ä—ñ–∂–∫–æ–≤–∞ ¬´–¢—ñ—Ç–∫–∞ –ö–ª–∞—Ä–∞¬ª,5814,5814,-33700,-33700,980,0,0,1197416,False,KPTP-7AK3-7K99-C2HT
6hTBmBXAZwBtee9z,1590829539,Bolt,4121,4121,-4400,-4400,980,0,0,1231116,False,29BB-A598-PBM0-XKMM
wLM4T_5pBmyJ5c7J,1590828943,–õ—ñ–∫—É–≤–∞–ª—å–Ω–æ-–¥—ñ–∞–≥–Ω–æ—Å—Ç–∏—á–Ω–∏–π —Ü–µ–Ω—Ç—Ä Adonis,8062,8062,-84500,-84500,980,0,0,1235516,False,2T12-6A7E-TCK4-93ET
A_vaLfytm2w0eCES,1590826519,Bolt,4121,4121,-4500,-4500,980,0,0,1320016,False,6A7A-H6PT-M6BP-0MKB
qTmuergZjbvAmmi7,1590823192,Bolt,4121,4121,-4800,-4800,980,0,0,1324516,False,2M48-78BH-C4CA-C006
rvIDJtXBDOJtCjAx,1590822188,–°–∫–∞—Å—É–≤–∞–Ω–Ω—è. Bolt,4121,4121,4500,4500,980,0,0,1329316,False
F0bboYXao4gnkuUi,1590822139,Bolt,4121,4121,-6000,-6000,980,0,0,1324816,False,M4M1-T035-XBPT-4030
rzPlyCMqV87xa9LO,1590820695,–°–∫–∞—Å—É–≤–∞–Ω–Ω—è. Bolt,4121,4121,4100,4100,980,0,0,1330816,False
2MToTuBKyOBPcQfR,1590820671,Bolt,4121,4121,-4500,-4500,980,0,0,1326716,False
1ha70JzfCiu26Qjz,1590820649,–°–∫–∞—Å—É–≤–∞–Ω–Ω—è. Bolt,4121,4121,4100,4100,980,0,0,1331216,False
heUGKAUObt2uPRqC,1590820632,Bolt,4121,4121,-4100,-4100,980,0,0,1327116,False
utwhnrTBowy6jpWO,1590820487,Bolt,4121,4121,-4100,-4100,980,0,0,1331216,False
VrOFwqsvmDE9v5SB,1590774333,–ü–∏—Ä—ñ–∂–∫–æ–≤–∞ ¬´–¢—ñ—Ç–∫–∞ –ö–ª–∞—Ä–∞¬ª,5814,5814,-18700,-18700,980,0,0,1335316,False,B5H5-E118-2PE6-AHP0
5WTNcZODOhW2FmRF,1590764451,Beer Market,5921,5921,-19482,-19482,980,0,194,1354016,False,HE3X-KM34-KE2P-T1X1
IdUS_jb8VpjK3NlQ,1590694271,"–ö–∏—ó–≤—Å—Ç–∞—Ä
+380978495150",4814,4814,-16000,-16000,980,0,0,1373498,True,8293-H535-PXC2-K50M
OM6c0jFmuhwKxIsn,1590685282,KOLO,5499,5499,-30550,-30550,980,0,305,1389498,False,3T0E-916P-P59X-3M64
uokJZMr0-p-IO5BL,1590666132,KOLO,5499,5499,-16850,-16850,980,0,168,1420048,False,K0TA-XKXE-2BP3-CK1T
Jan3VQIHoZSrWom1,1590664542,"–ö–∏—ó–≤—Å—Ç–∞—Ä
+380978495150",4814,4814,-1000,-1000,980,0,0,1436898,True,E2K8-AB2H-472K-MA59
sIatiuXwcw0LRMFC,1590660221,Uklon,4121,4121,-7100,-7100,980,0,0,1437898,False,A54C-91H6-AX6P-KA6T
TpXsikj9YQNLVHLo,1590656729,Bolt,4121,4121,-5100,-5100,980,0,0,1444998,False,HKPB-52P9-8BX1-8K9M
SNzs3ExylyxGCt0x,1590653142,Bolt,4121,4121,-4900,-4900,980,0,0,1450098,False,0MPA-805E-A166-H9C1
Y6U5CH991Bz1tzZg,1590587805,Bolt,4121,4121,-4000,-4000,980,0,0,1454998,False,2X82-88CM-6671-CM86
_SN8fTQNKesczOPP,1590587712,HlibnaKraina,5814,5814,-1050,-1050,980,0,0,1458998,False,0THT-P258-11EE-3KMH
eTAFNnRAhIxfwblV,1590587514,–°—ñ–ª—å–ø–æ,5411,5411,-15300,-15300,980,0,153,1460048,False,947M-3755-T62A-6TK2
Usys5VThStQ-tPqG,1590587385,–°—ñ–ª—å–ø–æ,5411,5411,-66819,-66819,980,0,668,1475348,False,29A8-H971-47P4-ABM2
B3wUygrWAouP9t6f,1590585027,–ü–∏—Ä—ñ–∂–∫–æ–≤–∞ ¬´–¢—ñ—Ç–∫–∞ –ö–ª–∞—Ä–∞¬ª,5814,5814,-17400,-17400,980,0,0,1542167,False,67PP-7CE2-M1EK-B50X
nPKHUrVac3CmCN5Q,1590580713,Bolt,4121,4121,-4900,-4900,980,0,0,1559567,False,3864-7096-7BP4-P1T1
ZXiu3ak-lwi5w0jfjXbc2Q,1590540083,Bolt,4121,4121,-14400,-14400,980,0,0,1564467,True
CD20kXfcNB9cmrb7Adc_WafDJA,1590540083,–°–∫–∞—Å—É–≤–∞–Ω–Ω—è. Bolt,4121,4121,14100,14100,980,0,0,1578867,False
Xq3wYTQ5SIIJtnQx,1590513844,EKOTOVARY,5411,5411,-9900,-9900,980,0,99,1564767,False,MAK4-P701-BK1M-14T1
5LN4h3nssknOP64l,1590513627,KOLO,5499,5499,-11150,-11150,980,0,111,1574667,False,184H-5E0X-25A0-X1T4
D_cmLqnycclkcpK6,1590486168,WFP.ZOO,5995,5995,-90900,-90900,980,0,0,1585817,False,PM28-C60M-9C50-HPBP
OHmW5o4tgGc-uFAl,1590475464,KOLO,5499,5499,-13300,-13300,980,0,133,1676717,False,6208-EXM8-952X-961A
KCip9xbdrZvMrg4tbpTc,1590454850,Bolt,4121,4121,-11700,-11700,980,0,0,1690017,True
BLXI0s7cKkBowv52L_K0sq0BXQ,1590454850,–°–∫–∞—Å—É–≤–∞–Ω–Ω—è. Bolt,4121,4121,11600,11600,980,0,0,1701717,False
r3aMtEidi-Ocb6SE,1590427291,restoranChChKO1,5812,5812,-52800,-52800,980,0,0,1690117,False,20KH-2T6T-9HK2-3715
xq2_idqI6DQ7SFsc,1590424528,–ê–ø—Ç–µ–∫–∞ –ù–∏–∑—å–∫–∏—Ö –¶—ñ–Ω,5912,5912,-17680,-17680,980,0,0,1742917,False,P7P2-X72K-X36P-TKE4
ff9js9IdqhuAjcg5,1590421645,Bolt,4121,4121,-14100,-14100,980,0,0,1760597,False
crqe0HeQpmUp1EaG,1590421425,–°–∫–∞—Å—É–≤–∞–Ω–Ω—è. Bolt,4121,4121,13700,13700,980,0,0,1774697,False
cjdlaqejKRQvKDTs,1590421230,Bolt,4121,4121,-13700,-13700,980,0,0,1760997,False
QN7gAKL5HmCRJvZy,1590420661,LAKSHERIDOGS,5995,5331,-27700,-27700,980,0,0,1774697,False,5E64-1T86-P7XP-A894
I5t5awAL_rrtkqR_,1590420560,–°–∫–∞—Å—É–≤–∞–Ω–Ω—è. Bolt,4121,4121,13100,13100,980,0,0,1802397,False
jkxze3wlWIWcSlJ6,1590420512,Bolt,4121,4121,-17500,-17500,980,0,0,1789297,False,8C58-053X-B0C5-94X4
mGvC9Y-zkQ3A4aip,1590415547,Bolt,4121,4121,-13100,-13100,980,0,0,1806797,False
NcX2w5S6rG_a4TrF,1590402742,KOLO,5499,5499,-6750,-6750,980,0,67,1819897,False,1MH5-54K9-M65P-9B39
8a8V5-ken4rWyimu,1590401342,Bolt,4121,4121,-8000,-8000,980,0,0,1826647,False,K637-1A0A-05AK-T479
V5HoeWJL2oVTESR1,1590398116,Bolt,4121,4121,-11600,-11600,980,0,0,1834647,False
wMHYODkL4gLTbW-0,1590334252,KOLO,5499,5499,-9200,-9200,980,0,92,1846247,False,XB6T-9KC9-5835-P30E
Bntjxv6_rC6PuS-Q,1590304434,KOLO,5499,5499,-5000,-5000,980,0,50,1855447,False,K5P9-10X4-0X1C-99PX
yz0QKxQzlwkwTI_q,1590242422,Bolt,4121,4121,-7900,-7900,980,0,0,1860447,False,63XH-B068-9X60-HC4B
WNnb1mpp3-29uoAw,1590232238,Bolt,4121,4121,-8100,-8100,980,0,0,1868347,False,C41A-5CT5-9PH7-CBC7
ZMPG0_7tBE6svOac,1590227202,WFP.AQUAMAR.,5499,5499,-94220,-94220,980,0,942,1876447,False,5C2K-AAAM-3XM6-HMKH
7dgfCPkouJH_O3iO,1590219838,KOLO,5499,5499,-5000,-5000,980,0,50,1970667,False,75KE-575A-HMXB-C7PT
AKTGGADB2UWCU8pz,1590137789,Uklon,4121,4121,-8000,-8000,980,0,0,1975667,False,P8P9-1B4C-PXHT-K471
kiGV2jY9s_izCP24,1590047704,KOLO,5499,5499,-15000,-15000,980,0,150,1983667,False,XXT8-E1HC-77HH-5PM5
X_EFD8eO1C3JhsEd,1590046822,portmone.com.ua,4899,4899,-15300,-15300,980,0,0,1998667,False,A453-161H-B2T5-8H0P
VRVe7Uf0LFaASHdJ,1590008765,"Lifecell
+380631692598",4814,4814,-5000,-5000,980,0,0,2013967,True,X452-23CK-43AM-5MXK
RLqMJWmnhpNXlOc4,1589994167,"Lifecell
+380631692598",4814,4814,-10000,-10000,980,0,0,2018967,True,P0MX-BC8K-6KM6-209H
hFVryH8N8LDXpXQz,1589977823,Lesya,4829,4829,-200000,-200000,980,0,0,2028967,True,T9CB-7HHH-E0K3-95KT
tO9JzjTOc-2Jee0l,1589958731,zakaz.ua,7278,7278,-207231,-207231,980,0,0,2228967,False,KCKH-194K-M6E1-B729
NuHs1YGIUD_FMRZ2,1589921845,portmone.com.ua,8999,8999,-35500,-35500,980,0,0,2436198,False,A87B-X2PT-53H7-3BKK
ItvEzycxoeJuZ4ve,1589916661,LIQPAY*FreshMart,5411,5411,-84604,-84604,980,0,1692,2471698,False,P74M-19H7-3M7T-9641
x75n1KM8Hm6e3w6M,1589852973,Netflix,7841,4899,-28873,-999,978,0,0,2556302,False,K45E-BXPP-K1KE-ME58
Sk2vkpNbkJLDddyB,1589821774,–°–∫–∞—Å—É–≤–∞–Ω–Ω—è. Raketa,4215,5814,100,100,980,0,0,2585175,False
-3Hxpoe74D1alfuF,1589821717,Raketa,4215,5814,-25600,-25600,980,0,3840,2585075,False,MA3P-065M-CB7P-9ME0
pHC8Mt1Vs3vrZeA7,1589821697,Raketa,4215,5814,-100,-100,980,0,0,2610675,False
Zsi-ZZkhacXT44Me,1589783584,Bolt,4121,4121,-5000,-5000,980,0,0,2610775,False,BA97-0T94-73MH-8H3C
vA0biQZ_t41IyQwW,1589779564,Bolt,4121,4121,-4800,-4800,980,0,0,2615775,False,6C58-1M0X-20P5-54CP
Q7LtyVtHGtGlqZrJ,1589709810,BeerMarket,5921,5921,-6049,-6049,980,0,120,2620575,False,MTXT-1B9C-PBA0-PHCA
W8sZZroCS2fzIK2X,1589709459,Roshen,5441,5441,-10948,-10948,980,0,218,2626624,False,2P40-20M8-0372-C792
QS4XCe-Ji57mD18A,1589559120,Lesya,4829,4829,-300000,-300000,980,0,0,2637572,True,C1C0-7H36-BTBE-XK7P
5u-0IdkiYKntk0uo,1589537902,Uklon,4121,4121,-7100,-7100,980,0,0,2937572,False,MA12-90TH-APP7-3053
eoHDoDqbqXOPQ2no,1589448622,Lesya,4829,4829,-500000,-500000,980,0,0,2944672,True,1EH4-T4H1-T8TH-XK54
ikdtpWS94-Jneg18,1589448616,–ù–∞ –¥–æ–ª–∞—Ä–æ–≤—É –∫–∞—Ä—Ç–∫—É,4829,4829,-104839,-3900,840,0,0,3444672,True
hYaP03HLaSgahh6n,1589448550,–íi–¥: –ü–†–ò–•–û–î–¨–ö–û –ï.–í. –§–û–ü,4829,4829,1850000,1850000,980,0,0,3549511,True
Ig33WzzhnEAoRcBN,1589399926,LIQPAY*Shine Bright,5977,5977,-108000,-108000,980,0,0,1699511,False,24CH-3XP0-6XKK-4CPB
r5qvJ5-FPreIizmK,1589375185,Bolt,4121,4121,-8200,-8200,980,0,0,1807511,False,T799-CP1C-3P00-60AE
f_24PEotuy8spu7l,1589366804,LIQPAY*Foundation Coff,5411,5411,-53200,-53200,980,0,532,1815711,False,9ME3-KMKE-509X-5BAA
2xrvXZkqrDnGFdMD,1589358248,Pirogitadruzi,5814,5814,-15000,-15000,980,0,0,1868911,False,5177-HKCA-2TTK-X2HA
N3tYvZ-9OmOgOl0j,1589316621,WFP.AQUAMAR.,5499,5499,-86280,-86280,980,0,862,1883911,False,XTM7-CBHK-1134-3P5P
0hFXX_BHGkpkCQSw,1589193707,LIQPAY*Foundation Coff,5411,5411,-25690,-25690,980,0,256,1970191,False,K195-M89X-XTH7-TXXB
GzVX3rQAZMG3vArS,1589113394,LIQPAY*FreshMart,5411,5411,-129400,-129400,980,0,2546,1995881,False,5873-156B-M6XB-0K1C
1eN8QEn-TqZqQNyI,1589113348,–í—ñ–¥: –û–ª–µ—Å—è –°.,4829,4829,160000,160000,980,0,0,2125281,True
NwYpx_muChwN1esJ,1589041317,LIQPAY*TOV BIRKRAFT,5812,5812,-57000,-57000,980,0,0,1965281,False,C620-730A-4A5H-4H3A
idu8zU-W3GRd4_-O,1589016365,LIQPAY*FOP VARShAVSKIJ,5992,5992,-62605,-62605,980,0,3130,2022281,False,87KB-1PK2-41BM-6M3M
udVHZUc4n6Zv7-DE,1589016231,–í—ñ–¥: –û–ª–µ—Å—è –°.,4829,4829,50000,50000,980,0,0,2084886,True
gZj0Tdghfq3Poq4p,1589016053,LIQPAY*FOP VARShAVSKIJ,5992,5992,-65900,-65900,980,0,3295,2034886,False,BE8X-2A8B-943H-5HTH
AqiwgRdZsdNXTIq_,1588877909,Mama-Manana,5812,5812,-55010,-55010,980,0,0,2100786,False,E78M-9X3X-BE57-B678
IGlMncI-oY9mQUCo,1588768905,Lesya,4829,4829,-50000,-50000,980,0,0,2155796,True,CCMA-41KP-98EK-H0B5
yqmSE5fPFdJyG1_O,1588750466,Lesya,4829,4829,-20000,-20000,980,0,0,2205796,True,0MXB-T2C3-BTA2-AKEC
CAEr3yxUQQUYzdop,1588685116,Lesya,4829,4829,-80000,-80000,980,0,0,2225796,True,61B8-8BA0-7A2E-AP4E
D4aqhPAHF3RE3QTl,1588676121,Lesya,4829,4829,-80000,-80000,980,0,0,2305796,True,E19P-X482-PC9C-71E9
9uaQYaZAVCT_swI8,1588588685,zakaz.ua,7278,7278,-200376,-200376,980,0,0,2385796,False,C18M-0063-HBH1-3E5K
pQtu66_ZbOf2utR_,1588582548,Lesya,4829,4829,-50000,-50000,980,0,0,2586172,True,1TMM-HMT3-MMPH-K580
8De5Me4iv_nP2ND7,1588526076,414943****6137,4829,4829,-50000,-50000,980,0,0,2636172,True,7K6M-C8PT-HK9E-E074
ihZWX1gaTppW1yNV,1588519807,WFP.AQUAMAR.,5499,5499,-101020,-101020,980,0,2020,2686172,False,1E7C-9HH2-77KA-X2X5
puIv4GpHCY90RT4U,1588498771,Bolt,4121,4121,-6500,-6500,980,0,0,2787192,False,H90T-38X5-2AMM-3BTA
T27nYh9-Dm96KsTD,1588493271,Bolt,4121,4121,-5900,-5900,980,0,0,2793692,False,H82K-C55K-P4CC-K3K5
ddbAA5CsoweyMEBw,1588447456,Lesya,4829,4829,-100000,-100000,980,0,0,2799592,True,XAEX-2814-1CBH-K0B0
1qwM5RvRj0Ri4twY,1588403469,BeerMarket,5921,5921,-21796,-21796,980,0,435,2899592,False,20E9-BEBE-K38M-HA3H
X-Lr3LB5T7w8GLZK,1588296777,–í—ñ–¥—Å–æ—Ç–∫–∏ –∑–∞ –∫–≤—ñ—Ç–µ–Ω—å,4829,4829,1365,1365,980,0,0,2921388,True
KQpMtypWafWO9o-i,1593449598,MAGAZYN PRODUKTY,5499,5499,-12000,-12000,980,0,0,2208198,False,7M8M-3127-HC4C-5K22
wwUplaUsPAGZcEmY,1593429611,Lesya,4829,4829,-100000,-100000,980,0,0,2220198,True,9BMM-2EAA-74E8-B3K1
t7nJAkKHQoMJvzER,1593414289,–°–∫–∞—Å—É–≤–∞–Ω–Ω—è. Bolt,4121,4121,5100,5100,980,0,-510,2320198,False
Fl-I6uezkcstedG1,1593414272,Bolt,4121,4121,-4600,-4600,980,0,460,2315098,False,6B1H-AEPK-CH5K-HXCT
z4w4rd4pXX-2n6dm,1593414237,Bolt,4121,4121,-5100,-5100,980,0,510,2319698,False
THZMMOfkXRhd0hcV,1593412729,Bolt,4121,4121,-4400,-4400,980,0,440,2324798,False
i1lNu-WTRGaUp4ce,1593375494,makeup.com.ua,5977,5977,-60900,-60900,980,0,0,2329198,False,20HH-K59X-ET6H-KX8B
0zknV6kUTQHpjIRC,1593356345,Loggerhead,5812,5812,-47700,-47700,980,0,1431,2390098,False,K76P-893B-90TP-05K9
cf1aDzWPOtTT_2Gs,1593355111,Beer Market,5921,5921,-13634,-13634,980,0,0,2437798,False,9AC9-B6X7-K50E-EKA0
MLjAIrb5H8_4wldG,1593177612,536354****8807,4829,4829,-43700,-43700,980,0,0,2451432,True,589C-0A53-46E9-1490
8WCKavojpnJ0xcVM,1593086753,MAGAZIN VERShINA 1,5499,5499,-8000,-8000,980,0,0,2495132,False,8144-HHT2-A723-X5C0
R4eGJxFqVbGCqDht,1592985416,MAGAZIN VERShINA 1,5499,5499,-9570,-9570,980,0,0,2503132,False,43H1-CAP6-127M-3P6K
BP2Xzrnd5_ehp-_K,1592985244,Vershina,5921,5921,-3200,-3200,980,0,0,2512702,False,T244-9CK7-82BX-5MCK
B9-35_fhmSScGR-T,1592984977,A110,5912,5912,-17264,-17264,980,0,0,2515902,False,T6H9-PP2B-MXH4-TKM1
2FuOGKeqv4CdtqCc,1592920097,516875****7365,4829,4829,-32400,-32400,980,0,0,2533166,True,X4XC-CX5E-3K56-M004
bNbZenwX1zTDyUhl,1592840211,Ruslana,5499,5499,-4700,-4700,980,0,0,2565566,False,9EA6-KK47-H3KX-MA9M
htbQU5ePUqk-qFwp,1592834820,–†–æ–¥–∏–Ω–Ω–∞ –∫–æ–≤–±–∞—Å–∫–∞,5499,5499,-15990,-15990,980,0,0,2570266,False,8B2T-3XTB-B62C-E54X
5Blz96YtyZShr-kR,1592834393,–ë–∞–Ω–∫–æ–º–∞—Ç DN00 Danyla Halytskoho,6011,6011,-70000,-70000,980,0,0,2586256,False,PPPB-PC9K-3433-EP83
y1zGBVrBN5CNkcew,1592821003,–í–æ–ø–∞–∫,5499,5499,-4044,-4044,980,0,0,2656256,False,5308-A9TH-3X7M-3T44
UmFIa-qBioTeE3g9,1592814885,Delikacia,5812,5812,-40000,-40000,980,0,1200,2660300,False,B52A-0M0M-319A-55X0
zqcOb6EqKSn1d33t,1592767830,–ü—ñ—Ä–æ—Å–º–∞–Ω—ñ / Pirosmani,5812,5812,-24900,-24900,980,0,747,2700300,False,B0T4-1P2B-7H15-43B3
Mar5IR-180cv6EKC,1592767011,Uklon,4121,4121,-4500,-4500,980,0,450,2725200,False,0H48-MM1H-X98A-EK1K
mnUKDULozR3YJPpP,1592665918,–í–µ–ª–∏–∫–∞ –ö–∏—à–µ–Ω—è,5411,5411,-63652,-63652,980,0,0,2729700,False,30XE-6X14-9KPC-KT71
bppkgk7D98IPzHqA,1592588046,KOLO,5499,5499,-5300,-5300,980,0,0,2793352,False,3HBX-1K14-X8X6-P9AA
uFtdEhOORwwa7phs,1592563804,LIQPAY*Restoran Bagato,5812,5812,-37600,-37600,980,0,1128,5298652,False,4A73-83CA-HH8E-EK6E
1nnp6D9NsZ6vVRVZ,1592554221,Coffee Is,5814,5814,-16000,-16000,980,0,480,5336252,False,XK8T-KB1M-7T6B-0B9E
SAhfhUDX2wIaluYu,1592548532,Ljaphabrik,5814,5814,-7600,-7600,980,0,228,5352252,False,3CT2-3TB0-249M-8502
oiJYaDiuhqCXGPYm,1592530804,Netflix,7841,4899,-30270,-999,978,0,0,5359852,False,5BA0-B7K2-6PK4-T03P
Bi9sfLKnzNp1HLgn,1592499688,Glovo,4215,4215,-33100,-33100,980,0,0,5390122,False,MKBE-A5BT-XP78-HC53
x0nM9TSMmlZ_xhWS,1592483722,KOLO,5499,5499,-23100,-23100,980,0,0,5423222,False,M5TH-85B4-EX9M-5P7X
iEbKdyQHYcXLKpnc4iwAAg,1592439943,Bolt,4121,4121,-6200,-6200,980,0,620,2946322,True
GGT_h9CHHMewKJF1h7YOi4mb6Q,1592439943,–°–∫–∞—Å—É–≤–∞–Ω–Ω—è. Bolt,4121,4121,6100,6100,980,0,-610,2952522,False
TU7pbtszHtMhXtAP,1592399694,"Lifecell
+380631692598",4814,4814,-15000,-15000,980,0,0,2946422,True,BMXA-027A-7A3H-4048
UIxnMN2FUog54PnL,1592399663,portmone.com.ua,4816,4816,-17340,-17340,980,0,0,2961422,False,X664-31H0-2AE8-1P75
6Gx64WmTeIfrTY1d,1592329550,KOLO,5499,5499,-20350,-20350,980,0,0,2978762,False,0XHX-75KP-X026-H27X
16XMIYcn3sPHHWyK,1592308777,Bolt,4121,4121,-5900,-5900,980,0,590,2999112,False,220M-XCTT-56B3-141M
ixtV4hwlwIbRuIEL,1592306079,Lesya,4829,4829,-1400000,-1400000,980,0,0,3005012,True,XTKE-XT23-6PHM-K53X
cCdIxbjEL01AIXCw,1592305788,Bolt,4121,4121,-6100,-6100,980,0,610,4405012,False
nEKkdabcJvDZACTD,1592298453,–ù–∞ –¥–æ–ª–∞—Ä–æ–≤—É –∫–∞—Ä—Ç–∫—É,4829,4829,-91398,-3400,840,0,0,4411112,True
TDXZyK0O-6QT4GOu,1592297562,–íi–¥: –ü–†–ò–•–û–î–¨–ö–û –ï.–í. –§–û–ü,4829,4829,3000000,3000000,980,0,0,4502510,True
3AbSZk3_wwFqrlO2,1592295213,PHotovramke,7221,7221,-75500,-75500,980,0,0,1502510,False,06CT-B440-B9HK-CCM7
TAig7yKs1w29C6gR,1592295049,Bolt,4121,4121,-4200,-4200,980,0,42,1578010,False,0HE0-P6PX-M45H-2M2P
O0EhJahgAamSzCAc,1592231437,LIQPAY*Foundation Coff,5411,5411,-37600,-37600,980,0,0,1582210,False,X67P-HK90-K3KP-76X4
y1arqgtQzhOVSvTq,1592216811,–°–∫–∞—Å—É–≤–∞–Ω–Ω—è. Liki24,5912,5912,72900,72900,980,0,0,1619810,False
Ifbu3DSJgU1yBgV5,1592206746,Flower Time,5992,5992,-24500,-24500,980,0,0,1546910,False,CA3H-8MH0-3X4T-MB3E
bmB5zgrt0KMGC2T7,1592154775,KOLO,5499,5499,-24850,-24850,980,0,0,1571410,False,A95B-0E82-KP59-CTXH
BT4ym0eTSMxqIgHV,1592152010,Liki24,5912,5912,-72900,-72900,980,0,0,1596260,False
u2gzkT4MVtyuqeYQ,1592064162,zakaz.ua,7278,7278,-138109,-138109,980,0,0,1669160,False,EMT4-0XK2-HKP8-C169
dYf7p9DrexiRLjwK,1592060821,Loggerhead,5812,5812,-29900,-29900,980,0,299,1807269,False,AP29-X02C-PKK9-C4EK
SZDhrk6eHZAXHHkx,1592052918,Beer Market,5921,5921,-16646,-16646,980,0,0,1837169,False,3102-3HTE-6A7B-EKTA
1HnFIkUtg3DPEDbA,1591976511,–ê–ø—Ç–µ–∫–∞ –ù–∏–∑—å–∫–∏—Ö –¶—ñ–Ω,5912,5912,-22280,-22280,980,0,0,1853815,False,60M4-1396-73P3-H0CK
s6WEzI11dnbvYDDq,1591973846,Bolt,4121,4121,-6000,-6000,980,0,60,1876095,False,7MEA-B9B8-23A9-X3X0
XfiQedRV0NQG_g_3,1591973785,TOV LDTs Adonis,8062,8062,-49000,-49000,980,0,0,1882095,False,8KBA-2340-C0H8-MHXC
vFoe8cPtIbuofjLb,1591970734,Bolt,4121,4121,-7400,-7400,980,0,74,1931095,False,3AB4-6EE2-472P-P7K6
qPKfWVK8SCPVmK1oweWo5w,1591921116,Bolt,4121,4121,-6200,-6200,980,0,62,1938495,True
b0EdC9Md5U2vmKd9lA4xBbVPHg,1591921116,–°–∫–∞—Å—É–≤–∞–Ω–Ω—è. Bolt,4121,4121,5600,5600,980,0,-56,1944695,False
cUX5wCWWTs5dyo8-,1591884472,–ü–∏—Ä—ñ–∂–∫–æ–≤–∞ ¬´–¢—ñ—Ç–∫–∞ –ö–ª–∞—Ä–∞¬ª,5814,5814,-15700,-15700,980,0,157,1939095,False,C9K4-8KE6-4622-9KHH
1DOTEOEwrfTkBw3Z,1591881663,–°–∏–≥–∞—Ä–Ω—ã–π –¥–æ–º ¬´–§–æ—Ä—Ç—É–Ω–∞¬ª,5993,5993,-21200,-21200,980,0,0,1954795,False,71P6-E015-31X6-PH8X
hBebjmXusyViz8uI,1591793123,Bolt,4121,4121,-5600,-5600,980,0,56,1975995,False
iYx9a-NhI7zibrwT,1591715477,Bolt,4121,4121,-7100,-7100,980,0,71,1981595,False,1576-3AB5-256X-P6PX
AoUETMw1Sec1fO7l,1591711556,Bolt,4121,4121,-7500,-7500,980,0,75,1988695,False,MM1E-77M6-0A88-7MH2
MKGocUatz_p--u5B,1591708564,Barbershop Daboroda,7230,7230,-50000,-50000,980,0,0,1996195,False,37E5-25PP-38B8-492E
CNlGyHMS5FnFJcYA,1591696300,Bolt,4121,4121,-5400,-5400,980,0,540,2046195,False,B99B-0H47-6XH6-7252
MT-TcnOBs_kLpEHC,1591693167,KOLO,5499,5499,-20500,-20500,980,0,0,2051595,False,4CCB-553P-C51E-TTH7
KcASpKiq3oliHIRc,1591691646,Bolt,4121,4121,-5100,-5100,980,0,510,2072095,False,2KCP-40B1-2PCB-70K0
wWBBoBUEx_JByb22qTcJwg,1591660378,–°–∫–∞—Å—É–≤–∞–Ω–Ω—è. Bolt,4121,4121,4500,4500,980,0,-450,2072695,True
8HekdjatgqONtLgYLJF2Hw,1591660378,–°–∫–∞—Å—É–≤–∞–Ω–Ω—è. Bolt,4121,4121,4500,4500,980,0,-450,2077195,True
gT16LFvtyIRClKaO,1591611795,BWTC,5814,5814,-14000,-14000,980,0,420,2068195,False,B689-891H-94B9-6EBM
jNPtBXjnewpTpp_1,1591610944,MAGAZYN PRODUKTY,5499,5499,-5050,-5050,980,0,0,2082195,False,54H5-28X6-4CKE-M517
_aaz-yZQAZXo-yb3,1591609787,–ò–≥—Ä–æ–º–∞–≥,5733,4215,-99600,-99600,980,0,0,2087245,False,1416-4K05-PAPT-X9P4
kKy1L51yQo2uWIZI,1591555125,SPDZABOLEVSERGEJ1,5812,5812,-32000,-32000,980,0,960,2186845,False,62C5-A9PP-B2T0-B9C9
_o9iO96Tg_ElAb2b,1591553908,BWTC,5814,5814,-7500,-7500,980,0,225,2218845,False,1X3H-MM3M-CT1T-KEEC
J94YanzeqLk_b4Jm,1591552808,Beer Market,5921,5921,-10600,-10600,980,0,0,2226345,False,0TTX-812B-9CTH-K136
zVBooagnHco0dPG9,1591552643,–§–∞—Ä–º–∞—Ü—ñ—è,5912,5912,-1440,-1440,980,0,0,2236945,False,EMTK-HKBB-KX8P-PTBE
4dSCoS7-jyHG_mEa,1591523428,"–ë–∞–Ω–∫–æ–º–∞—Ç 11B,BULVARNO-KUDRIAVSK",6011,6011,-50000,-50000,980,0,0,2238385,False,8H8B-BHP9-P445-H075
SrJlgRTzixg-GGfh,1591522279,–°–∫–∞—Å—É–≤–∞–Ω–Ω—è. Bolt,4121,4121,5600,10100,980,0,-560,2288385,False
uxmaDp_4kf3OIlaW,1591520678,Bolt,4121,4121,-10000,-10000,980,0,1000,2282785,False,7CEH-HA3B-XH34-45BE
w1h0CJSgJDGuR2_I,1591520592,Bolt,4121,4121,-10100,-10100,980,0,1010,2292785,False
btqUJTMpk0Uv1K7x,1591520540,–°–∫–∞—Å—É–≤–∞–Ω–Ω—è. Bolt,4121,4121,10100,10100,980,0,-1010,2302885,False
1YLrH6qhXUGLZ3pD,1591520383,FOPMilovanovKIAVET,742,742,-149200,-149200,980,0,0,2292785,False,X033-TC6E-672C-K6T1
l7KZvVkOAWAqb5jq,1591520324,Bolt,4121,4121,-10100,-10100,980,0,1010,2441985,False
afv2LmoKi3kB4a1V,1591516145,Bolt,4121,4121,-10100,-10100,980,0,1010,2452085,False,A36X-0PPM-C49A-E5M6
zJ68CzLaBUhJISSf,1591516140,–°–∫–∞—Å—É–≤–∞–Ω–Ω—è. Bolt,4121,4121,5500,10000,980,0,-550,2462185,False
m8WpfGeXtvPePSSH,1591515633,Bolt,4121,4121,-10000,-10000,980,0,1000,2456685,False
hK_RLMUu0cgwX0nM,1591509688,KOLO,5499,5499,-13600,-13600,980,0,0,2466685,False,21HB-6HMX-EM9B-4XHM
bZX258Bd0XQAxS07,1591441385,Glovo,4215,4215,-48900,-48900,980,0,0,2480285,False,0KKC-E966-K7C2-P0C9
eI9hvfvZWWA2598L,1591371364,KOLO,5499,5499,-27250,-27250,980,0,0,2529185,False,63B6-HMBT-E26H-8C65
fOwrHWq-sfNRHEHR,1591193450,–ù–∞ –¥–æ–ª–∞—Ä–æ–≤—É –∫–∞—Ä—Ç–∫—É,4829,4829,-34945,-1300,840,0,0,2556435,True
fEjty_VvHjhqYD9r,1591174714,Lesya,4829,4829,-800000,-800000,980,0,0,2591380,True,0HEP-82B0-PC9B-8C34
yBJ-ErqX7aJ8fobW,1591174639,–íi–¥: –ü–†–ò–•–û–î–¨–ö–û –ï.–í. –§–û–ü,4829,4829,1200000,1200000,980,0,0,3391380,True
IUhYl70QUbF6HfGH,1591174206,Lesya,4829,4829,-7000,-7000,980,0,0,2191380,True,CX8A-0XH1-9BBH-HE70
hydogZjfex4BUoEW,1591107850,–°–∫–∞—Å—É–≤–∞–Ω–Ω—è. Bolt,4121,4121,500,7700,980,0,-50,2198380,False
nNdPIKT-bA7yD1_X,1591106247,Bolt,4121,4121,-7700,-7700,980,0,770,2197880,False
LHA806mYhKp-5lPe,1591104487,Lesya,4829,4829,-50000,-50000,980,0,0,2205580,True,CB2B-K2T5-B9KK-8T46
6VQLxbWX_ttXnwdh,1591100978,Bolt,4121,4121,-7500,-7500,980,0,750,2255580,False,2A56-X44M-E9K8-PM13
k6uuOGebUr0dLg3r,1591096869,Lesya,4829,4829,-400000,-400000,980,0,0,2263080,True,HA4T-2KAX-6H58-87BP
M6G3dWdV5SQYoKFB,1591017014,Lesya,4829,4829,-600000,-600000,980,0,0,2663080,True,1B45-E219-1B18-ACEK
a0S1cNRSbp0Rh2LT,1591008245,–ù–∞ –¥–æ–ª–∞—Ä–æ–≤—É –∫–∞—Ä—Ç–∫—É,4829,4829,-115904,-4300,840,0,0,3263080,True
-DD4owDTtp_4V8BX,1591005112,–íi–¥: –ü–†–ò–•–û–î–¨–ö–û –ï.–í. –§–û–ü,4829,4829,2600000,2600000,980,0,0,3378984,True
UqCaj7JuyYWdh7eY,1591002823,LIQPAY*Ovocheva kultur,4215,4215,-90200,-90200,980,0,0,778984,False,5B2P-P9AA-KT2T-AH6C
ZXu8JEf28DMxD1Vc,1591002706,zakaz.ua,7278,7278,-157473,-157473,980,0,0,869184,False,27M0-797X-8965-HC59
xQSQNH26T1wGRFTL,1590999572,Foodmarket –Ø–±–ª—É—á–∫–æ,5499,5499,-10600,-10600,980,0,0,1026657,False,P206-AP94-KA20-BA3K
HPuYLALWU2QLYg4z,1590978711,–í—ñ–¥—Å–æ—Ç–∫–∏ –∑–∞ —Ç—Ä–∞–≤–µ–Ω—å,4829,4829,1381,1381,980,0,0,1037257,True
tTlZbIwKzA8V2GmG,1596136228,MAGAZYN DAY AND DAY,5499,5499,-34523,-34523,980,0,0,1062663,False,1A06-9C2A-KME0-EC73
KRFIfOIEDqv6XVax,1596116263,Bolt,4121,4121,-6000,-6000,980,0,0,1097186,False,4M6E-8E6K-7PA4-60AC
VgZgNkVno_AdjWFQ,1596106415,–Ü–≤–∞–Ω –î.,—Ä–∞–º–µ–Ω üçú,4829,4829,-17160,-17160,980,660,0,1103186,True,5M8C-3850-518H-5B05
sk5TVWPkdPu8BSxa,1596099547,Bolt,4121,4121,-7800,-7800,980,0,0,1120346,False,256E-6564-6697-3HXE
_YXuphgj39SCqrGt,1596094263,"–Ø—Ä–æ—Å–ª–∞–≤—ñ–≤ –í–∞–ª, 19",5499,5499,-10600,-10600,980,0,0,1128146,False,9936-659K-T34H-4T5H
l1onvPPdwpxLMhWX,1596086532,Bolt,4121,4121,-8000,-8000,980,0,0,1138746,False
ZcxAi-wKmfIZlgrL,1596042997,Glovo,4215,4215,-28800,-28800,980,0,0,1146746,False,E882-8EEH-B6EM-B9X2
gT-UZSWMKb20RYpw,1596041969,Roshen,5441,5441,-18669,-18669,980,0,0,1175546,False,26XK-518M-HM7A-37B5
0IpIzES7m0quEj2P,1596041652,–ê–ø—Ç–µ–∫–∞ –î–æ–±—Ä–æ–≥–æ –î–Ω—è,5912,5912,-4326,-4326,980,0,0,1194215,False,1E2A-CM2B-27XC-H297
9960Jxj2PFdiYRer,1596024978,–ß—ñ—á—ñ–∫–æ,5812,5812,-14000,-14000,980,0,0,1198541,False,ETT7-72EM-8A06-2684
mphHZDWUO9QxQlAE,1596024950,restoranChChKO1,5812,5812,-43802,-43802,980,0,0,1212541,False,7TE7-04CB-K03A-620A
bAz7ieIbu1qULgII,1596001487,MAGAZYN DAY AND DAY,5499,5499,-10600,-10600,980,0,0,1256343,False,AT3T-92BB-CHMH-A7H5
PohQbBGOHifwlzwuTxz7,1595982110,Bolt,4121,4121,-5700,-5700,980,0,0,1266943,True
00jbBzf02fk_J3Im8cMo1MBbpw,1595982110,–°–∫–∞—Å—É–≤–∞–Ω–Ω—è. Bolt,4121,4121,5600,5600,980,0,0,1272643,False
s8gT6yuBhdylZXST,1595959183,MAGAZYN DAY AND DAY,5499,5499,-31214,-31214,980,0,0,1267043,False,8H31-BMT0-2ATE-HPC4
Y2e-vZVRp8y7lFOZ,1595937236,Harms,5814,5814,-5700,-5700,980,0,0,1298257,False,A863-7959-XXP5-06E1
i1XVmycymOF60qAq,1595937211,Harms,5814,5814,-4560,-4560,980,0,0,1303957,False,0P35-5CP7-A92E-1T46
5VLYeOgyEzDMJVP4,1595936055,STEYKHAUS,5814,5814,-16500,-16500,980,0,0,1308517,False,50M3-0PXT-72HH-K82C
cFtUyxjoISk1lhAx,1595934418,–ö–Ω–∏–≥–∞—Ä–Ω—è –Ñ,5192,5192,-36100,-36100,980,0,0,1325017,False,T1TT-2253-6BCX-4TAP
GkRNq37SPTS3KT4y,1595930687,tsentrklinicheskojpsih,8999,8999,-80000,-80000,980,0,0,1361117,False,22BE-94KT-P46A-40BK
Bbegm-7nI7Z8ThTA,1595926768,RESTAURANT FILADELFIYA,5812,5812,-25000,-25000,980,0,0,1441117,False,796C-40ET-M73X-9XX6
6Qaw-RHJT17uAnDe,1595921688,Bolt,4121,4121,-5600,-5600,980,0,0,1466117,False
OXl7G9FZkoQMiWyQ,1595871754,MAGAZYN DAY AND DAY,5499,5499,-15050,-15050,980,0,0,1471717,False,A16H-H3EA-M662-C7XP
e_Ou99XBjFroTuNb,1595869708,–ü–∏—Ä—ñ–∂–∫–æ–≤–∞ ¬´–¢—ñ—Ç–∫–∞ –ö–ª–∞—Ä–∞¬ª,5814,5814,-21500,-21500,980,0,0,1486767,False,3HAK-T86X-357P-3P77
sgeSTkHzj93lOaRt,1595846679,STEYKHAUS,5814,5814,-15000,-15000,980,0,0,1508267,False,1TE5-P845-297T-HMA9
As-0L0eDWnV36FfY,1595829855,"–ö–∏—ó–≤—Å—Ç–∞—Ä
+380962159945",4814,4814,-10000,-10000,980,0,0,1523267,True,3HE1-0137-9B8X-8906
8NpdQkabllAZm2KE,1595766355,MAGAZYN DAY AND DAY,5499,5499,-26550,-26550,980,0,0,1533267,False,37TE-8PK0-9T6M-K772
ihLksc9_I17TKjK_,1595763640,ORANGUTAN,5814,5814,-34500,-34500,980,0,0,1559817,False,567P-X08C-06H1-A44C
NrfRaEMyq6mJY2ev,1595688174,Bolt,4121,4121,-9500,-9500,980,0,0,1594317,False,PB90-97TA-H851-9X1C
NK0FrE9cAZaWTXmP,1595687431,TELEMART,5045,5045,-29900,-29900,980,0,0,1603817,False,PBMC-X5E2-T82T-K2H7
324qxa1_2kW0ybhz,1595686427,ITIS Flowers Cafe,5814,5814,-6200,-6200,980,0,0,1633717,False,1PAE-8E7A-XPK2-4802
xpi_FWSs9VVzUWPA,1595685761,ITIS Flowers Cafe,5814,5814,-12100,-12100,980,0,0,1639917,False,3P6P-P16M-58EB-4MBA
5ob25IcG8mEfwyjS,1595684359,–°–∫–∞—Å—É–≤–∞–Ω–Ω—è. Bolt,4121,4121,6200,6200,980,0,0,1652017,False
MFcRSoFSFY5tFpzK,1595684313,Bolt,4121,4121,-7800,-7800,980,0,0,1645817,False,E769-7671-7B95-EPEC
XcOG0VcJ8OHNl3Mi,1595684240,Bolt,4121,4121,-8200,-8200,980,0,0,1653617,False,M1CA-BM18-4XTE-900M
iJko8hUd0sv-kig4,1595683878,Brain,5722,5045,-69900,-69900,980,0,0,1661817,False,T3T1-KHH7-1HX4-98X6
_KrAYFh2DauR9eMj,1595682014,Bolt,4121,4121,-6200,-6200,980,0,0,1731717,False
5pf7MV577SAKGKCT,1595668488,Pethouse,5995,5995,-46900,-46900,980,0,469,1737917,False,P310-T1E7-B520-EMPC
lP9as6wWHyq9uD5q,1595664307,MAGAZYN DAY AND DAY,5499,5499,-36450,-36450,980,0,0,1784817,False,K06T-TX4C-6745-924C
VlFA89TNmR1bnUu_,1595622413,–í—ñ–¥: –ö–æ—Å—Ç—è–Ω—Ç–∏–Ω –ê.,üç∫,4829,4829,40000,40000,980,0,0,1821267,True
NyNHqLCsP_M53duZ,1595622409,–í—ñ–¥: –ö–æ—Å—Ç—è–Ω—Ç–∏–Ω –ü.,4829,4829,51200,51200,980,0,0,1781267,True
Qzas6QgLTtiWAcLC,1595622041,OldBricks1,5814,5814,-174500,-174500,980,0,0,1730067,False,H8KH-AKC8-993B-C4HP
FaxkdroPr97Nq4rN,1595611995,"–Ø—Ä–æ—Å–ª–∞–≤—ñ–≤ –í–∞–ª, 19",5499,5499,-13000,-13000,980,0,0,1904567,False,55XM-5C38-CPP1-3CPX
KS7zIjmL9p3yEiU-,1595578726,Bolt,4121,4121,-6200,-6200,980,0,0,1917567,False,BBK0-CA7C-KKHK-T3B0
sICtOrPy_vAen3Tc,1595575006,Bolt,4121,4121,-5700,-5700,980,0,0,1923767,False,T27B-0E2H-02A9-20P0
6LZRrqZaybhgsey1,1595524569,MAGAZYN DAY AND DAY,5499,5499,-23350,-23350,980,0,0,1929467,False,09AM-HCC3-AM4H-M9H9
z5M2bJYa6hH0_J3L,1595518855,–ê–ø—Ç–µ–∫–∞ –î–æ–±—Ä–æ–≥–æ –î–Ω—è,5912,5912,-1150,-1150,980,0,0,1952817,False,HC8X-2AP6-83M2-AE74
JEHqevocJrTCxsRl,1595505388,MAGAZYN DAY AND DAY,5499,5499,-36645,-36645,980,0,0,1953967,False,ACKH-95XH-HAP3-3442
riUFQpNMxtONx1M2,1595438455,–°–∫–∞—Å—É–≤–∞–Ω–Ω—è. Raketa,4215,5814,100,100,980,0,0,1990612,False
M6ViqRcNE61pKo1G,1595438430,Raketa,4215,5814,-34200,-34200,980,0,5130,1990512,False,XE3K-649A-CH05-A5H4
8eyNa6-d9A1kxasV,1595438412,Raketa,4215,5814,-100,-100,980,0,0,2024712,False
fqbvioUj_zp8MKRz,1595438181,–í—ñ–¥: 516798****8598,4829,4829,50000,50000,980,0,0,2024812,True
fMsEnAVe8oTv8VQg,1595407881,WFP.AQUAMAR.,5499,5499,-25920,-25920,980,0,0,1974812,False,2719-P2X5-C820-T805
kmIr3Zf8iNIPaSES,1595245473,"Lifecell
+380631692598",4814,4814,-9500,-9500,980,0,0,2000732,True,6632-XE89-8CEH-EX6T
PHHe8ByAGLQ1683j,1595235505,Bolt,4121,4121,-5400,-5400,980,0,0,2010232,False,7XBK-H56M-2HA1-7C7P
Ez4DCTDNcL2Lg8y0,1595235385,Roshen,5441,5441,-24087,-24087,980,0,0,2015632,False,A6KC-M308-HEP3-9KPX
lrgtaXeGzQ5d38fL,1595232193,Bolt,4121,4121,-4600,-4600,980,0,0,2039719,False,656M-E6BP-098C-A8X9
VOFFDepaoUrYbofb,1595186680,535528****6317,4829,4829,-23400,-23400,980,0,0,2044319,True,CK08-MX4X-A1T2-CK54
Oc8j4tmmuc_pGBBw,1595171780,italistproseccobar1,5814,5814,-9000,-9000,980,0,0,2067719,False,XA07-9AE8-P2B6-H5HK
gd_8gpz_KdE-oyUM,1595153899,MAGAZYN DAY AND DAY,5499,5499,-27186,-27186,980,0,0,2076719,False,P23H-H4BX-2467-701B
hODi1UMR0luRsvy2,1595150266,Bolt,4121,4121,-6800,-6800,980,0,0,2103905,False,KT92-7X50-MC3T-9627
LM_nR75T249B1MpN,1595142601,Bolt,4121,4121,-8300,-8300,980,0,0,2110705,False,1B48-085H-TX6A-X12K
T14h38P0a52iC5jO,1595140158,Lesya,4829,4829,-100000,-100000,980,0,0,2119005,True,2EE9-2470-P4CH-436M
Bna4yx6Skp1RhIRX,1595140017,Bolt,4121,4121,-4800,-4800,980,0,0,2219005,False,ETA5-E2XB-A927-P54P
YxPVjcYeR62jt8xL,1595123398,Netflix,7841,4899,-31414,-999,978,0,0,2223805,False,2C06-7M7X-0MXT-APK5
MLXY_EAmdKm2whCS,1595089132,Lesya,4829,4829,-50000,-50000,980,0,0,2255219,True,075A-PP3T-9282-HP0C
BX_j3Dsa938ULnO7,1595079536,Barbershop Daboroda,7230,7230,-50000,-50000,980,0,0,2305219,False,3BMC-H5B1-EMXC-3AEA
pdqZh2z87lInZApa,1595064511,–ò–≥—Ä–æ–º–∞–≥,5733,4215,-74600,-74600,980,0,0,2355219,False,TATT-947B-39EK-6KP1
OKUfnPHbFW-Uo_ln,1595006881,APTEKA_______7,5912,5912,-13300,-13300,980,0,0,2429819,False,4PTH-HE6X-PCH1-HCM8
o2c0buVlMHHNM2tC,1594981976,Lesya,4829,4829,-50000,-50000,980,0,0,2443119,True,E986-CHBK-9A17-C364
oBt0U8HV5iUyXWxz,1594934295,–ê–ª–µ–∫—Å–µ–π –í—ã–∫–∞–ª—é–∫ BCD,4829,4829,-30000,-30000,980,0,0,2493119,True,C0X3-K2TH-B739-HM9A
xPNWCP2TmzC5VOiX,1594896510,MAGAZYN DAY AND DAY,5499,5499,-40850,-40850,980,0,0,2523119,False,5M7X-AB4H-XT75-531T
8V0Bh8dhQfB6QS-A,1594895355,OkvajnSichovih,5399,5399,-45130,-45130,980,0,0,2563969,False,M84C-M58E-1C96-316K
tmBs1rhqzdB1IFmv,1594893234,Pethouse,5995,5995,-59000,-59000,980,0,11800,2609099,False,72A8-PKMA-K62K-XA2H
D9PwMZxz51Gc7WVZ,1594847218,Bolt,4121,4121,-6600,-6600,980,0,0,2668099,False,KM1A-EE40-3529-40X8
vVI3yJ0L7u0DE3Vh,1594844132,–ì—Ä–∞–¥—É—Å,5814,5814,-7800,-7800,980,0,0,2674699,False,P18A-2898-HAHB-9484
OiwKHV_kymbqasTj,1594842153,–ì—Ä–∞–¥—É—Å,5814,5814,-7800,-7800,980,0,0,2682499,False,6ECX-6A48-H82E-8769
B298x-GoYCVK1wz2,1594842135,–í—ñ–¥: –ú–∞–∫—Å–∏–º –ú.,4829,4829,15300,15300,980,0,0,2690299,True
hlLSOcFGqahATfuk,1594840346,Glovo,4215,4215,-35600,-35600,980,0,0,2674999,False,MAB6-506P-6EB1-BTHK
1rD3FEhHjKi7K4z2,1594831677,Bukitorija,5814,5814,-6000,-6000,980,0,0,2710599,False,1B7X-4XCA-48B9-E767
kDrDciaqycDy5YPj,1594831092,"–Ø—Ä–æ—Å–ª–∞–≤—ñ–≤ –í–∞–ª, 19",5499,5499,-10600,-10600,980,0,0,2716599,False,4B1P-508B-C5E3-1C1B
4QINXsGdS5ckANKl,1594823113,MAGAZYN DAY AND DAY,5499,5499,-4150,-4150,980,0,0,2727199,False,6A4X-E5CT-1E3K-HXB0
hB6U3Un9sURGb1jp,1594743722,–°–∫–∞—Å—É–≤–∞–Ω–Ω—è. Bolt,4121,4121,5000,5000,980,0,0,2731349,False
zh1PUGKXY4YkNULE,1594743673,Bolt,4121,4121,-6300,-6300,980,0,0,2726349,False,8TM2-K37P-36KX-T7P5
xuPNR32MSZTwxJja,1594742080,Bolt,4121,4121,-5000,-5000,980,0,0,2732649,False
9aeIAjXEuGjfVPkX,1594738273,Lesya,4829,4829,-100000,-100000,980,0,0,2737649,True,PAH9-4H7K-0PT4-5387
NkCVvte3_BI7P3oc,1594714912,LIQPAY*TOV BIRKRAFT,5812,5812,-54800,-54800,980,0,0,2837649,False,0APX-6BE9-B49A-AC81
jleJ4D12AXZVNomR,1594711885,LIQPAY*TOV TEHNOLAJN T,5732,5732,-53000,-53000,980,0,0,2892449,False,PC3P-761P-1110-HP6T
VAqvcsp74Q1V9iVS,1594711538,portmone.com.ua,4816,4816,-17340,-17340,980,0,0,2945449,False,C8P3-CHC2-E3X4-9T54
Tfb7d6HBnCU7f_f1,1594660854,–í–∏–≤–µ–¥–µ–Ω–Ω—è –∫–µ—à–±–µ–∫—É 777.57‚Ç¥,4829,4829,62593,62593,980,0,0,2962789,True
XYXjXekorDj4RCcM,1594660122,–î–∂–∞–≤—ñ–¥–∞–Ω –ê.,4829,4829,-27800,-27800,980,0,0,2900196,True,A5T4-7EAA-4674-KM0E
yElD41zD3bWULUH6,1594635029,Lesya,4829,4829,-1000000,-1000000,980,0,0,2927996,True,TE71-TCTX-CE1H-9TP2
twm34UtMk2HULEia,1594633552,–ù–∞ –¥–æ–ª–∞—Ä–æ–≤—É –∫–∞—Ä—Ç–∫—É,4829,4829,-35422,-1300,840,0,0,3927996,True
g_lB42L2mcgufkBf,1594631998,–û–∫—Å–∞–Ω–∞ –ü.,4829,4829,-1300000,-1300000,980,0,0,3963418,True,84AH-EX43-6TEP-CB9C
7Xw3trYXmnt70Jwr,1594631772,–íi–¥: –ü–†–ò–•–û–î–¨–ö–û –ï.–í. –§–û–ü,4829,4829,3500000,3500000,980,0,0,5263418,True
B_Vemv6qNK0I0zXh,1594626739,Watsons,5977,5977,-3290,-3290,980,0,0,1763418,False,K8C8-299B-7C9K-8T2K
s6u_P4kPeznqm2PY,1594626578,zakaz.ua,7278,7278,-145634,-145634,980,0,0,1766708,False,A1TA-P3CT-1138-259A
g3yaMYbke0oK74jO,1594622030,Roshen,5441,5441,-8033,-8033,980,0,0,1912342,False,XAB6-629P-0K54-3P03
3ScHjDn_VnVe51hW,1594541378,MAGAZYN PRODUKTY,5499,5499,-8600,-8600,980,0,0,1920375,False,7EX0-PK7M-P20B-464T
X2QoocV_HgBFRUXH,1594541219,MAGAZYN PRODUKTY,5499,5499,-13300,-13300,980,0,0,1928975,False,C2X1-XK68-K5B5-XXKC
gx0iI6Il58DIpcpX,1594408537,KOLO,5499,5499,-21500,-21500,980,0,0,1942275,False,52PT-7H6H-H56H-7M8M
TeW7fc_r3zdi-nVU,1594371571,Bolt,4121,4121,-14400,-14400,980,0,0,1963775,False,4H8P-PT95-C485-2T3C
kjW9tW1OZzxdPeHO,1594366633,Flower Time,5992,5992,-55000,-55000,980,0,0,1978175,False,X5B7-XP9T-3EEA-9M4M
CZIFSHCbyHMfvEVg,1594284172,Pethouse,5995,5995,-107400,-107400,980,0,21480,2033175,False,K79P-T559-0EX3-TMA7
_AJBBLnLJLWbQd2U,1594284109,–í—ñ–¥: –û–ª–µ—Å—è –°.,4829,4829,350000,350000,980,0,0,2140575,True
StzZpgp6VOpKK2ZO,1594243516,APTEKA7,5912,5912,-3710,-3710,980,0,0,1790575,False,PAKP-M6P9-01AK-85C7
CN6TDAxubLvVA04W,1594240499,–ë–æ–≥–¥–∞–Ω –ë,4829,4829,-72800,-72800,980,2800,0,1794285,True,716C-KBT1-81A2-C7XK
_vDTyEerBgCFdqfX,1594239722,OldBricks1,5814,5814,-63200,-63200,980,0,0,1867085,False,1EE2-PCX3-14XP-5E98
N7rUkQNXM0K-Hxd3,1594226681,PROSTOR 2101,5977,5977,-9450,-9450,980,0,0,1930285,False,16KE-51TP-743P-ATT0
tj1t6qZtl--TCMQU,1594213262,"–Ø—Ä–æ—Å–ª–∞–≤—ñ–≤ –í–∞–ª, 19",5499,5499,-19100,-19100,980,0,0,1939735,False,24H1-CPX2-4XX4-6MPA
3VXdbyUNdnZntaqS,1594207621,Glovo,4215,4215,-39900,-39900,980,0,0,1958835,False,AX05-1M26-AT10-6TC5
HxKhx4QCZroJFhy9,1594144929,WFP.AQUAMAR.,5499,5499,-47120,-47120,980,0,0,1998735,False,8KAB-HEXX-H469-HT3A
wpPaWhKDByKfOdNT,1594144449,410232****2408,4829,4829,-60000,-60000,980,0,0,2045855,True,E2HB-K33K-22HB-B7XB
Jwcr-9VpjeG3IbQj,1594106447,Bolt,4121,4121,-8600,-8600,980,0,0,2105855,False,X6B5-EEAM-4K1X-0K72
wDrRyBeE_cpnsUC8,1594105073,CoffeeART,5814,5814,-5000,-5000,980,0,0,2114455,False,750T-2XX0-0311-11T1
cvSmcLWMwBHS-qcr,1594099554,Bolt,4121,4121,-5000,-5000,980,0,0,2119455,False,EC77-CHB4-C11M-0PP4
mGoKD4mnfup5JEemWdwYOuw,1594081465,Bolt,4121,4121,-4400,-4400,980,0,0,2124455,True
D2L2aOSppj92bKsDk2O8phXQWg,1594081465,–°–∫–∞—Å—É–≤–∞–Ω–Ω—è. Bolt,4121,4121,4000,4000,980,0,0,2128855,False
mWA4oSfnkBfgH4gI,1594033007,Lesya,4829,4829,-50000,-50000,980,0,0,2124855,True,0T8K-1T6K-MT99-75CE
AZVIaQuurQL9WwA8,1594030834,KOLO,5499,5499,-39100,-39100,980,0,0,2174855,False,BT36-4C9B-5K28-25KM
N5Sgl68S9eVij5yb,1594024697,CafeBoutique,5399,5399,-47700,-47700,980,0,0,2213955,False,2037-CBA1-TB26-BE9X
sUB-RRjxuMFDl20D,1593958604,Bolt,4121,4121,-4000,-4000,980,0,0,2261655,False
Epvu-khjiROmGpCM,1593958099,–°–∫–∞—Å—É–≤–∞–Ω–Ω—è. Bolt,4121,4121,1900,5600,980,0,0,2265655,False
2Crg6jjILUNZMDHS,1593956463,Bolt,4121,4121,-5600,-5600,980,0,0,2263755,False
eiLLQn-IR4BMpMDM,1593955952,LIQPAY*Madheads Coffee,5411,5411,-24000,-24000,980,0,0,2269355,False,A6HH-A8KE-9813-2P61
_wq5Xsevlq6cx2zv,1593955839,LIQPAY*ChP Bezruk P.M,5411,5411,-52900,-52900,980,0,0,2293355,False,XT7H-H94C-0TA1-HPHE
mxhnlRorbB03v5Zp,1593936764,–íi–¥: –û–ª–µ—Å—è –°.,4829,4829,500,500,980,0,0,2346255,True
t6EaRHlzYOgAg4I0,1593936702,–û–ª–µ—Å—è –°.,4829,4829,-750,-750,980,0,0,2345755,True
f0TI_14DG-dHenN5,1593859729,Lesya,4829,4829,-100000,-100000,980,0,0,2346505,True,TPA0-5896-3A3H-E8AT
kgmlDiQyOpIfyJDH,1593854732,Beer Market,5921,5921,-31787,-31787,980,0,0,2446505,False,3496-P7MK-K18X-94HB
RJILBvkLo4s6Hh0Fs-G4,1593822351,Bolt,4121,4121,-4900,-4900,980,0,0,2478292,True
uZH9SpCUTOeaMPHKGJAS8A,1593822351,Bolt,4121,4121,-4100,-4100,980,0,0,2483192,True
2hwvvab8gb1dfKEGs25S_2PMlQ,1593822351,–°–∫–∞—Å—É–≤–∞–Ω–Ω—è. Bolt,4121,4121,4400,4400,980,0,0,2487292,False
Y_HruA4DeZhWNhnVW5m3SyP4Sw,1593822351,–°–∫–∞—Å—É–≤–∞–Ω–Ω—è. Bolt,4121,4121,4000,4000,980,0,0,2482892,False
Tg9POIHOcwGdJA6j,1593770976,Lesya,4829,4829,-50000,-50000,980,0,0,2478892,True,ECKT-0E43-76AH-956T
D2kGBoXEmK-5Y3kp,1593769437,Bolt,4121,4121,-4500,-4500,980,0,0,2528892,False,P6E3-3AA9-655X-217P
mqlLav9OiWJwga2_,1593766478,Bolt,4121,4121,-4400,-4400,980,0,0,2533392,False
t-MX9vRhM45x0OJz,1593690132,Bolt,4121,4121,-4000,-4000,980,0,0,2537792,False
EJXHe7xVTGXguvBN,1593677206,Lesya,4829,4829,-200000,-200000,980,0,0,2541792,True,E9E2-8851-3B6C-XTPE
0e0b3UJsFMoJJl2w,1593634892,OldBricks1,5814,5814,-61000,-61000,980,0,0,2741792,False,9087-K03T-EHP6-7642
rzi6AsrQol9me-OL,1593620991,–ë–∞–Ω–∫–æ–º–∞—Ç –ü—Ä–∏–≤–∞—Ç–ë–∞–Ω–∫,6011,6011,-100000,-100000,980,0,0,2802792,False,B1KT-M6AM-8X41-5KCB
A8pw462edIFjsVSI,1593620936,–ë–∞–Ω–∫–æ–º–∞—Ç –ü—Ä–∏–≤–∞—Ç–ë–∞–Ω–∫,6011,6011,-100000,-100000,980,0,0,2902792,False,878A-K67P-57TX-EH2B
9aXEzdyL1ligbj1V,1593619807,KOLO,5499,5499,-10600,-10600,980,0,0,3002792,False,X7C6-4XH9-C4B9-M617
wXps2XdyLeqBZM-p,1593618903,LIQPAY*Jasmine,5651,5651,-60800,-60800,980,0,1824,3013392,False,KP6T-BCC8-3A4C-HB26
AhGJEfZTQKDiSq0e,1593594507,Lesya,4829,4829,-700000,-700000,980,0,0,3074192,True,H9PX-B8C9-7XCK-E0H4
H9yIAdgPJ44DjaL9,1593594208,–ù–∞ –¥–æ–ª–∞—Ä–æ–≤—É –∫–∞—Ä—Ç–∫—É,4829,4829,-142092,-5300,840,0,0,3774192,True
6kMRVTYJeUs2k2Yk,1593594151,–û–∫—Å–∞–Ω–∞ –ü.,4829,4829,-800000,-800000,980,0,0,3916284,True,3TCC-97K8-2603-PBCP
T5sNF1A5OrjX39A-,1593593927,–íi–¥: –ü–†–ò–•–û–î–¨–ö–û –ï.–í. –§–û–ü,4829,4829,2700000,2700000,980,0,0,4716284,True
AA9CBcLN1N95Nxbw,1593583324,LIQPAY*Ovocheva kultur,4215,4215,-93600,-93600,980,0,0,2016284,False,B245-K96K-7EE8-74A4
jLVtoNeMcfjskkFE,1593573924,–í—ñ–¥—Å–æ—Ç–∫–∏ –∑–∞ —á–µ—Ä–≤–µ–Ω—å,4829,4829,2186,2186,980,0,0,2109884,True
_xdpARPlB51AjmCW,1598796948,–ö–õ–û,5541,5541,-95741,-95741,980,0,0,1551305,False,MB62-B22B-XCP9-1A89
ZOzHEbuFSyEVyAq9,1598789501,–ü–ª–∞—Ç—ñ–∂ COMFY,4829,4829,-139980,-139980,980,0,0,1647046,True
09zVp_DIr_sqxnSK,1598774494,WFP.AQUAMAR.,5499,5499,-34120,-34120,980,0,341,1787026,False,9MTB-5179-K293-XATA
ujI12WHqBEwKnEVT,1598720095,–ê–ø—Ç–µ–∫–∞ –î–æ–±—Ä–æ–≥–æ –î–Ω—è,5912,5912,-3820,-3820,980,0,0,1821146,False,XA56-9CMM-396P-7X61
PEFXa8SEY0Uf-Y-u,1598708138,Raketa,4215,4215,-37200,-37200,980,0,0,1824966,False,EB3K-161C-5H01-PCX0
IrNwx5WmTvSWEx_L,1598694276,Kavjarnja,5814,5814,-3800,-3800,980,0,0,1862166,False,4EP5-M2B3-8TKA-14CE
BpRgXoRtpar6cYwe,1598693016,BWTC,5814,5814,-7350,-7350,980,0,0,1865966,False,28B3-5CXX-716A-7H2E
2oHU1oH46uCefFDv,1598683563,–§–∞—Ä–º–∞—Ü—ñ—è,5912,5912,-4580,-4580,980,0,0,1873316,False,3X6M-EB82-XE2A-E87X
x2vfSkZL6saMPdHk,1598683261,Billa,5411,5411,-389,-389,980,0,3,1877896,False,0993-45AP-X4H4-C94P
9m4OR7w0dkaqYTp5,1598682600,MAGAZYN DAY AND DAY,5499,5499,-26700,-26700,980,0,267,1878285,False,0P1E-7X44-9A05-CKHM
lnsTbt1Si_ueMolz,1598682186,MAGAZYN DAY AND DAY,5499,5499,-1650,-1650,980,0,16,1904985,False,266C-B94A-E81C-X03M
KYBp3A9dVnbCYbam,1598608031,MAGAZYN DAY AND DAY,5499,5499,-3400,-3400,980,0,34,1906635,False,04EM-K5P2-EAHM-P81X
pDj8deZbMk_iOLA0,1598607741,–ü–∏—Ä—ñ–∂–∫–æ–≤–∞ ¬´–¢—ñ—Ç–∫–∞ –ö–ª–∞—Ä–∞¬ª,5814,5814,-20600,-20600,980,0,0,1910035,False,67MM-75C8-T28M-ECEA
tZxGfGx9uPWI-WIl,1598561797,ZOOLYUKS,5995,5995,-10000,-10000,980,0,0,1930635,False,MAE5-HKH3-H93M-8KP8
PRmD4TLH2puZRfIM,1598461643,Raketa,4215,4215,-28900,-28900,980,0,0,1940635,False,1T4E-X5BE-MM4T-ABA4
NCLTLt_Ky8p3EC3F,1598376446,–ö–æ–ª–æ,5411,5499,-18850,-18850,980,0,188,1969535,False,4HBK-4465-TMCE-HK33
HMSzXywBy5FTZIkH,1598335770,MAGAZYN DAY AND DAY,5499,5499,-13350,-13350,980,0,150,1988385,False,17MK-55C0-MM89-ET3X
xVw3O3HocOviHLw8,1598335261,–ù–æ–≤–∞ –ø–æ—à—Ç–∞,7399,7399,-4500,-4500,980,0,0,2001735,False,BMPH-C14H-08B2-B6TT
5aAjiDeHMy6FeMLR,1598284025,Uklon,4121,4121,-29500,-29500,980,0,2950,2006235,False,C032-X83H-A7MT-58X2
QOXK-KaC8mLQFluy,1598259502,–í—ñ–¥: –û–ª–µ—Å—è –°.,4829,4829,25000,25000,980,0,0,2035735,True
To-4HlkWxulALfrU,1598259110,Uklon,4121,4121,-20400,-20400,980,0,2040,2010735,False,9B28-E8TA-00H1-A5CX
yTljrqbIXb6dvfCW,1598258992,Karnivora1,5812,5812,-91300,-91300,980,0,0,2031135,False,8P6T-XTA5-PKK8-2K98
PdDAvKOlTLzjvqQ_,1598257126,–ü–∞–ø–∞ –õ–µ—Å–∏,4829,4829,-100000,-100000,980,0,0,2122435,True,90CC-A461-P05C-A6AC
FWm15wy6imZSHYNP,1598254756,Bolt,4121,4121,-4000,-4000,980,0,400,2222435,False,10MA-H2HC-E9XA-P86B
tjXja3YtkkcDfNre,1598249687,Bolt,4121,4121,-27100,-27100,980,0,2710,2226435,False,KE99-P3KP-6XE3-KK4B
p29Gc2Qxrl7o432m,1598117171,MAGAZYN DAY AND DAY,5499,5499,-60190,-60190,980,0,1203,2253535,False,6841-52TE-7XX5-A42B
8wmHyyBMCRBAGDVn,1598111570,Right Coffee Bar,5814,5814,-9500,-9500,980,0,0,2313725,False,7HTX-16B2-15PM-349M
vahF4bgu-VhbSw0g,1598094754,LIQPAY*TOV UZVAR,5921,5921,-32900,-32900,980,0,658,2323225,False,7K9K-A0B1-XABE-C5A7
7dfiBmTXp2BFWNIc,1598093062,Bolt,4121,4121,-10800,-10800,980,0,1080,2356125,False,186C-ECAP-KCTE-E7MT
Y0XnYCeIWXrjlhas,1598081346,Bolt,4121,4121,-11700,-11700,980,0,1170,2366925,False,7XBP-017P-6358-46A5
ZIV4ttu46zflwYYU,1598016811,Bolt,4121,4121,-6771,-6771,980,0,677,2378625,False,C75K-3CEP-1H3A-2E95
hhuyykOzAM2-xAAJ,1597994633,BabkaBejkeri,5814,5814,-12500,-12500,980,0,0,2385396,False,4A17-MC6A-4C7P-CTPB
i6QsjWup0pnYnqQ7,1597991769,–ü–∏—Ä—ñ–∂–∫–æ–≤–∞ ¬´–¢—ñ—Ç–∫–∞ –ö–ª–∞—Ä–∞¬ª,5814,5814,-12500,-12500,980,0,0,2397896,False,C362-2PTT-TM4P-AXXX
-gQZVY1LpddxGOA5,1597938697,Beer Market,5921,5921,-11536,-11536,980,0,230,2410396,False,K721-077C-C0P9-M325
vDYOL3Dm4lqKkhm6,1597938247,Bolt,4121,4121,-4543,-4543,980,0,454,2421932,False,P9B2-4B28-XKE4-MX5A
5ZEqB4OMgO8AFW5L,1597924076,Glovo,4215,4215,-29900,-29900,980,0,0,2426475,False,4M6X-X8M0-7H6E-M9XC
YI1c0bKJnPiBxyjO,1597915984,The Blue Cup,5812,5812,-15600,-15600,980,0,0,2456375,False,7520-AA6A-E85H-B029
tyzQxSg678UDkv4X,1597915401,Bolt,4121,4121,-6201,-6201,980,0,620,2471975,False,2338-K7H9-M89M-98HP
BsRW8qFpg_AJYl-i,1597907662,MAGAZYN DAY AND DAY,5499,5499,-15900,-15900,980,0,318,2478176,False,A8AB-4CK6-B128-8TP0
EkM2EAGWP6aHnK1J,1597817388,Bolt,4121,4121,-5597,-5597,980,0,559,2494076,False,5553-P9MK-C515-P7X8
9YjWT7vsnJYG2iBN,1597802818,Netflix,7841,4899,-32647,-999,978,0,0,2499673,False,EKEB-6T52-TM2A-C0X1
yAhMD5XvHeonUUhg,1597787341,–ù–∞ –¥–æ–ª–∞—Ä–æ–≤—É –∫–∞—Ä—Ç–∫—É,4829,4829,-74176,-2700,840,0,0,2532320,True
q-AYEI2bNzq06M_T,1597756801,Lesya,4829,4829,-900000,-900000,980,0,0,2606496,True,KBP3-87MC-B51T-7543
dh5gXLuaNl1kL9uY,1597674704,Bolt,4121,4121,-7864,-7864,980,0,786,3506496,False,62E6-1A5E-5A33-B1H7
vbTNpVqUb5Xs5lo4,1597655779,–û–∫—Å–∞–Ω–∞ –ü.,4829,4829,-320000,-320000,980,0,0,3514360,True,6TP5-263T-XT1A-4H9M
1dJVCya6UuSF7tqL,1597655347,Lesya,4829,4829,-1500000,-1500000,980,0,0,3834360,True,PM6T-HMEK-ME96-8CK7
7BEHOwzz7qbjHD-a,1597655317,Yakaboo,5942,5942,-58000,-58000,980,0,8700,5334360,False,XMT8-B431-KEAP-M8A7
tsvmp9C7dKGJb0Rk,1597654486,–íi–¥: –ü–†–ò–•–û–î–¨–ö–û –ï.–í. –§–û–ü,4829,4829,3700000,3700000,980,0,0,5392360,True
IIZkHhm8OD-QOERX,1597652325,WFP.AQUAMAR.,5499,5499,-31840,-31840,980,0,318,1692360,False,589M-K255-16X3-9TC8
0ej0iOH_dP0Q7UQu,1597652088,LIQPAY*FOP Zamrij Arte,7278,7278,-260816,-260816,980,0,0,1724200,False,K1HC-B7CC-C5C5-780E
Oa4bIP2PRLXQG4sc,1597649952,"Lifecell
+380631692598",4814,4814,-3300,-3300,980,0,0,1985016,True,6BKT-5A30-59KC-TTH1
EeANHGYPBPhaNIlg,1597607843,–í—ñ–¥: –û–ª–µ—Å—è –°.,4829,4829,200000,200000,980,0,0,1988316,True
7Ht9AHoCa2a4pfqv,1597601290,MAGAZYN DAY AND DAY,5499,5499,-2850,-2850,980,0,28,1788316,False,PAAH-P4MA-825T-B83A
Ux484eIQOzkcYyY-,1597599817,Bolt,4121,4121,-7800,-7800,980,0,78,1791166,False,KH61-6MTP-C74C-04MP
8NMaWnZ7sGrxHO-z,1597589168,Bolt,4121,4121,-8100,-8100,980,0,81,1798966,False,3C5M-732A-7ABT-HBCK
z30ZuG2cj0KaOPct,1597586412,Bolt,4121,4121,-13400,-13400,980,0,134,1807066,False,HT4K-8AK3-X8HH-T06B
_njBtYV9FtnVFfOA,1597586262,–°–∫–∞—Å—É–≤–∞–Ω–Ω—è. Bolt,4121,4121,13400,13400,980,0,-134,1820466,False
0jJO94vS1UukjcNT,1597586198,Bolt,4121,4121,-13400,-13400,980,0,134,1807066,False
iE_R5_D7kEG9U9LI,1597563187,Bolt,4121,4121,-16300,-16300,980,0,163,1820466,False,9A00-EBPC-1BT9-61XP
mLUxYUbjy_1zShUi,1597558640,MAGAZYN DAY AND DAY,5499,5499,-15900,-15900,980,0,159,1836766,False,6590-3H16-KP46-1P92
ekY4wqV7XWXq7s2y,1597506806,MAGAZYN DAY AND DAY,5499,5499,-48531,-48531,980,0,485,1852666,False,0188-97AM-T5AK-K7A9
MM-9wBbYC92SM9QW,1597482715,Beer Market,5921,5921,-21782,-21782,980,0,217,1901197,False,974H-47XT-528A-61KP
2EVOJ7w_iXKTOWGf,1597482447,Roshen,5441,5441,-3843,-3843,980,0,38,1922979,False,0H3M-95T4-1CEP-43P2
RPlJ0I7-nHaCjYRo,1597481268,Ekstravert,5814,5814,-25150,-25150,980,0,0,1926822,False,2KB4-KX6T-7673-2C26
_57NYySYVYRizvkH,1597481241,Ekstravert1,5814,5814,-12000,-12000,980,0,0,1951972,False,EK4H-1H24-P139-4C31
VtvVjBpxX_weEdmz,1597395429,Bolt,4121,4121,-6300,-6300,980,0,63,1963972,False,CBKC-91EX-H32T-2AT1
5Kdqa91_-qn8XYbR,1597390482,Bolt,4121,4121,-5100,-5100,980,0,51,1970272,False,7HPC-X8X9-104T-0K8E
ymIuBG7c7agyI8Dy,1597341186,–î–∞—Ä–∏ –º–æ—Ä—è,5411,5411,-59550,-59550,980,0,944,1975372,False,1MB3-9MTA-5A0B-KCPK
CrbTYobfsJCThmpx,1597337538,MAGAZYN DAY AND DAY,5499,5499,-10600,-10600,980,0,212,2034922,False,3KP8-05HM-BKP6-828P
YV4383lE-eeXShkN,1597316158,–°–∫–∞—Å—É–≤–∞–Ω–Ω—è. Bolt,4121,4121,8600,8600,980,0,-860,2045522,False
RcrwgiJZ6S4M9Mv5,1597316113,Bolt,4121,4121,-12700,-12700,980,0,1270,2036922,False,EH82-9CK6-ETH9-209E
mXH6i8aC1Udp1AoG,1597312432,Bolt,4121,4121,-8600,-8600,980,0,860,2049622,False
Ttpkrj4HwtdIfKoK,1597297077,Bolt,4121,4121,-7900,-7900,980,0,790,2058222,False,B28C-6E3B-P698-3649
fQUQuZegyujlKiEH,1597254411,MAGAZYN DAY AND DAY,5499,5499,-23140,-23140,980,0,462,2066122,False,2K7X-4MMX-18EC-0X77
kOIGqVApSIJe5AyW,1597244129,Lesya,4829,4829,-75000,-75000,980,0,0,2089262,True,72P6-KK74-H68X-HMP2
kz7FOU8FCRLCuQ7e,1597225250,Bolt,4121,4121,-5700,-5700,980,0,570,2164262,False,6H3M-EX25-B6A4-6792
K7_D4rvdAkHA1byl,1597220984,Bolt,4121,4121,-5700,-5700,980,0,570,2169962,False,KP86-393E-M095-B5H0
17X8O7q-XsiNDR2t,1597216838,portmone.com.ua,4816,4816,-18360,-18360,980,0,0,2175662,False,69EC-XTC7-2C6X-XP2T
Mz8n3xsmTX4MmaSe,1597164615,MAGAZYN DAY AND DAY,5499,5499,-15900,-15900,980,0,318,2194022,False,K8E9-XB7A-92MB-9854
yzKmD31TTCvgkTjb,1597159268,Bolt,4121,4121,-6346,-6346,980,0,634,2209922,False,93X3-28K2-XXXE-X5CB
SW0aLHys9WZXWyIJ,1597125227,Lesya,4829,4829,-200000,-200000,980,0,0,2216268,True,3256-XCT2-P04T-7135
j6YxsyjKB5xNppnf,1596987590,Beer Market,5921,5921,-9242,-9242,980,0,184,2416268,False,ACEX-7K0B-6PP5-B2KP
G3Jv82GZnGtdYq25,1596986536,BabkaBejkeri,5814,5814,-22000,-22000,980,0,0,2425510,False,T51C-64C7-M2CC-M1HB
HZUffHhdpw8iPPL2,1596984912,WFP.AQUAMAR.,5499,5499,-19320,-19320,980,0,386,2447510,False,B0A3-A2BE-H5KK-2XAB
vxI9mrQSpxPskILr,1596972485,Lesya,4829,4829,-10000,-10000,980,0,0,2466830,True,BA08-940M-AKK3-PKCC
MC0kesYVm1bJR8zq,1596966866,MAGAZYN DAY AND DAY,5499,5499,-15900,-15900,980,0,318,2476830,False,14BK-8XPP-M8CK-KCMM
M40K_p61ZeDJKgM-,1596914258,Lesya,4829,4829,-50000,-50000,980,0,0,2492730,True,1B3A-14P3-9PBM-XKA5
bS2BqbrFehr6sHah,1596881774,–°—ñ–ª—å–ø–æ,5411,5411,-35952,-35952,980,0,719,2542730,False,B575-0B8X-63MK-K386
Z1uxf2a0VjVmsALB,1596790069,Bolt,4121,4121,-5700,-5700,980,0,570,2578682,False,M0K4-91T9-C9MK-HTT0
VwRm6jLAPfDFarJ7,1596787623,Bolt,4121,4121,-4500,-4500,980,0,450,2584382,False,T810-P21B-223C-13B1
iFUu4FR0lkb2sTfO,1596785811,"–Ø—Ä–æ—Å–ª–∞–≤—ñ–≤ –í–∞–ª, 19",5499,5499,-12200,-12200,980,0,244,2588882,False,05M2-X0XT-MXC3-CXAP
McXXWr4qb7q_jE5t,1596737259,Lesya,4829,4829,-300000,-300000,980,0,0,2601082,True,9MT0-94M9-TP4X-TH26
QhQauK7IQBSxvIhK,1596737191,–û–ª–µ–∫—Å—ñ–π –í.,–ø–æ–¥–∞—Ä–æ–∫ –í–∞–¥–∏–º—É,4829,4829,-24000,-24000,980,0,0,2901082,True,1ET7-XBK8-30B0-784C
BPp36KSodsckAcaT,1596703833,Bolt,4121,4121,-7000,-7000,980,0,700,2925082,False,B33P-7AM6-62KH-8HM3
muJbcHV2j7zs7j6k,1596694744,MAGAZYN DAY AND DAY,5499,5499,-10600,-10600,980,0,212,2932082,False,HK0E-1XK8-BT36-528H
NbWVNTuob_PcsZF-,1596694723,Bolt,4121,4121,-7400,-7400,980,0,740,2942682,False,06TB-CM12-15PP-016P
JM_zl9aU92yFszq8,1596625950,Bolt,4121,4121,-8600,-8600,980,0,860,2950082,False,8255-8M6K-M68B-8370
dHDvZlWuSwQGg_OD,1596620175,Bolt,4121,4121,-6300,-6300,980,0,630,2958682,False,EPH0-435M-7P77-CXT1
qYJD5-9uXLbWDbm3,1596605139,Bolt,4121,4121,-4100,-4100,980,0,410,2964982,False,8HC9-96B3-H195-P7HB
F-kDLtZRaCIqu2YpLv4H,1596589036,Bolt,4121,4121,-4500,-4500,980,0,450,2969082,True
TdpgjvD_U-nLP8KGQ9aKbA,1596589036,Bolt,4121,4121,-9900,-9900,980,0,990,2973582,True
cD80ToMGdngTHCW7n0Px5A,1596589036,Bolt,4121,4121,-4700,-4700,980,0,470,2983482,True
BBQUu9gJUrCdHKY7bnJzcgQ-XA,1596589036,–°–∫–∞—Å—É–≤–∞–Ω–Ω—è. Bolt,4121,4121,4300,4300,980,0,-430,2988182,False
Enh8dK9DIxNH4G1PVNQaJmrusQ,1596589036,–°–∫–∞—Å—É–≤–∞–Ω–Ω—è. Bolt,4121,4121,9400,9400,980,0,-940,2983882,False
FsvCaZiV9ud7K9h1cMo9pUiJVA,1596589036,–°–∫–∞—Å—É–≤–∞–Ω–Ω—è. Bolt,4121,4121,4300,4300,980,0,-430,2974482,False
8FmS5dc78HNEHgyK,1596568151,MAGAZYN DAY AND DAY,5499,5499,-5300,-5300,980,0,106,2970182,False,X951-7532-CTBA-MAC7
JNx-u0H_Bq3Zx8Br,1596532570,Bolt,4121,4121,-3600,-3600,980,0,360,2975482,False,402T-C2C2-BBC1-042M
ATEfGplJ7QW25ss8,1596525440,MAGAZYN DAY AND DAY,5499,5499,-5300,-5300,980,0,106,2979082,False,42CC-39MT-E310-17T0
bMa1TG_Bz2-cRgkQ,1596524003,Bolt,4121,4121,-5000,-5000,980,0,500,2984382,False,613C-50M6-4TXX-2B37
TgIScnfV6JEhXN3S,1596519511,Bolt,4121,4121,-4300,-4300,980,0,430,2989382,False
VlnkNtfdxNptk40q,1596519405,–ù–∞ –¥–æ–ª–∞—Ä–æ–≤—É –∫–∞—Ä—Ç–∫—É,4829,4829,-5587,-200,840,0,0,2993682,True
Nl7MILO_lFb8RIz8wDXL,1596504119,Bolt,4121,4121,-5500,-5500,980,0,550,2999269,True
ljiyDwjfj4whap4i3z0T,1596504119,Bolt,4121,4121,-4400,-4400,980,0,440,3004769,True
5UPGoNvDhw9h161BBnYVl7ybLQ,1596504119,–°–∫–∞—Å—É–≤–∞–Ω–Ω—è. Bolt,4121,4121,5200,5200,980,0,-52,3009169,False
DBzFA3hbiEfoQ50nIJ_6x91MIQ,1596504119,–°–∫–∞—Å—É–≤–∞–Ω–Ω—è. Bolt,4121,4121,4200,4200,980,0,-42,3003969,False
tJD7dFrd1FFnvLv8,1596471900,–°–∫–∞—Å—É–≤–∞–Ω–Ω—è. Bolt,4121,4121,6100,6100,980,0,-610,2999769,False
tSNwsRXeYE0Pfvco,1596471852,Bolt,4121,4121,-8200,-8200,980,0,820,2993669,False,55X4-AAE3-B241-6409
MfXcLWynDPyJJ52t,1596469919,Bolt,4121,4121,-6100,-6100,980,0,610,3001869,False
Q78iqwX-DBWphNeP,1596465629,Bolt,4121,4121,-9400,-9400,980,0,940,3007969,False
FYfNhtO6jmM4LqsV,1596457271,Lesya,4829,4829,-500000,-500000,980,0,0,3017369,True,45M8-4108-5036-5MA6
vw46ydPqB2Ksno8_,1596456642,516874****1366,4829,4829,-275000,-275000,980,0,0,3517369,True,K106-A82A-40KC-C4A8
EvR6QDMpNOVjc0ld,1596456413,Bolt,4121,4121,-5200,-5200,980,0,520,3792369,False,5C29-H85P-CC8K-E08A
aVplPS4_CiDZlg4c,1596454767,Bolt,4121,4121,-4300,-4300,980,0,430,3797569,False
5mHxnz6nU7BxCkeM,1596453617,CTS TURIZM REKLAMCILIK,4722,4722,-4419672,-134800,978,0,0,3801869,False,3HA0-7380-42E3-T817
AtG7owynxrWIBXWu,1596451489,–î–º–∏—Ç—Ä–æ –ö.,–º—É—Å–æ—Ä ‚ôªÔ∏è,4829,4829,-20000,-20000,980,0,0,8221541,True,P6MC-B522-0M53-BAC3
NHa26iD1lGGIO9z7,1596450639,–ù–∞ –¥–æ–ª–∞—Ä–æ–≤—É –∫–∞—Ä—Ç–∫—É,4829,4829,-44569,-1600,840,0,0,8241541,True
GySL-2sD18b_MNzM,1596449172,BWTC,5814,5814,-4500,-4500,980,0,0,8286110,False,0C37-H1EH-B0K6-55C3
yrVW-V3BbNOz2Zea,1596448438,–íi–¥: –ü–†–ò–•–û–î–¨–ö–û –ï.–í. –§–û–ü,4829,4829,8000000,8000000,980,0,0,8290610,True
VSkt1VLJBldsi5O_,1596442211,zakaz.ua,7278,7278,-310982,-310982,980,0,0,290610,False,BXK7-96AX-0026-61BA
TDQBQDCSBd0lSLjf,1596441690,Bolt,4121,4121,-5200,-5200,980,0,52,601592,False
jdpHEwDg7T0vZO2z,1596440762,LIQPAY*TOV Evro Klik,5045,5045,-145900,-145900,980,0,0,606792,False,76PH-BH81-277A-AP31
ToptrxL0Szwlrk9i,1596440542,Bolt,4121,4121,-4200,-4200,980,0,42,752692,False
jiyCmQyfonIxEIKM,1596369184,Doggeriz Hotdogs,5814,5814,-27700,-27700,980,0,0,756892,False,8HXE-7MAE-XB31-3K09
YyY0NrtSsYAmKClN,1596366191,MAGAZYN DAY AND DAY,5499,5499,-15900,-15900,980,0,159,784592,False,8KK6-C5E9-T4TT-95K6
2_7twoXR3lDIXrQo,1596353196,WFP.AQUAMAR.,5499,5499,-45380,-45380,980,0,453,800492,False,7KAH-BPX7-3C8T-632B
EUN9kVqZfDq4JcfF,1596290428,MAGAZYN DAY AND DAY,5499,5499,-47351,-47351,980,0,473,845872,False,M7KK-4980-9CT2-MHC4
xA1rIusb6iwDVAjz,1596277764,Pethouse,5995,5995,-46900,-46900,980,0,0,893223,False,KXE2-PX10-2A6E-8MHX
hmOg8C1c4UIwS7zU,1596275089,–ö–æ—Å–∞—Ç–∫–∞,5812,5812,-57500,-57500,980,0,0,940123,False,T182-P3BT-15T1-E31X
oPCtvASJDv_dnIk0,1596253020,–í—ñ–¥—Å–æ—Ç–∫–∏ –∑–∞ –ª–∏–ø–µ–Ω—å,4829,4829,971,971,980,0,0,997623,True
I5_p8Z7TNXxLsMgO,1596230683,–î–µ–Ω–∏—Å –ö–æ—Ç–æ–≤,—Ü—ã–ø–∞ üê•,4829,4829,-23920,-23920,980,920,0,996652,True,7011-KK78-69T4-0TM1
4N68Ne9DhyY1cwMd,1601368175,Bolt,4121,4121,-4900,-4900,980,0,49,1991768,False,605C-8AB7-PM0E-XA20
72jZxBPHkHR2LMRg,1601360948,MAGAZYN DAY AND DAY,5499,5499,-15900,-15900,980,0,0,1996668,False,PT6H-7AME-EMMT-A59T
qDyhLttVz9VXoQjY,1601302865,Lesya,4829,4829,-5000,-5000,980,0,0,2012568,True,APTB-P650-KC24-M61K
iNOdAdpPHlEzkUQt,1601300410,Lesya,4829,4829,-10000,-10000,980,0,0,2017568,True,H6E4-4536-K332-5E04
DmcO8Y8dXpfsqYbL,1601285053,–î–∞—Ä—ñ—è –¢.,4829,4829,-10000,-10000,980,0,0,2027568,True,0C1M-25XK-EXHB-605E
yWJSA1xVGNJep8RM,1601284987,Barbershop Daboroda,7230,7230,-45000,-45000,980,0,0,2037568,False,TA96-BEH9-TX9A-1073
x7iSsZ6Kx-HVqXle,1601215784,MAGAZYN DAY AND DAY,5499,5499,-13950,-13950,980,0,0,2082568,False,4104-4EB4-MM8H-CHTM
tHCwZx6TtSTfzyfu,1601211040,473121****3677,4829,4829,-6030,-6030,980,0,0,2096518,True,1965-K040-2995-3618
hDUPoWYMpXmGEdAY,1601210124,PIROGITADRUZI,5814,5814,-12500,-12500,980,0,0,2102548,False,0H5H-KX3E-CXME-T6B0
JiQXjG9IIsZEpJzh,1601207953,PORTER PAB,5814,5814,-13200,-13200,980,0,0,2115048,False,2T2P-X1H5-HH46-PB17
31WBozmSMrEEdLaA,1601125387,MAGAZYN DAY AND DAY,5499,5499,-16750,-16750,980,0,0,2128248,False,X2E4-C4MX-4765-TBKA
XxBfqoXQ0JXkovoZ,1601106448,bwtc cafe&roasters,5814,5814,-30500,-30500,980,0,0,2144998,False,51EA-X7T0-06M4-0XCB
-7vaH3epjVh5b5hG,1601104410,bwtc cafe&roasters,5814,5814,-25600,-25600,980,0,0,2175498,False,BA85-21EX-0EH1-X67X
OiIxReOGXU_Cw_x-,1601061621,Lesya,4829,4829,-100000,-100000,980,0,0,2201098,True,EP60-EC94-EME3-K491
z4TcCJvwd-HRofkp,1601061616,Pethouse,5995,5995,-50900,-50900,980,0,0,2301098,False,EB58-3EEK-1B5E-2XAC
zxezBxP6aUG5WGtJ,1601055118,WFP.AQUAMAR.,5499,5499,-42480,-42480,980,0,0,2351998,False,K3T1-99T5-2X0H-AB9P
zR3raLSp48NUtal1,1601034338,MAGAZYN DAY AND DAY,5499,5499,-14950,-14950,980,0,0,2394478,False,BBET-4P1M-0M32-E4X3
yZomc5riFbCMUEho,1600967538,MAGAZYN DAY AND DAY,5499,5499,-4600,-4600,980,0,0,2409428,False,CXXM-H0EK-1X3K-P302
lEj10BkWm_0sK4ky,1600935983,Bolt,4121,4121,-8000,-8000,980,0,800,2414028,False,6456-8CKX-352A-5H76
A2DUenhvRTzyPmuS,1600930118,Lesya,4829,4829,-100000,-100000,980,0,0,2422028,True,A6M8-4B51-95E5-T4BC
eATknjpXKfPS9qH0,1600925538,Bolt,4121,4121,-8300,-8300,980,0,830,2522028,False,7P55-C7CM-KT29-8TA2
rf_-fTSO2JNyK0io,1600881349,Lesya,4829,4829,-100000,-100000,980,0,0,2530328,True,9PM5-0PM1-T3M9-HAHT
9Wov7pd352bwDBx4,1600880988,Lesya,4829,4829,-100000,-100000,980,0,0,2630328,True,1P0T-8TP8-1CX2-606H
tf2IoXCt8TjFfHnn,1600862941,Beer Market,5921,5921,-20000,-20000,980,0,0,2730328,False,2M2K-0T94-M23K-30KK
J-CKEW7aYn7and0N,1600862729,Roshen,5441,5441,-17350,-17350,980,0,0,2750328,False,5K7C-8CTK-M1H2-905X
OFtnQd1JDjqGn0Dg,1600808318,Bolt,4121,4121,-5000,-5000,980,0,500,2767678,False,1K6M-8BP4-XX3X-TK27
xfwHcmSPvYLa1KIJ,1600806649,414943****8992,4829,4829,-15000,-15000,980,0,0,2772678,True,KEK8-2CH6-MHEP-EBTP
N3-SpaZDrlkzLaRd,1600806522,–ú–æ–∫—Ä—ñ –í—É—Å–∞ (–ú–æ–∫—Ä—ñ –≤—É—Å–∞. –£–∫—Ä–∞—ó–Ω—Å—å–∫–∏–π –ø–∞–±),5814,5814,-57900,-57900,980,0,0,2787678,False,7B1T-HMT2-6KH2-T0M1
oFdvvDl30y71XQsj,1600793792,Bolt,4121,4121,-5300,-5300,980,0,530,2845578,False,CKEE-982A-A96C-C82A
0dwfjq7Fo34NKBqt,1600792447,MAGAZYN DAY AND DAY,5499,5499,-5300,-5300,980,0,0,2850878,False,7BPM-47MX-2X1H-6053
ei1inZ46kygaAJcJ,1600746884,–°–∫–∞—Å—É–≤–∞–Ω–Ω—è. Bolt,4121,4121,10000,10000,980,0,-1000,2856178,False
4TEPyuX-rcQanwpT,1600746774,Bolt,4121,4121,-10000,-10000,980,0,1000,2846178,False
yjLezPzHcD1wWxRO,1600708253,OkvajnSichovih,5399,5399,-21650,-21650,980,0,0,2856178,False,M9H6-9X1K-217A-314C
FEgExtjCiiHrx1JD,1600686867,"–ö–∏—ó–≤—Å—Ç–∞—Ä
+380962159945",4814,4814,-10000,-10000,980,0,0,2877828,True,6X2M-PP6E-8P1E-0632
MCMcEnXWMZ_oM59O,1600668639,MAGAZYN DAY AND DAY,5499,5499,-15900,-15900,980,0,0,2887828,False,P832-6ACE-9433-EK9B
TnOQ_S9gdppb8Vnm,1600603893,bwtc cafe&roasters,5814,5814,-7700,-7700,980,0,0,2903728,False,35A0-K662-389E-7K0H
p9mfl1xzsc0xXKHS,1600603652,Kavjarnja,5814,5814,-3800,-3800,980,0,0,2911428,False,BX6E-CMH5-1BAP-91A3
ENmzT0iqL55GtL6f,1600589871,Lesya,4829,4829,-50000,-50000,980,0,0,2915228,True,7AKP-8MTT-774T-584T
t4bfERU5G7J9QpEyyEquaA,1600556724,Bolt,4121,4121,-9200,-9200,980,0,920,2965228,True
vSZ0BtGbrs9AdF1wbi_vLFf2bA,1600556724,–°–∫–∞—Å—É–≤–∞–Ω–Ω—è. Bolt,4121,4121,9000,9000,980,0,-900,2974428,False
PGSLDlLWN67uIPGI,1600513751,Lesya,4829,4829,-50000,-50000,980,0,0,2965428,True,T48M-T03C-XHM2-74TH
9wz8g6vp87fpoUre,1600499796,–ù–æ–≤–∞ –ø–æ—à—Ç–∞,7399,7399,-4500,-4500,980,0,0,3015428,False,CB5H-640C-0HK3-3TE9
74gzEFdrlYkClZPi,1600496688,Bolt,4121,4121,-9000,-9000,980,0,900,3019928,False
jDA2UkZ0Aew9QtjT,1600480486,Netflix,7841,4899,-33407,-999,978,0,0,3028928,False,5857-1HA9-CB30-1P46
4MbUsgpvpOydW3Za,1600450716,Lesya,4829,4829,-100000,-100000,980,0,0,3062335,True,THAE-6XMC-70C7-K5C9
TQBUCqby4wu5rSox,1600432259,–°–∫–∞—Å—É–≤–∞–Ω–Ω—è. Bolt,4121,4121,6325,10000,980,0,-632,3162335,False
OvrJm_lj6SzNxF80,1600431759,Bolt,4121,4121,-10000,-10000,980,0,1000,3156010,False
sqkLha-0SXTTTs1s,1600430488,MAGAZYN DAY AND DAY,5499,5499,-27100,-27100,980,0,0,3166010,False,AEAH-7P7C-T3PM-C385
Pma4WAmYMUnkiRST,1600417665,LIQPAY*Foundation Coff,5812,5812,-36260,-36260,980,0,0,3193110,False,97TA-7PP4-M239-08X4
bOCxD6gvukVHd3n1,1600357306,–°–∫–∞—Å—É–≤–∞–Ω–Ω—è. Bolt,4121,4121,5258,10000,980,0,-525,3229370,False
xp7qtRrviAo4FFb7,1600356868,Bolt,4121,4121,-10000,-10000,980,0,1000,3224112,False
Tq74imjxRya_k17e,1600351538,–°–∫–∞—Å—É–≤–∞–Ω–Ω—è. Bolt,4121,4121,4901,10000,980,0,-490,3234112,False
Ox-V_UNEcWTJ1p_p,1600351007,Bolt,4121,4121,-10000,-10000,980,0,1000,3229211,False
_UJIGAk3JjvarCUJ,1600350391,Lesya,4829,4829,-100000,-100000,980,0,0,3239211,True,2CEA-AK79-8X00-21MH
Z8inRrB3aMMnJjf_,1600340093,–°–∫–∞—Å—É–≤–∞–Ω–Ω—è. Bolt,4121,4121,5012,10000,980,0,-501,3339211,False
5TnglveV7kSQfw4G,1600339602,Bolt,4121,4121,-10000,-10000,980,0,1000,3334199,False
ODqjHdYxZeqXzdHu,1600339583,–°–∫–∞—Å—É–≤–∞–Ω–Ω—è. Bolt,4121,4121,10000,10000,980,0,-1000,3344199,False
C5YBH7EVbTS-IvSE,1600339451,Bolt,4121,4121,-10000,-10000,980,0,1000,3334199,False
qplnBU971zJZRPuo,1600326797,Bolt,4121,4121,-8400,-8400,980,0,840,3344199,False,9M4C-6269-T02B-TXCA
0LNpxd_MZsDtPIJE,1600320466,Bolt,4121,4121,-8400,-8400,980,0,840,3352599,False,CP27-326X-PTA9-70TK
iB-GRY62zQBwquj6,1600284175,Rozetka,5722,5399,-80000,-80000,980,0,0,3360999,False,3PA8-614H-58KM-3TA0
AOgpYh3cRKYBap1O,1600281370,MAGAZYN DAY AND DAY,5499,5499,-15900,-15900,980,0,0,3440999,False,CHKP-AH5K-845E-B036
Bk2beHlQIlDH7vHc,1600265924,516874****9591,4829,4829,-10900,-10900,980,0,0,3456899,True,HAH0-66PH-5M0X-BP27
SN5p0Cw43b3u0qYW,1600262587,Right Coffee Bar,5814,5814,-9500,-9500,980,0,0,3467799,False,E91A-M1T9-EB46-28P9
Sn7cWb2Ottdr0pss,1600247780,–°–∫–∞—Å—É–≤–∞–Ω–Ω—è. Bolt,4121,4121,6143,10000,980,0,-614,3477299,False
CQ53S6NgIf0Khyrz,1600247531,Bolt,4121,4121,-10000,-10000,980,0,1000,3471156,False
TW1HnQAU3RSc-mPN,1600247490,–°–∫–∞—Å—É–≤–∞–Ω–Ω—è. Bolt,4121,4121,10000,10000,980,0,-1000,3481156,False
Qic4MIOqbha46zzb,1600247259,Bolt,4121,4121,-10000,-10000,980,0,1000,3471156,False
CrbTY4PXtZeSgWp6,1600247221,–°–∫–∞—Å—É–≤–∞–Ω–Ω—è. Bolt,4121,4121,10000,10000,980,0,-1000,3481156,False
jUtehdKlHYS2hgv6,1600247166,Bolt,4121,4121,-10000,-10000,980,0,1000,3471156,False
s0fPpCYaZLM9zsbH,1600234675,Lesya,4829,4829,-500000,-500000,980,0,0,3481156,True,30C0-PHEB-6C59-H4TK
-AZwmYix8RACJfrj,1600199681,MAGAZYN DAY AND DAY,5499,5499,-13100,-13100,980,0,0,3981156,False,EA47-49XH-EC50-KP0K
T0jDywB8zAcvpkTG,1600183734,Bolt,4121,4121,-6000,-6000,980,0,600,3994256,False,E909-B811-M4MX-P9X6
1JofCPR9KspNKInH,1600177184,Flower Time,5992,5992,-32500,-32500,980,0,6500,4000256,False,HCX3-3ABA-283A-47MX
aVnxSWIRi8HCexlb,1600175913,Bolt,4121,4121,-5200,-5200,980,0,520,4032756,False,X842-3K11-9978-B72C
WAb3WXnxv7voSTDY,1600160861,–û–∫—Å–∞–Ω–∞ –ü.,4829,4829,-700000,-700000,980,0,0,4037956,True,HH8C-191E-AK0T-93B7
_Zj592DPC0zA8LG-,1600158566,Lesya,–¥–∏—Ç–æ—à–∫–µ,4829,4829,-1000000,-1000000,980,0,0,4737956,True,CXK1-25T7-EX4A-478E
qIxQK-SCECz0cq2O,1600158418,–ù–∞ –¥–æ–ª–∞—Ä–æ–≤—É –∫–∞—Ä—Ç–∫—É,4829,4829,-76057,-2700,840,0,0,5737956,True
5vqQuv7FTuwhQSxH,1600158034,–íi–¥: –ü–†–ò–•–û–î–¨–ö–û –ï.–í. –§–û–ü,4829,4829,5500000,5500000,980,0,0,5814013,True
t8dfxrXpBxHFXkj4,1600156916,Bolt,4121,4121,-5900,-5900,980,0,59,314013,False,9986-39B6-X55X-PX08
8jfkXZRIQnMqek0Z,1600148273,MAGAZYN DAY AND DAY,5499,5499,-18450,-18450,980,0,0,319913,False,09KE-P2H2-8X5C-3CE5
jhmWYcvYVMDJ06gU,1600082065,Raketa,4215,4215,-28500,-28500,980,0,0,338363,False,H781-20PH-PE52-X984
zlCvYlyWJrKjy7SH,1600072739,Bolt,4121,4121,-5700,-5700,980,0,57,366863,False,H58H-7784-8M03-3E70
Ro--c_N4a2-MaVNs,1600037807,Bolt,4121,4121,-8700,-8700,980,0,87,372563,False,TMT5-M19A-5097-72KP
UiPUMq7lZZO2KrdO,1600025501,Duty Free Shop,5309,5812,-6778,-1800,949,0,0,381263,False,EM85-29BH-KAHT-XC96
r_v-jD19m0GSgVuj,1600024325,ATU Duty Free,5309,5309,-29158,-7746,949,0,0,388041,False,6176-0MH7-B0H2-PE8B
csMFApdsNWhahPTO,1600018962,SARPEDOR BOUTIG VE H,7011,7011,-24480,-6500,949,0,0,417199,False,K5CC-A812-EB90-P8M7
-fLNFxEiR7Ft9g1s,1600015288,MUG BODRUM MARINA D&R,5942,5942,-85653,-22750,949,0,0,441679,False,2P6T-A4H5-4KP7-M6CM
F4lLwbvorc70Wfbx,1600012820,BAHATTIN YILDIRIM,5411,5411,-6022,-1600,949,0,0,527332,False,512T-T7E4-981T-P1P4
GuOMnBYHe-sqDGuX,1600011724,YUNUSLAR KARADENIZ,5462,5462,-9047,-2400,949,0,0,533354,False,50C0-AM0E-0512-9TH4
yzq6NxTJc06-krMp,1600010904,KAKTUS CAFE,5814,5814,-84701,-22500,949,0,0,542401,False,PAB8-A4AA-K8X1-TB7K
kX238x9fgpIleN6x,1600007653,KIRACI RESTORANT,5814,5814,-141561,-37600,949,0,0,627102,False,B6M3-K6C7-C1HP-P61H
HlfdBN0_6d63_SwW,1599995647,"Lifecell
+380631692598",4814,4814,-11000,-11000,980,0,0,768663,True,P664-XXB3-453K-2EM4
9zyz_AkPrwosEqiU,1599990691,portmone.com.ua,4899,4899,-22440,-22440,980,0,0,779663,False,0236-X878-CAHE-P048
vMcNDExRhvhdIBdc,1599920972,GIZEM SPA LTD. STI - O,7298,7298,-225898,-60000,949,0,0,802103,False,M872-27HC-4TTT-3BT5
v07y2ByjJfERvY3J,1599857939,IXIR BAR RESTAURANT,5812,5812,-269173,-71500,949,0,0,1028001,False,PKBB-4P21-19BM-07MC
MkCqLFsh_pEWhrgK,1599850046,–°–∫–∞—Å—É–≤–∞–Ω–Ω—è. YUNUSLAR KARADENIZ,5462,5462,7170,1900,949,0,0,1297174,False
NXQ0-gr74zShsh-O,1599850002,YUNUSLAR KARADENIZ,5462,5462,-7170,-1900,949,0,0,1290004,False
PuMTtBEmrllFokuu,1599768582,IXIR BAR RESTAURANT,5812,5812,-109854,-29050,949,0,0,1297174,False,2AB6-4294-A3T3-A4B5
6QEXuRKiDHLI2Vfx,1599760154,YUNUSLAR KARADENIZ,5462,5462,-7507,-2000,949,0,0,1407028,False,A9X4-H02K-49EB-H67C
LHe8qaYAW-apYXWt,1599759768,TRANCA RESTAURANT,5812,5812,-89211,-23800,949,0,0,1414535,False,3EA8-A2KB-E16P-X21C
xY2nilzq40O6Bfqs,1599754484,SURFER CARAVAN,5812,5812,-13109,-3500,949,0,0,1503746,False,K547-X935-TB35-24XB
iTyTfGxsPpInPIs4,1599747811,Bodrum Kalesi - Sualtƒ± Arkeoloji M√ºzesi,7991,7991,-48737,-13000,949,0,0,1516855,False,7AM0-2B0T-20C2-971C
FqM5yQfPCnGOg37N,1599430282,–°–∫–∞—Å—É–≤–∞–Ω–Ω—è. Bolt,4121,4121,1000,16000,980,0,-10,1565592,False
C-HI2jrpvjUx-Yrl,1599427747,Bolt,4121,4121,-16000,-16000,980,0,160,1564592,False
GusncmBL1o8Xuauy,1599406400,MAGAZYN DAY AND DAY,5499,5499,-1761,-1761,980,0,0,1580592,False,E48X-C86A-0EB8-P93C
cgxJryVNXFCFeBsW,1599403058,Bolt,4121,4121,-7500,-7500,980,0,75,1582353,False,84P5-HM8B-X518-5K34
hS3LQxLqWsN8wCpL,1599400200,Uklon,4121,4121,-12800,-12800,980,0,128,1589853,False,5EM3-TM88-M489-MC7M
MX8ruA_o-niBNDr9,1599399864,–ï–ø—ñ—Ü–µ–Ω—Ç—Ä,5211,5211,-687612,-687612,980,0,0,1602653,False,PXTK-P151-X4MH-0281
37irZKZLamMVRu_3,1599394853,Uklon,4121,4121,-12700,-12700,980,0,1270,2290265,False,T163-MP68-1881-XCP1
oeHe1mAiHSQJWm57,1599302559,MAGAZYN DAY AND DAY,5499,5499,-12650,-12650,980,0,0,2302965,False,A51K-TCP0-862K-X5C6
tL3TU1OiQDlMd4rL,1599298229,516874****1218,4829,4829,-71700,-71700,980,0,0,2315615,True,K87B-P940-96MC-4EPA
LT4YYV_FKtNcAJIH,1599226222,Lesya,4829,4829,-500000,-500000,980,0,0,2387315,True,M47C-2CE2-PEX2-5A2T
I6USf2uRYx-OmKWo,1599217385,Lesya,4829,4829,-300000,-300000,980,0,0,2887315,True,68KT-XH77-61C8-12C7
mA_oTAYWG-IycDV7,1599118099,MAGAZYN DAY AND DAY,5499,5499,-20050,-20050,980,0,0,3187315,False,4366-CC27-66A4-M5K9
uEkRa6l60Gv3A1Qz,1599115613,Bolt,4121,4121,-4000,-4000,980,0,400,3207365,False,XPX2-BH67-651H-E1BA
IOT2zjnr61GntUOW,1599113387,Bolt,4121,4121,-4300,-4300,980,0,430,3211365,False,0X9H-2E7A-1996-915B
NCvC78tMyFBlVwr7,1599048112,MAGAZYN DAY AND DAY,5499,5499,-20000,-20000,980,0,0,3215665,False,KCT0-081K-B93M-BCT5
5xb34hYXuAOd9Fba,1598955841,Lesya,4829,4829,-300000,-300000,980,0,0,3235665,True,4B24-MTEB-HAH3-5A2P
1mirBWI0FXyH2i7u,1598954727,Uklon,4121,4121,-5900,-5900,980,0,590,3535665,False,0KHK-CC3A-4ATX-111B
4U3Jq1gqK6ejGBBf,1598934225,–í—ñ–¥—Å–æ—Ç–∫–∏ –∑–∞ —Å–µ—Ä–ø–µ–Ω—å,4829,4829,1559,1559,980,0,0,3541565,True
tO1z5m6HBsiizG9v,1598907851,–í–∏–≤–µ–¥–µ–Ω–Ω—è –∫–µ—à–±–µ–∫—É 582.28‚Ç¥,4829,4829,46872,46872,980,0,0,3540006,True
PgIgPtponbDeIxAZ,1604086800,–ú—ñ—Å—å–∫–µ –∫–∞—Ñ–µ ¬´–•–∞—Ä–º—Å¬ª (–ö–Ω–∏–∂–∫–æ–≤–∞ –∫—Ä–∞–º–Ω–∏—Ü—è ¬´–•–∞—Ä–º—Å¬ª),5814,5814,-3120,-3120,980,0,0,1337118,False,KE94-2AEP-6622-E4K7
KQ3UEt9L6lO8pRJI,1604074813,Uklon,4121,4121,-8100,-8100,980,0,0,1340238,False,PK8T-3HXK-3537-MT8H
ducbPIJBaQxJwGD1,1604074663,–°–∫–∞—Å—É–≤–∞–Ω–Ω—è. Bolt,4121,4121,7500,7500,980,0,0,1348338,False
Zl7FFsAWop1Tt4kY,1604074142,Bolt,4121,4121,-7500,-7500,980,0,0,1340838,False
PbwAdgHZ9gvcnzX1,1604071758,Produkti,5499,5499,-5500,-5500,980,0,0,1348338,False,5494-E0T5-26BA-67AH
4ZjNvzbipNNU6sma,1604071561,–•–ª–µ–±–Ω—ã–π,5814,5814,-26800,-26800,980,0,0,1353838,False,AX4T-52T4-3A34-B6X2
eNmw9BiNwwUCVTMM,1604041634,–ü–ª–∞—Ç—ñ–∂ COMFY,4829,4829,-139980,-139980,980,0,0,1380638,True
zR76LwrpCwHcDTm0,1604040654,bwtc cafe&roasters,5814,5814,-3600,-3600,980,0,0,1520618,False,30C2-A03C-578C-7HA7
m9vJ7wQVe7xHS8q21NST,1604022138,Bolt,4121,4121,-9800,-9800,980,0,0,1524218,True
j_WC0yinyV9L4q6jkIFnNEed-w,1604022138,–°–∫–∞—Å—É–≤–∞–Ω–Ω—è. Bolt,4121,4121,8400,8400,980,0,0,1534018,False
eH7tezEtJnpXHJK-,1603994084,–ü–∏—Ä—ñ–∂–∫–æ–≤–∞ ¬´–¢—ñ—Ç–∫–∞ –ö–ª–∞—Ä–∞¬ª,5814,5814,-12600,-12600,980,0,0,1525618,False,8M20-0MBB-9BAB-6XB9
fOiaexCC4VW6HiEw,1603981778,Bolt,4121,4121,-8700,-8700,980,0,0,1538218,False,1P0P-X091-94M4-2HE0
Mfg4J1yUu91gMfux,1603979741,–ü–∏—Ä—ñ–∂–∫–æ–≤–∞ ¬´–¢—ñ—Ç–∫–∞ –ö–ª–∞—Ä–∞¬ª,5814,5814,-16800,-16800,980,0,0,1546918,False,MMA1-TPTH-BMX9-XCHP
5FF4soFbB6-REJwH,1603979453,MAGAZYN DAY AND DAY,5499,5499,-7000,-7000,980,0,0,1563718,False,KTT2-6BTK-2X11-E2KK
rJQxhxt4qXdlpyRU,1603963183,Bolt,4121,4121,-8400,-8400,980,0,0,1570718,False
pPr7hOLDAkSG-GI1,1603955636,MAGAZYN DAY AND DAY,5499,5499,-16500,-16500,980,0,0,1579118,False,5A86-CM9H-44AE-M3X3
mjLIZfML50WshUbicltI,1603932122,Bolt,4121,4121,-8900,-8900,980,0,0,1595618,True
ZgYBYB2p32FtU0YBg0NKKqP8NA,1603932122,–°–∫–∞—Å—É–≤–∞–Ω–Ω—è. Bolt,4121,4121,8000,8000,980,0,0,1604518,False
EeM3YG0KMp29zNbf,1603884904,–í—ñ–¥: –û–ª–µ—Å—è –°.,4829,4829,240000,240000,980,0,0,1596518,True
7lUC41_11MYJQrP3,1603879197,Bolt,4121,4121,-8200,-8200,980,0,0,1356518,False,T34A-P1E2-B9MP-1364
tqdjEKpkGtx9p424,1603874030,MAGAZYN DAY AND DAY,5499,5499,-14200,-14200,980,0,0,1364718,False,C1K4-3CPK-0P80-1M0P
e3RaHhz_OU7qeAmV,1603873411,Bolt,4121,4121,-8000,-8000,980,0,0,1378918,False
8JFFoo6o_xu9Bnwf,1603747447,FDY*Clothing,5691,5691,-296800,-296800,980,0,0,1386918,False,B83T-1C8H-A0H7-AH0P
v999X60fvh6Q3tpK,1603718281,The Cinematographer‚Äôs Party,5814,5814,-50000,-50000,980,0,0,1683718,False,X723-7C8X-1C48-BKMA
M4YXXRDDSAYUQtWX,1603717677,MaagazinProdukti,5499,5499,-16500,-16500,980,0,0,1733718,False,9XC0-K6XB-8797-T2C8
fc_sVELcMK43U5A6,1603715656,ML DILA,8099,8099,-250000,-250000,980,0,0,1750218,False,135B-9390-0CK3-162T
R_msR6ddaUEDahIo,1603705381,Lesya,4829,4829,-27500,-27500,980,0,0,2000218,True,B4KE-MPE4-280A-3108
Vxk5hQGj_qZKbViV,1603705342,Bolt,4121,4121,-4700,-4700,980,0,0,2027718,False,A2PT-P112-4KAM-KH42
JbRmQRI_WaRHq3Wy,1603702654,Bolt,4121,4121,-4500,-4500,980,0,0,2032418,False,6XM8-27MA-90B4-1T2P
0XQ9quOVVfmcINV8,1603645617,Lesya,4829,4829,-20000,-20000,980,0,0,2036918,True,61AT-3AC2-1EKH-BBEC
6hCPwGYYVUPfRZ8N,1603633446,–í–æ–ª–æ–¥–∏–º–∏—Ä –ì.,–ë–µ–ª–æ—à–∏—Ü–∫–∏–π,4829,4829,-320000,-320000,980,0,0,2056918,True,KX2B-3A97-4ME8-BE62
JNfCApoTq1b5sDd3,1603633326,–ü—Ä–∏–≤–∞—Ç24: Prykhodko Ernest,6536,6536,260000,260000,980,0,0,2376918,False
nxPiQ8lud1TQAetD,1603624777,Bolt,4121,4121,-9000,-9000,980,0,0,2116918,False,24T6-0062-XK08-B6H1
5IikNEMum824trcT,1603624680,–ö–æ–Ω–¥–∏—Ç–µ—Ä—Å–∫–∞—è ¬´–ê–Ω–∞—Å—Ç–∞—Å–∏—è¬ª,5441,5441,-15980,-15980,980,0,0,2125918,False,P7H8-X09A-EK69-H13K
SEJ96Vf4Lf3YNfK1,1603621903,Uklon,4121,4121,-2900,-2900,980,0,0,2141898,False,56B5-TB6K-4PK8-5A7T
-M6V0D-m0-b0QTWH,1603620752,9Bar,5814,5814,-5800,-5800,980,0,0,2144798,False,928T-E253-C501-8773
JjG5ZftCxc9GLBD-,1603619485,Uklon,4121,4121,-13900,-13900,980,0,0,2150598,False,5HBX-2EPB-698M-X80T
umOFdpN8hPPawkfl,1603614862,Uklon,4121,4121,-11500,-11500,980,0,0,2164498,False,T15P-781E-CT83-MB87
pHlUsx1p4KUjW78H,1603613404,Bolt,4121,4121,-5900,-5900,980,0,0,2175998,False,E764-CBPE-KEAB-5EEC
EspzR7UlxXK4AgGd,1603541718,536354****5316,4829,4829,-36500,-36500,980,0,0,2181898,True,9286-P1AB-E5HP-BB40
76vZh7Ku-oxJ6Mao,1603527944,MAGAZYN DAY AND DAY,5499,5499,-18250,-18250,980,0,0,2218398,False,P662-2K3T-2783-91T6
8OZ2065QFykbDOYz,1603526327,ZOOLYUKS,5995,5995,-177100,-177100,980,0,0,2236648,False,858H-6PMB-K750-ET50
kMrQy-4mAe9RLCbk,1603479526,MAGAZYN DAY AND DAY,5499,5499,-19450,-19450,980,0,0,2413748,False,B998-06KB-42XM-KKT7
VrSbZWKc9X-GcpJJ,1603462219,Lesya,4829,4829,-300000,-300000,980,0,0,2433198,True,594E-X82P-078M-KHA8
PyeV2YLnx_wP2eGz,1603454214,516874****0131,4829,4829,-46231,-46231,980,0,0,2733198,True,46P5-9442-3PC8-8T03
Oym-nWXHTOTULCtt,1603385241,–°–∫–∞—Å—É–≤–∞–Ω–Ω—è. Bolt,4121,4121,6100,10600,980,0,0,2779429,False
VsUbri-M9b9ue3lR,1603383816,Bolt,4121,4121,-10600,-10600,980,0,0,2773329,False
LHjIgYVLDD-Rd1XW,1603368475,–°–∫–∞—Å—É–≤–∞–Ω–Ω—è. Bolt,4121,4121,8100,8100,980,0,0,2783929,False
pznlRn-yyHaI4GlJ,1603368335,Bolt,4121,4121,-8100,-8100,980,0,0,2775829,False
0cNbsoO0PwfKrYfQ,1603356259,Bolt,4121,4121,-8600,-8600,980,0,0,2783929,False,4MTT-K0T2-TM67-1E1X
qhmAP4Wz7V3mf7au,1603353980,MAGAZYN DAY AND DAY,5499,5499,-16500,-16500,980,0,0,2792529,False,CE0E-P5B4-C8B2-T4M2
wBm-br7G1cA3QrAi,1603344234,Bolt,4121,4121,-7200,-7200,980,0,0,2809029,False,E3XB-7221-B48C-5CEX
opQmG_XYsHXwcj-6G4E,1603322229,Bolt,4121,4121,-5800,-5800,980,0,0,2816229,True
aQO4sWJmvAzN9cFKcnqOuGVgCQ,1603322229,–°–∫–∞—Å—É–≤–∞–Ω–Ω—è. Bolt,4121,4121,5000,5000,980,0,0,2822029,False
BTEhJ86KLrj5dIyp,1603292396,–°–∫–∞—Å—É–≤–∞–Ω–Ω—è. Bolt,4121,4121,7200,7200,980,0,0,2817029,False
0vglf47DRi7PM9rY,1603292348,Bolt,4121,4121,-9100,-9100,980,0,0,2809829,False,X034-9APH-8A2C-2CK5
wGZK-FFYL6LOSkMh,1603289502,Bolt,4121,4121,-7200,-7200,980,0,0,2818929,False
i8_xCZTrItKiDRgL,1603274145,Bolt,4121,4121,-7200,-7200,980,0,0,2826129,False,29T9-085E-K186-131M
6KPJxH-XknUen7cQ,1603272951,Bolt,4121,4121,-6600,-6600,980,0,0,2833329,False,BE13-E268-M304-6C1C
EdqentJBGkIA15bI,1603268937,MAGAZYN DAY AND DAY,5499,5499,-1102,-1102,980,0,0,2839929,False,K066-1BM6-K630-X378
psvboA8uleqjtgm4,1603262563,Lesya,4829,4829,-300000,-300000,980,0,0,2841031,True,HK0X-7B00-H4K6-51A2
RHQn0czgVqY9MJgN,1603260396,Bolt,4121,4121,-5000,-5000,980,0,0,3141031,False
58F0r53IywEo0zfq,1603201263,–ü–∏—Ä—ñ–∂–∫–æ–≤–∞ ¬´–¢—ñ—Ç–∫–∞ –ö–ª–∞—Ä–∞¬ª,5814,5814,-25700,-25700,980,0,0,3146031,False,2H9B-97PH-8X3P-0EMC
J8xWfegygZXsY8aR,1603200910,–ö–æ–ª–æ,5411,5499,-13300,-13300,980,0,0,3171731,False,B002-BP2A-3P97-E76H
AynWVPg7-qh_npgE,1603178631,"–ö–∏—ó–≤—Å—Ç–∞—Ä
+380962159945",4814,4814,-10000,-10000,980,0,0,3185031,True,M7XB-CBH2-CK76-C6EP
W8nSqaGAUgRfmMLR,1603124768,MAGAZYN DAY AND DAY,5499,5499,-24300,-24300,980,0,0,3195031,False,2547-9067-B559-BKA0
59P_OGpGib2TokOq,1603115726,Raketa,4215,4215,-29600,-29600,980,0,2960,3219331,False,22E4-B564-4CMK-CHKH
1s7DcSSCWuWYPYA1,1603104301,Bolt,4121,4121,-4700,-4700,980,0,0,3248931,False,TPE0-A4K1-E0HM-C0P2
D1FZuI25AFf4VRIF,1603089058,Bolt,4121,4121,-5800,-5800,980,0,0,3253631,False,HA8A-H0CK-K3MX-0CMB
2IwYuM_2-ekOjCJy,1603077050,Netflix,7841,4899,-33411,-999,978,0,0,3259431,False,7T4P-K10C-HH97-46T9
3UCjRheY0X6FZnJe,1603015733,MAGAZYN DAY AND DAY,5499,5499,-37402,-37402,980,0,0,3292842,False,C0C2-6XBT-HBE9-9A99
RqKmmfP3oyLwgnfc,1602929325,MAGAZYN DAY AND DAY,5499,5499,-16500,-16500,980,0,0,3330244,False,250E-2194-6B10-1M70
ICeeTdRmeOOpP8Ji,1602837809,Lesya,4829,4829,-1200000,-1200000,980,0,0,3346744,True,7246-8EB9-HP3B-3EH0
40VMP1IAZzdgmZnP,1602837801,–ù–∞ –¥–æ–ª–∞—Ä–æ–≤—É –∫–∞—Ä—Ç–∫—É,4829,4829,-105413,-3700,840,0,0,4546744,True
ec4HyNTA7WiNJ3XZ,1602836796,–íi–¥: –ü–†–ò–•–û–î–¨–ö–û –ï.–í. –§–û–ü,4829,4829,3000000,3000000,980,0,0,4652157,True
Xgwq05K2Zj86uNLP,1602830925,iHerb,5499,5499,-282694,-282694,980,0,0,1652157,False,3XKB-C493-M299-10E6
hEbHuHUmmwbqLbV1vBuc,1602802750,Bolt,4121,4121,-7500,-7500,980,0,0,1934851,True
5cMTd6i2CuJMoSD8wK_mcdm8cw,1602802750,–°–∫–∞—Å—É–≤–∞–Ω–Ω—è. Bolt,4121,4121,7100,7100,980,0,0,1942351,False
_w6pAKQDT0TvFuX3,1602749264,Bolt,4121,4121,-7100,-7100,980,0,0,1935251,False
XUew6e-j0-LRZdMl,1602745272,MAGAZYN DAY AND DAY,5499,5499,-22200,-22200,980,0,0,1942351,False,TAK8-T7TC-TPK3-KMXK
ejzY8yfu703UJgdd,1602671143,LIQPAY*Luxury Beauty,5977,5977,-4100,-4100,980,0,0,1964551,False,X32B-X25K-5488-16E6
MJSXO1FC4jpKJlwf,1602668514,Yaroslaviv Val 37-1,5499,5499,-58900,-58900,980,0,0,1968651,False,P6T7-9077-HX53-AKPX
l6-MBJautlov8W8v,1602664006,FOODFACTOR,5499,5499,-5300,-5300,980,0,0,2027551,False,7XC9-99K9-8KA3-KX6M
DZpe5rdL9AvePCqU,1602659948,LIQPAY*Luxury Beauty,5977,5977,-46200,-46200,980,0,0,2032851,False,KHH7-026M-HAC9-752B
bQztAKNqE7b0wPui,1602588401,prom.ua,6538,6538,-19000,-19000,980,0,0,2079051,False,H89A-XET6-35PA-8H7T
gGZPIix6BBIlfsTi,1602578453,portmone.com.ua,4816,4816,-19380,-19380,980,0,0,2098051,False,B50E-ETHK-B55C-4PCE
nwkN1qNJ9DAXTThK,1602520050,MAGAZYN DAY AND DAY,5499,5499,-13600,-13600,980,0,0,2117431,False,0A9X-8EE4-67EC-44E2
DypdISovNgq74xig,1602488696,"Lifecell
+380631692598",4814,4814,-2000,-2000,980,0,0,2131031,True,EM62-MM5T-5C95-P88E
17X8Oby-X8qIAxyj,1602488577,"Lifecell
+380631692598",4814,4814,-8000,-8000,980,0,0,2133031,True,80XE-67C8-P90P-M2TX
mMwGPIHsF0U4_F4o,1602428485,–°–∫–∞—Å—É–≤–∞–Ω–Ω—è. Bolt,4121,4121,3049,10000,980,0,0,2141031,False
QB2lgvYWBCLTkvzb,1602427930,Bolt,4121,4121,-10000,-10000,980,0,0,2137982,False
NJ-sNdjC4Gatfn1a,1602424959,–ë–∞–±–µ–Ω–µ,5812,5812,-9000,-9000,980,0,0,2147982,False,EE1E-C2H8-CH8C-B7BH
vwzQrZFR10CVZwHF,1602424928,–ë–∞–±–µ–Ω–µ,5812,5812,-35500,-35500,980,0,0,2156982,False,PC98-2MEX-B624-PM15
8O3FmB237kmBfDVd,1602424906,RESTAURANT BABENE,5812,5812,-45000,-45000,980,0,0,2192482,False,B96X-61HT-23KT-56X6
N9XLY-mV6TQSaUAy,1602326493,Bolt,4121,4121,-6800,-6800,980,0,0,2237482,False,M239-ATKT-X4EE-M441
iKtRRVwoXjghiltr,1602325185,Bolt,4121,4121,-5400,-5400,980,0,0,2244282,False,46X7-42HP-TA88-5EX4
U8aILK6g3sc-oYKU,1602320741,Bolt,4121,4121,-3800,-3800,980,0,0,2249682,False,TPXT-ECE3-XMT4-799M
tyPnR2hyGNTKwhYB,1602319510,MAGAZYN DAY AND DAY,5499,5499,-1700,-1700,980,0,0,2253482,False,2892-C015-P44A-BKA8
ZATysyGYKYCnNfsb,1602318695,MAGAZYN DAY AND DAY,5499,5499,-42400,-42400,980,0,0,2255182,False,ET9E-305K-50E6-3P67
a1-0-qB0qykvAlQa,1602246172,Beer Market,5921,5921,-9000,-9000,980,0,0,2297582,False,65TB-ATM3-0M74-31EP
ciOx0HMJ0nwGzIl-,1602245096,–ß—ñ—á—ñ–∫–æ,5812,5812,-9000,-9000,980,0,0,2306582,False,2766-K489-A95A-6PEM
Lo47ZzNKXxdJjYdT,1602245079,restoranChChKO1,5812,5812,-69352,-69352,980,0,0,2315582,False,PK62-393K-TP7A-8K2E
MmxZ-ItqkYVExcOv,1602245059,–ß—ñ—á—ñ–∫–æ,5812,5812,-12500,-12500,980,0,0,2384934,False,HC23-T85X-3PC2-E11X
wJOuXD2gIHnIuaCb,1602235968,Bolt,4121,4121,-7900,-7900,980,0,0,2397434,False,PP9X-4A78-2H7C-2K4H
pBNLmKppL5asc_Fi,1602232622,Bolt,4121,4121,-7000,-7000,980,0,0,2405334,False,E518-BK96-B046-0025
FZ0TK6BjVbPgbsrMP2td,1602198126,Bolt,4121,4121,-7200,-7200,980,0,0,2412334,True
aeU9cP3KyVx-Us3jG-kWZ4Pycg,1602198126,–°–∫–∞—Å—É–≤–∞–Ω–Ω—è. Bolt,4121,4121,6600,6600,980,0,0,2419534,False
iQdPxNQa1fa75QnU,1602189396,–ö–æ—Å—Ç—è–Ω—Ç–∏–Ω –ü.,–†–æ—è–ª –≤–∏–∑ —á–∏–∑ üçî,4829,4829,-7000,-7000,980,0,0,2412934,True,TT15-449K-77HM-2584
QMVAFZ2ovo2SQOIM,1602172171,PYVNA DUMA,5812,5812,-54000,-54000,980,0,0,2419934,False,T34A-HAA8-4A11-4P00
u6mMeACVyvz7eYPa,1602149058,MAGAZYN DAY AND DAY,5499,5499,-26900,-26900,980,0,0,2473934,False,M349-C3BP-M9BH-A650
ZasvLi-Lj2kWCauC,1602142467,Bolt,4121,4121,-6700,-6700,980,0,0,2500834,False,97H2-0HC6-4M91-1P32
90idkb5hCkLkfqbi,1602135436,Bolt,4121,4121,-6600,-6600,980,0,0,2507534,False
qr8LrZM8bR4KWTP4,1602056997,Bolt,4121,4121,-1500,-1500,980,0,0,2514134,False,778M-C8K2-BB3A-3KBA
g8ihCwmvZKuRFZsU,1602006496,MAGAZYN DAY AND DAY,5499,5499,-28048,-28048,980,0,0,2515634,False,93MH-TA03-AX30-TK65
NL1wd3c4iKn3uBTD,1601912384,Lesya,4829,4829,-150000,-150000,980,0,0,2543682,True,P730-P63B-T9H9-26M2
VdK-JqinBd9TVRVm,1601900347,–°–∫–∞—Å—É–≤–∞–Ω–Ω—è. Bolt,4121,4121,6500,6500,980,0,0,2693682,False
utF2DA3rvFftdePn,1601900297,Bolt,4121,4121,-8600,-8600,980,0,0,2687182,False,3701-39K8-EC7E-MPKX
B35a2_OnljDcYRt5,1601897655,Bolt,4121,4121,-6500,-6500,980,0,0,2695782,False
iJrmLwd-I9ImJQbq,1601892781,Bolt,4121,4121,-4000,-4000,980,0,0,2702282,False,9P9T-TTBA-XBPB-0PP1
b_SJ2UTqFxZfQm_Z,1601837836,Uklon,4121,4121,-10800,-10800,980,0,0,2706282,False,A766-4H1K-K1KX-9459
PtOMEYyOBRAVqlEh,1601828572,Uklon,4121,4121,-12400,-12400,980,0,0,2717082,False,1M9E-3MHP-AP4P-C685
lob7sEsOC8saHebu,1601810775,Novus,5411,5411,-27447,-27447,980,0,0,2729482,False,MMHC-P406-H855-T34T
LI6U3sP-9PwP3C9Y,1601807937,Bolt,4121,4121,-11000,-11000,980,0,0,2756929,False,HX4P-1BMX-343X-01K4
XK9T3_a2KfzoVMOJ,1601807901,Beer Market,5921,5921,-28201,-28201,980,0,0,2767929,False,590P-5513-ME86-092B
DLXE8fhmFwRAE5Lb,1601807393,MAGAZYN DAY AND DAY,5499,5499,-52300,-52300,980,0,0,2796130,False,4MEA-XTKH-BHKE-TT37
i8vPjdBF1o2yqlJlbzKr4g,1601765927,Bolt,4121,4121,-6500,-6500,980,0,0,2848430,True
GOXO8YcTvuuGOaPfCKx3U_9Psg,1601765927,–°–∫–∞—Å—É–≤–∞–Ω–Ω—è. Bolt,4121,4121,5900,5900,980,0,0,2854930,False
KUP9UfWwU7sYCVXK,1601726793,Lesya,4829,4829,-200000,-200000,980,0,0,2849030,True,6H8X-1P66-24C5-MA78
gwaHAMpoGdrlq8-V,1601725421,MAGAZYN DAY AND DAY,5499,5499,-19500,-19500,980,0,0,3049030,False,K5CX-XB4H-97MB-C9KK
5XsXXPGOzvlWhQSL,1601654217,Bolt,4121,4121,-5900,-5900,980,0,0,3068530,False
oRAZ6Sj_BS8qNEWr,1601641393,Bolt,4121,4121,-7700,-7700,980,0,0,3074430,False,CAMH-P4A3-6E9B-5A29
yr3srdYObWRpxqU2,1601629228,WFP.ZOO.,5995,5995,-281700,-281700,980,0,50000,3082130,False,X0EK-884E-E0CH-5P8K
tY-8tcVj5PpSQkki,1601580481,Bolt,4121,4121,-6900,-6900,980,0,0,3363830,False,KME9-0AP4-728B-HCKB
5u-0J9AiYavnmkur,1601580416,Wine Love,5812,5812,-200000,-200000,980,0,0,3370730,False,844E-ABTE-28HT-H249
nMCuNnRHGR0Sx0f8,1601580346,Wine Love,5814,5814,-71000,-71000,980,0,0,3570730,False,4XM8-P9KC-5AH9-XEMK
Y9ockpMOZcv7wyVU,1601572279,Bolt,4121,4121,-10500,-10500,980,0,0,3641730,False,85K3-K31K-004A-659P
cvdH31xI7xBbJPpt,1601565230,–í—ñ–¥—Å–æ—Ç–∫–∏ –∑–∞ –≤–µ—Ä–µ—Å–µ–Ω—å,4829,4829,1980,1980,980,0,0,3652230,True
k1B27UOF_v_B3hkw,1601554515,–í–∏–≤–µ–¥–µ–Ω–Ω—è –∫–µ—à–±–µ–∫—É 187.25‚Ç¥,4829,4829,15073,15073,980,0,0,3650250,True
kJNeUrLZuapXiSPd,1601544799,Lesya,4829,4829,-1500000,-1500000,980,0,0,3635177,True,1657-06P6-CT30-BXTC
8YYj2ss8rtOLaBcT,1601544117,–ù–∞ –¥–æ–ª–∞—Ä–æ–≤—É –∫–∞—Ä—Ç–∫—É,4829,4829,-105111,-3700,840,0,0,5135177,True
_57NYSSdUYptzPIF,1601544060,–íi–¥: –ü–†–ò–•–û–î–¨–ö–û –ï.–í. –§–û–ü,4829,4829,3500000,3500000,980,0,0,5240288,True
L6JS8J7T6jA_efCl,1601542852,Bolt,4121,4121,-10000,-10000,980,0,0,1740288,False,K954-TH35-9M7E-HHCP
b7QokU50LjVnpXRo,1601539222,Flower Time,5992,5992,-28000,-28000,980,0,0,1750288,False,64PA-KACA-6136-6343
5aTgP2tdmKZZ25-E,1601538604,MAGAZYN DAY AND DAY,5499,5499,-16500,-16500,980,0,0,1778288,False,6AB5-C44E-41M6-HM1X
5AC0mGFIXPIw0zm-,1601538524,Bolt,4121,4121,-9000,-9000,980,0,0,1794788,False,AEH3-C59X-3T3M-9KH3
1otZWx4piLELtuq3,1606667477,Bolt,4121,4121,-8000,-8000,980,0,80,1705087,False,6X1M-4XHT-XXBP-65B3
xgndcGtC7TKcQdtk,1606667311,METRO,5399,5499,-9990,-9990,980,0,0,1713087,False,41HE-0C7M-KCPH-1P62
_R9JdJjq36AvIV4H,1606667197,METRO,5399,5499,-98686,-98686,980,0,0,1723077,False,BC45-5XPH-2C3A-031T
508oW61nYYggAFBG,1606666833,METRO,5399,5499,-121639,-121639,980,0,0,1821763,False,T44T-A17B-59H6-0441
CcHI76DD8g_IEzm5,1606661437,Bolt,4121,4121,-7400,-7400,980,0,74,1943402,False,TAM7-88E7-B066-H61P
2agLXKbPXf1s4M0S,1606649608,Bolt,4121,4121,-8500,-8500,980,0,85,1950802,False,X02B-74XE-HX53-6X09
-jOo5V_ByHQ4BE2r,1606572686,MAGAZYN DAY AND DAY,5499,5499,-49894,-49894,980,0,0,1959302,False,8PPH-9M3P-4P9T-BCAP
ne8uvgdX35duzWyb,1606565959,Uklon,4121,4121,-7000,-7000,980,0,700,2009196,False,0615-EE6M-P58X-18X1
XP1JVAI4v6HdyFUR,1606505036,Steam,5816,5816,-21800,-21800,980,0,0,2016196,False,4H9H-A4CX-1C43-98XB
LLY8TmbfnocP-dps,1606480951,–ß—ñ—á—ñ–∫–æ,5812,5812,-3000,-3000,980,0,90,2037996,False,M301-B1P9-B886-3470
t6CuGVaKawy667k0,1606480936,restoranChChKO1,5812,5812,-35000,-35000,980,0,1050,2040996,False,MCA6-E558-M377-HAB5
6JMnKWkQfevxvLGo,1606404049,Roshen,5441,5441,-5692,-5692,980,0,0,2075996,False,T877-4MPH-597C-HPX3
AKDDtmIpqVCxR0Z9,1606392217,–°—Ç–µ–π–∫—Ö–∞—É—Å,5814,5814,-12000,-12000,980,0,360,2081688,False,9TTC-B8KA-5HAT-PH0E
dK2gaFJ9tVAa-K6O,1606391839,–Ü–Ω–Ω–∞ –†.,4829,4829,-207000,-207000,980,0,0,2093688,True,2M9K-744X-4HKP-K486
jhowugl_oAp3BYOS,1606378958,MAGAZYN DAY AND DAY,5499,5499,-4800,-4800,980,0,0,2300688,False,5P7H-P8CK-69M8-B139
AtiVOJwwhD7UU0F7,1606326546,MAGAZYN DAY AND DAY,5499,5499,-19700,-19700,980,0,0,2305488,False,K2K0-M7A4-20B2-0T6B
mYPARjzZn8e6Jvmu,1606319992,Lesya,4829,4829,-100000,-100000,980,0,0,2325188,True,K9KT-8X6P-M73X-8EMT
l1Z4RRhP8o3OfZKf,1606237537,Lesya,4829,4829,-100000,-100000,980,0,0,2425188,True,3HE8-118C-C63B-5K18
tNI7XWqEtmpAAhs1,1606236907,EKOTOVARY,5411,5411,-9900,-9900,980,0,0,2525188,False,78H8-18BA-T54T-3X2K
THLBaiWb2C5ee66L,1606220603,Lesya,4829,4829,-250000,-250000,980,0,0,2535088,True,XC34-3713-17MB-57TX
NwdYlie0G37pfmhh,1606157392,536354****6752,4829,4829,-9800,-9800,980,0,0,2785088,True,X460-02B6-BHBE-9BPM
JE5BlwuwN8as3jIW,1606156419,–°–æ–∫—Ä–∞—Ç,5943,5943,-5900,-5900,980,0,0,2794888,False,0A3C-PAM3-54CA-8320
5dGN0vMG1A_uc4IX,1606156183,Beermood,4215,4215,-38000,-38000,980,0,0,2800788,False,K78E-P80P-KH2C-2C45
aZT9p6iv_TKIcIZi,1606155700,Novus,5411,5411,-18399,-18399,980,0,0,2838788,False,K3A3-K6K5-9417-7151
oReRFbEGP7z80s8v,1606145767,Bolt,4121,4121,-6000,-6000,980,0,600,2857187,False,1P57-EH42-32B6-B49C
frjSGdU_ASfGx_oV,1606133300,MAGAZYN DAY AND DAY,5499,5499,-21704,-21704,980,0,0,2863187,False,A313-9MMC-B8ME-9P2H
QeIvqCGsCQXNKnNN,1606079536,LIQPAY*Antonenko Marin,8999,8999,-32800,-32800,980,0,0,2884891,False,7TA2-C2A5-C1C7-8ET6
PuhABIBDFZvjmr7HL95f,1606004295,Bolt,4121,4121,-5200,-5200,980,0,520,2917691,True
zCbssDLtvQtIFldWfsHhEt20iA,1606004295,–°–∫–∞—Å—É–≤–∞–Ω–Ω—è. Bolt,4121,4121,4800,4800,980,0,-480,2922891,False
gXRYjiS_hNXyXZFp,1605974768,–ù–æ–≤–∞ –ø–æ—à—Ç–∞,4214,4214,-3500,-3500,980,0,0,2918091,False,92AC-01C2-K3C4-9X41
14bOLI4CFOeqawmB,1605960455,Bolt,4121,4121,-5500,-5500,980,0,550,2921591,False,BK31-H73E-TC31-XKP7
3UGaLIukSGXtKr5m,1605960432,–°–∫–∞—Å—É–≤–∞–Ω–Ω—è. Bolt,4121,4121,5500,5500,980,0,-550,2927091,False
TYXHw60tP08fTm8O,1605960339,Bolt,4121,4121,-5500,-5500,980,0,550,2921591,False
pagmm1ZYM6gC7hLL,1605952413,MAGAZYN DAY AND DAY,5499,5499,-23300,-23300,980,0,0,2927091,False,C706-P9KT-0PB6-4P2X
_bvnH49Oiv8E51C3,1605940716,Bolt,4121,4121,-4800,-4800,980,0,480,2950391,False
lLGs1DozJ2wbtw82,1605893847,–°–∫–∞—Å—É–≤–∞–Ω–Ω—è. Uklon,4121,4121,11100,11100,980,0,-1110,2955191,False
e9bbJpv2Xe8M7wIH,1605892007,Uklon,4121,4121,-11100,-11100,980,0,1110,2944091,False
5iWqD3CDdxtuit1O,1605888360,–°–∫–∞—Å—É–≤–∞–Ω–Ω—è. Bolt,4121,4121,10300,10300,980,0,-1030,2955191,False
t-f3HvX0myenrlyd,1605888303,Uklon,4121,4121,-11900,-11900,980,0,1190,2944891,False,51TE-XCT8-4MMC-M2HP
UBQMX1Myw3AUB_r5,1605888256,–°–∫–∞—Å—É–≤–∞–Ω–Ω—è. Bolt,4121,4121,9800,9800,980,0,-980,2956791,False
LXJaaIuVfT44IZQu,1605888234,Bolt,4121,4121,-10300,-10300,980,0,1030,2946991,False
HzCOIbxDjOzJ1gBU,1605887934,Bolt,4121,4121,-9800,-9800,980,0,980,2957291,False
awK8lAjm6I99nOR6,1605873868,Bolt,4121,4121,-5100,-5100,980,0,510,2967091,False,99HT-M6T7-AABE-HC3K
HACdhZ-ChGylmvFS,1605873503,Lesya,4829,4829,-300000,-300000,980,0,0,2972191,True,M7M4-9X33-001X-56C6
T7Z0otd8y4niYljXD_O9,1605831166,Bolt,4121,4121,-8200,-8200,980,0,820,3272191,True
Lo07ztA03-aLDM0-D_uFX8G1qg,1605831166,–°–∫–∞—Å—É–≤–∞–Ω–Ω—è. Bolt,4121,4121,8000,8000,980,0,-800,3280391,False
rbWwbbDHJ51_NPjk,1605782019,–ù–æ–≤–∞ –ø–æ—à—Ç–∞,7399,7399,-4000,-4000,980,0,0,3272391,False,B398-795B-A0B1-7X9B
r2qjQut8e9vC4pI5,1605782002,–ù–∞–∫–ª–∞–¥–µ–Ω–∏–π –ø–ª–∞—Ç—ñ–∂ (–ù–æ–≤–∞ –ø–æ—à—Ç–∞),6538,6538,-203300,-203300,980,0,0,3276391,False,EAM6-5T8M-1M73-415C
Q_Up_wVfIQ5iu_cM,1605780456,–ö–æ–ª–æ,5411,5499,-11000,-11000,980,0,0,3479691,False,377T-9MPT-H299-28E2
nMRuAlPfQmWoqUc4,1605779250,Bolt,4121,4121,-8100,-8100,980,0,810,3490691,False,266X-MM6P-5H2A-AAXM
_7GiecOig5Q04EJc,1605767658,Bolt,4121,4121,-8000,-8000,980,0,800,3498791,False
5KJAv46y1pB5wXmT,1605755779,Netflix,7841,4899,-33597,-999,978,0,0,3506791,False,H44A-ECK7-91KP-BXKC
1ye60PJf70v9oUCP,1605727287,Burger Farm,5814,5814,-42500,-42500,980,0,1275,3540388,False,538K-200C-HXM1-58X3
pnAR0cFKlE7XQQyk,1605712815,Lesya,4829,4829,-500000,-500000,980,0,0,3582888,True,77B1-1519-CX62-7TXB
cspLNCu8jwYVR3ca,1605703657,Bolt,4121,4121,-5400,-5400,980,0,540,4082888,False,B53T-EPPB-5KMH-CT0A
GyHtl7iSxqlpoDTu,1605692993,–°–∫–∞—Å—É–≤–∞–Ω–Ω—è. Bolt,4121,4121,4800,4800,980,0,-480,4088288,False
qkExyR8l_ZHc5wlO,1605692952,Bolt,4121,4121,-5800,-5800,980,0,580,4083488,False,T3E8-403X-AME1-84KB
trfiJbhGBeTUdnJ3,1605690847,Bolt,4121,4121,-4800,-4800,980,0,480,4089288,False
IH1n17GSZ2nGGRCx,1605639682,MAGAZYN DAY AND DAY,5499,5499,-16030,-16030,980,0,0,4094088,False,2075-HME1-9BAE-KPH9
_yydsnwsoTUWudva,1605619747,Bolt,4121,4121,-5400,-5400,980,0,540,4110118,False,K6M3-29KH-CTPE-4X9A
t-je0uQvcK4Ca5_I,1605534932,Lesya,4829,4829,-700000,-700000,980,0,0,4115518,True,M78B-E3EC-70H5-7576
O8hSdH9ZOX6siOap,1605533318,–ù–∞ –¥–æ–ª–∞—Ä–æ–≤—É –∫–∞—Ä—Ç–∫—É,4829,4829,-87886,-3100,840,0,0,4815518,True
pc9Rk_eJStOpl3Cs,1605533302,Lesya,4829,4829,-500000,-500000,980,0,0,4903404,True,M55P-E38B-X1K1-HXTC
CaA8wJrFutNJ_3Ag,1605531842,–ü–∏—Ä—ñ–∂–∫–æ–≤–∞ ¬´–¢—ñ—Ç–∫–∞ –ö–ª–∞—Ä–∞¬ª,5814,5814,-25700,-25700,980,0,771,5403404,False,9P5E-0MP8-3KHT-1K99
ur5z29LXPXFLTqge,1605530876,–ö–æ–ª–æ,5411,5399,-7500,-7500,980,0,0,5429104,False,8TC2-90MC-2T53-MTX4
H29qXPmSfG5hxmqT,1605528927,–íi–¥: –ü–†–ò–•–û–î–¨–ö–û –ï.–í. –§–û–ü,4829,4829,3700000,3700000,980,0,0,5436604,True
zDxh3awLrKzhpKqI,1605466156,MAGAZYN DAY AND DAY,5499,5499,-28890,-28890,980,0,0,1736604,False,68X9-3HAE-2AP1-9500
O2vYA54L4mTxwDgU,1605465311,Simona,5814,5814,-35400,-35400,980,0,354,1765494,False,23H7-49XM-A6A5-1177
07FDwjODBGXDIqeN,1605460451,Uklon,4121,4121,-28700,-28700,980,0,287,1800894,False,HM1P-XKBE-73K1-KM95
liLg_nCu-nL1O68j,1605450486,Bolt,4121,4121,-7200,-7200,980,0,72,1829594,False,MT8P-82M3-T2H2-AP8A
hhlaOdP6ecaIe7sg,1605448921,"–¢–µ–∞—Ç—Ä –ø–∏–≤–∞ ""–ü—Ä–∞–≤–¥–∞""",5812,5812,-7000,-7000,980,0,70,1836794,False,XXXH-1CX5-33KA-B56K
HrylxgyRx_aXVM7T,1605446764,FOP SITARCHUK D. A.,5812,5812,-40600,-40600,980,0,406,1843794,False,EHT8-EX2A-642H-1TMM
YjlZhtTMY4NRIP-G,1605446738,TZOV KUMPEL KRAFT,5812,5812,-4200,-4200,980,0,42,1884394,False,46MC-375A-T34A-8162
6NUnYLhKC6fw-hXZ,1605441861,–ì–∞—Å–æ–≤–∞ –ª—è–º–ø–∞ / Gas Lamp (–ì–∞—Å–æ–≤–∞ –õ—è–º–ø–∞),5812,5812,-7000,-7000,980,0,70,1888594,False,1HA4-BK68-173P-7C21
ZrQt1adZZU-Hj4mh,1605436682,KavaBezNazvi,5814,5814,-8500,-8500,980,0,85,1895594,False,H6T2-5TTP-8P61-874X
PTb1tAwXqT_S_M0i,1605435335,Candyandcolor,5441,5441,-66001,-66001,980,0,0,1904094,False,CM9X-1CMA-667M-97A9
KZtupJk5dVCV_9ZS,1605433651,Atelier 19,5814,5814,-38000,-38000,980,0,541,1970095,False,HE64-B1CX-P29C-A793
DYwslX3y_I6LSE_h,1605429821,Lesya,4829,4829,-50000,-50000,980,0,0,2008095,True,9M0E-TAK4-TX75-KTK8
uCjllE7N_S4TFuVq,1605428369,portmone.com.ua,4816,4816,-22440,-22440,980,0,0,2058095,False,AB2K-0X5A-H67K-A6C8
o2pGdKb9JyBo2wXz,1605382071,EPKChIZBURGER,5814,5814,-21900,-21900,980,0,657,2080535,False,ATKK-BE0K-ABK8-5TKH
_YvtkpI762Ulgr9t,1605382050,Epic Cheeseburger Cafe,5814,5814,-8000,-8000,980,0,240,2102435,False,2AA1-8PH6-4E59-2320
-xublvYdVhLokpCz,1605373409,–ì–∞—Å–æ–≤–∞ –ª—è–º–ø–∞ / Gas Lamp (–ì–∞—Å–æ–≤–∞ –õ—è–º–ø–∞),5812,5812,-7000,-7000,980,0,210,2110435,False,AKBT-PPHK-BHCT-E67X
Aq-VgX7rgSiB9sMN,1605369391,–ì–∞—Å–æ–≤–∞ –ª—è–º–ø–∞ / Gas Lamp (–ì–∞—Å–æ–≤–∞ –õ—è–º–ø–∞),5812,5812,-7000,-7000,980,0,210,2117435,False,PPB4-PK0A-6B09-M0E4
aosU2SBel4ERRRrs,1605367565,–ü—Ä–∞–≤–¥–∞. Beer Theatre,5812,5812,-8000,-8000,980,0,240,2124435,False,A9C3-30EK-5H9T-7H8T
7mMrQZgP3gKDEksQ,1605359574,RAMEN MO,5812,5812,-42700,-42700,980,0,1281,2132435,False,573M-MAPP-BP09-46KH
LL9ZRT3DBKJGmnJH,1605282850,AlkoDjutiPHri,5921,5921,-16500,-16500,980,0,0,2175135,False,0063-H5P1-9AE8-E315
uXxe7D-FxDWPOkt8,1605280795,LUSH LVIV SHOP,5977,5977,-53500,-53500,980,0,0,2191635,False,5EMK-BM6P-7710-CM8B
J5IQU31Ep0RRB0uq,1605268582,–°–∫–∞—Å—É–≤–∞–Ω–Ω—è. Bolt,4121,4121,5900,5900,980,0,-590,2245135,False
AnMtLvAiQb-JGUtz,1605268573,Bolt,4121,4121,-5800,-5800,980,0,580,2239235,False,20M1-T0HC-96H6-A1B6
FuwjSWBYpuU7vZcb,1605268251,Bolt,4121,4121,-5900,-5900,980,0,590,2245035,False
zSHfeyDLMGS4m0a8,1605243053,–°–∫–∞—Å—É–≤–∞–Ω–Ω—è. Bolt,4121,4121,4600,4600,980,0,-460,2250935,False
XwVe7ieXVtFkfEYR,1605243007,Bolt,4121,4121,-6400,-6400,980,0,640,2246335,False,744H-0822-E443-E782
27mdzKJorxb90lQ8,1605240867,Bolt,4121,4121,-4600,-4600,980,0,460,2252735,False
VLOdtuakIYkyuNr4,1605219682,–§–∞—Ä–º–∞—Ü—ñ—è,5912,5912,-8850,-8850,980,0,0,2257335,False,EM49-C3H2-B4A6-T6KM
8ak09MO29hpq25lM,1605218337,Old Bricks,5814,5814,-40000,-40000,980,0,1200,2266185,False,98HC-8CBP-0K8M-C3C5
ZUT2SIq47YU3BrjE,1605205424,Bolt,4121,4121,-4500,-4500,980,0,450,2306185,False,07B0-X2XM-TC80-H7P6
xLs-w9aobykIqw0n,1605182598,Glovo,4215,5814,-33900,-33900,980,0,0,2310685,False,E8X7-K94A-372P-KX6T
_LzZAKObXIA-vRci,1605170217,Right Coffee Bar,5814,5814,-23400,-23400,980,0,702,2344585,False,76K7-MMA4-ABPM-78TX
yCeupmLHQLLHXQQF,1605037655,MAGAZYN DAY AND DAY,5499,5499,-12400,-12400,980,0,0,2367985,False,9CK4-T237-9P0C-5050
cTjW_8DXCcJrROTN,1604998318,Lesya,4829,4829,-300000,-300000,980,0,0,2380385,True,H8K0-TXA9-M030-4TE3
Ma2Xb4thzoNlF3fa,1604952991,LIQPAY*Foundation Coff,5812,5812,-36470,-36470,980,0,1094,2680385,False,1CT5-X87T-EE4M-04H2
4YAbQIrLlH4RLw7P,1604929381,Lesya,4829,4829,-200000,-200000,980,0,0,2716855,True,CMMM-911X-AKAP-CA6C
NqtQLqiliaa6xRPI,1604919858,–íi–¥: –ü–†–ò–•–û–î–¨–ö–û –ï.–í. –§–û–ü,4829,4829,1200000,1200000,980,0,0,2916855,True
mphHYDicPdYwSlQG,1604917922,"Lifecell
+380631692598",4814,4814,-1000,-1000,980,0,0,1716855,True,0127-A332-C889-98TK
MaKLoah5oZhL9KiD,1604917757,"Lifecell
+380631692598",4814,4814,-10000,-10000,980,0,0,1717855,True,XK27-0541-T6X0-846E
RAv-zvsovCoMrp-Z,1604910756,MAGAZYN DAY AND DAY,5499,5499,-20000,-20000,980,0,0,1727855,False,3862-P179-02BT-6E05
SBmZgu2C9rEFehhs,1604834085,MAGAZYN DAY AND DAY,5499,5499,-157641,-157641,980,0,0,1747855,False,9H29-KC15-MHM1-KAP2
6z9-LQ7p3HVhmTaG,1604749974,Bolt,4121,4121,-6600,-6600,980,0,66,1905496,False,C9E8-M5AM-EM48-4X6K
v9a-yYEt75UbrSf1,1604749902,Goodwine,5921,5921,-82600,-82600,980,0,0,1912096,False,BBK5-M431-1T15-0471
sivuLa1C3Ap_eaDn,1604748630,AptekaANRIPHARM,5912,5912,-1300,-1300,980,0,0,1994696,False,95HT-AP5B-43X1-5M4B
m0ei01wrsZOzQS_P,1604742787,MAGAZYN DAY AND DAY,5499,5499,-16500,-16500,980,0,0,1995996,False,C3T9-MH3M-3C33-BA56
yZXCGz_LFw5_YsOz,1604686622,TCPIZZA,5814,5814,-60000,-60000,980,0,1800,2012496,False,110C-22M5-TEB9-94B5
GP2gR11gIdl0KpkM,1604686041,Lesya,4829,4829,-100000,-100000,980,0,0,2072496,True,X4E3-7E62-57MC-H0E6
85GU-2pZnKLQa_kS,1604664179,Lesya,4829,4829,-100000,-100000,980,0,0,2172496,True,0XTH-XBM0-3EP2-X6C9
ThpykSR3N3Cbd1O5,1604649677,MAGAZYN DAY AND DAY,5499,5499,-6050,-6050,980,0,0,2272496,False,71X9-H034-TKB8-960M
I4Y2sVZ6aGuxRJy4UpaCnA,1604620779,Bolt,4121,4121,-9100,-9100,980,0,910,2278546,True
Su9MGfUYLZkM5c57IzUD0oGweQ,1604620779,–°–∫–∞—Å—É–≤–∞–Ω–Ω—è. Bolt,4121,4121,8500,8500,980,0,-850,2287646,False
4TDejeYVhEN1AMlb,1604572437,MC UNIVER KLINIK,8062,8062,-180000,-180000,980,0,0,2279146,False,8MM3-9C16-0833-PC14
KZ2Zz7-QaTeRkQUJ,1604571232,MAGAZYN DAY AND DAY,5499,5499,-12900,-12900,980,0,0,2459146,False,4CX4-762M-0CCH-BBAH
ChPxjkvm-CwZJ9lk,1604565427,Bolt,4121,4121,-8500,-8500,980,0,850,2472046,False,PM2X-E33X-A8E1-191K
LMH4n-q0cDRT6_Qf,1604558240,Bolt,4121,4121,-8500,-8500,980,0,850,2480546,False
hc4pyQ-B4W9D28dxFffZ,1604534683,Bolt,4121,4121,-4900,-4900,980,0,490,2489046,True
u9hNjehBzAGiNSE_eUquyhDOBA,1604534683,–°–∫–∞—Å—É–≤–∞–Ω–Ω—è. Bolt,4121,4121,4500,4500,980,0,-450,2493946,False
cBdf9CNCYGutQSID,1604524427,Lesya,4829,4829,-500000,-500000,980,0,0,2489446,True,1P28-B24K-H846-XH9E
dNRyX60mVQfFCJyS,1604492736,–ö–æ–ª–æ,5411,5499,-11000,-11000,980,0,0,2989446,False,049H-TMA7-4558-76K9
HNOF4Jb38PFApf9g,1604479197,Bolt,4121,4121,-4500,-4500,980,0,450,3000446,False
2-enLOZZyRrCgE4t,1604476203,MAGAZYN DAY AND DAY,5499,5499,-15800,-15800,980,0,0,3004946,False,H28H-370C-485A-AX6P
_o4mOhqqsu2Tux2h,1604410840,Yaroslaviv Val 37-1,5499,5499,-23900,-23900,980,0,0,3020746,False,H6HK-7364-223B-C01C
kNjSRPXGFReUjyjd,1604404249,Bolt,4121,4121,-5300,-5300,980,0,530,3044646,False,73KA-P87B-9471-BM09
gf3bYwgvMtzdetHD,1604394653,–ê–ø—Ç–µ–∫–∞,5912,5912,-2500,-2500,980,0,0,3049946,False,059E-5092-8C12-46XP
Bo3-T4zB5ISxQj7i,1604341442,MOYO,5722,5045,-109900,-109900,980,0,0,3052446,False,7XH9-14K3-0XET-7MPX
3SB7dF54E_VQ_P9m,1604338879,516875****4182,4829,4829,-3000,-3000,980,0,0,3162346,True,P104-2P67-68P8-ABPM
FQN4cB29dv3nO86Z,1604338865,516875****4182,4829,4829,-55000,-55000,980,0,0,3165346,True,P0B6-5EM6-TCPE-B2TA
ghxYHdIqrztigOHe,1604336741,Beer Market,5921,5921,-27750,-27750,980,0,0,3220346,False,1011-BK24-X334-KAHB
1OEKmBZjvCDr3-HU,1604316740,–ù–∞ –¥–æ–ª–∞—Ä–æ–≤—É –∫–∞—Ä—Ç–∫—É,4829,4829,-37245,-1300,840,0,0,3248096,True
_CJHNMxGOPi0c_en,1604316716,Lesya,–Ω–∞ —Å–∞–º—Å–∏–Ω –ø—Ä–∏—Ç–∏ üíÑ,4829,4829,-1500000,-1500000,980,0,0,3285341,True,58MH-8PB8-C6C6-07T8
W2lbPHIgWBXSom8Z,1604315062,–íi–¥: –ü–†–ò–•–û–î–¨–ö–û –ï.–í. –§–û–ü,4829,4829,3600000,3600000,980,0,0,4785341,True
YHGz9ZpTamzK6xVl,1604310857,516874****4509,4829,4829,-20800,-20800,980,800,0,1185341,True,P587-T0T2-1M8H-744M
4qFdKSF0K9Bj9JuV,1604301954,LjaPHabrik,5814,5814,-13500,-13500,980,0,135,1206141,False,EP3M-115A-962X-76XT
pupJDkjNSMwE1tKG,1604252699,–ê–ø—Ç–µ–∫–∞ –ù–∏–∑—å–∫–∏—Ö –¶—ñ–Ω,5912,5912,-40690,-40690,980,0,0,1219641,False,AHM4-9PK9-80XK-C4A5
T3vOYT03s_CoYHyY,1604248466,MAGAZYN DAY AND DAY,5499,5499,-23050,-23050,980,0,0,1260331,False,3PHK-BK56-THMT-BH81
Qola45d4rwW-qoNP,1604234214,–í—ñ–¥—Å–æ—Ç–∫–∏ –∑–∞ –∂–æ–≤—Ç–µ–Ω—å,4829,4829,1953,1953,980,0,0,1283381,True
MEUSwtteO-yO1tts,1604232169,–í–∏–≤–µ–¥–µ–Ω–Ω—è –∫–µ—à–±–µ–∫—É 500.00‚Ç¥,4829,4829,40250,40250,980,0,0,1281428,True
jFb9rl6e8MisrOxq,1604227170,EVA,5977,5977,-18890,-18890,980,0,0,1241178,False,6E03-498T-K491-C9B7
-Se4Ir68uCUCF2qX,1604217998,bwtc cafe&roasters,5814,5814,-20500,-20500,980,0,0,1260068,False,9BK9-MMH3-0XAX-KA94
pupJDkjIQMgK1NiG,1604217497,–•–ª–µ–±–Ω—ã–π,5814,5814,-13200,-13200,980,0,0,1280568,False,563M-355X-55P9-H030
uYKOFLLt63lFG0eE,1609329266,Lesya,4829,4829,-500000,-500000,980,0,0,4527587,True,77EH-XKMP-KCMK-M1AC
Z1XA52U29M0SAhXG,1609323573,–íi–¥: –ü–†–ò–•–û–î–¨–ö–û –ï.–í. –§–û–ü,4829,4829,3200000,3200000,980,0,0,5027587,True
N3zHW50eYmHzTbYi,1609316697,MAGAZYN DAY AND DAY,5499,5499,-11000,-11000,980,0,0,1827587,False,25XT-4K6H-P5P9-EKT1
Wja2ciLa3PncbYqe,1609314429,Bolt,4121,4121,-5100,-5100,980,0,0,1838587,False
uQPTlji0LLDvkw8C,1609311942,–ü–ª–∞—Ç—ñ–∂ COMFY,4829,4829,-139980,-139980,980,0,0,1843687,True
CFO1pA5Bi7N7Unl0,1609248590,–°—ñ–ª—å–ø–æ,5411,5411,-180420,-180420,980,0,3087,1983667,False,E59E-X1AK-3P53-1207
PPAGaRQ48aoS8tFl,1609243973,–ù–æ–≤–∞ –ø–æ—à—Ç–∞,7399,7399,-13900,-13900,980,0,0,2164087,False,P8CC-H7A6-3BE5-HHXX
oYzuXP2TuoEDTSms,1609243159,PHotosalonMAN,7221,7221,-12000,-12000,980,0,0,2177987,False,E4XP-M625-M512-A1E9
KfTC_vu2tW3xmR3o,1609242814,KHUDOZHNII SALON,5970,5970,-24000,-24000,980,0,0,2189987,False,CC6X-C7M1-6071-A3EH
e3XLgGOR0Bn3OIyB,1609241516,Honey. Cafe-confectionery,5814,4215,-55000,-55000,980,0,0,2213987,False,5H8X-5K4E-BXT2-C70B
SZ8NKdwbVTISlbG-,1609238783,–°–∫–∞—Å—É–≤–∞–Ω–Ω—è. Bolt,4121,4121,17200,19800,980,0,-1720,2268987,False
KkB8T_9j0qXckrdU,1609237903,–ö–∏—ó–≤—Å—å–∫–µ –º–µ—Ç—Ä–æ,4111,4111,-800,-800,980,0,0,2251787,False,X0E3-M23E-33M5-P723
vnpnJg9y4NMeJCHt,1609236808,Bolt,4121,4121,-19800,-19800,980,0,1980,2252587,False
Iq91YVakf5V7lioN,1609232134,–°–∫–∞—Å—É–≤–∞–Ω–Ω—è. Bolt,4121,4121,6400,21600,980,0,-640,2272387,False
8oCjwcHmS17kfVi6,1609228328,Bolt,4121,4121,-21600,-21600,980,0,2160,2265987,False
VPD9fFb3WcYWWJaR,1609142621,MAGAZYN DAY AND DAY,5499,5499,-28600,-28600,980,0,572,2287587,False,X313-96E0-28BC-P79H
5rznEV_tSDtOfkHK,1609075976,Bolt,4121,4121,-7200,-7200,980,0,720,2316187,False,8MCK-APCH-0M82-PMHC
5-cDrfdRAJnuAMrw,1609072221,Bolt,4121,4121,-7800,-7800,980,0,780,2323387,False,9BT2-E8M2-KM74-32E1
NQ2Wl6dcA__3Msl5,1609066012,–Ü—Ä–∏–Ω–∞ –¢.,–∫–∞–ª–µ–Ω–¥–∞—Ä–∏ üìÜ,4829,4829,-40000,-40000,980,0,0,2331187,True,9M7E-AMEM-B6TH-6XC4
XRYV74Pt3AuWQ7IV,1609004728,MAGAZYN DAY AND DAY,5499,5499,-4600,-4600,980,0,92,2371187,False,7T98-A953-85KA-05B9
WN8hLHM7U-MRC1XB,1608989480,–ö–æ–ª–æ,5411,5499,-1000,-1000,980,0,20,2375787,False,T8PK-1EH7-TAKE-1T24
hileAeLegpNnJl8i,1608979071,–°—ñ–ª—å–ø–æ,5411,5411,-48178,-48178,980,0,963,2376787,False,9564-2MMM-350C-82T9
tFhOmW_EV0Vjy80r,1608979026,–°—ñ–ª—å–ø–æ,5411,5411,-16500,-16500,980,0,330,2424965,False,9M6P-1CT3-5HTC-TMK5
EimepvO3nxDw7cas,1608977239,Lesya,4829,4829,-100000,-100000,980,0,0,2441465,True,P9HB-AE30-4P37-5TP8
Q-dek_o29NiCo7Fd,1608971758,Lesya,4829,4829,-5000,-5000,980,0,0,2541465,True,A0B6-56PK-HX0H-AKCE
KvLYP_5xGXc_HhwI,1608910847,414949****7383,4829,4829,-12000,-12000,980,0,0,2546465,True,XBAM-HPX8-78HE-T61E
1CWyuxANiVygDZu4,1608884630,–ù–æ–≤–∞ –ø–æ—à—Ç–∞,4214,4214,-123400,-123400,980,0,0,2558465,False,PCC5-6C4E-A033-6KHT
3ZnWM2L_Jqrye-L1GJrP,1608855851,Bolt,4121,4121,-7600,-7600,980,0,760,2681865,True
zXlW_8bAhR22UPK514244a5SIA,1608855851,–°–∫–∞—Å—É–≤–∞–Ω–Ω—è. Bolt,4121,4121,6900,6900,980,0,-690,2689465,False
RlzIiWr5jY4cdUoK,1608851634,Bar /13,5814,5814,-4000,-4000,980,0,0,2682565,False,C87B-H6HH-9HKK-B952
ULyHghkBtclgoOI9,1608851618,Bar /13,5814,5814,-28000,-28000,980,0,0,2686565,False,A2AB-T97E-P2AC-3BXE
WjBDCLn58m--0Vmz,1608818318,–•–º—ñ–ª—å–Ω–∏–π –ö–Ω—è–∑—å,5812,5812,-13000,-13000,980,0,0,2714565,False,CC5E-X12K-0X1A-M1A6
EWHiUSzDajLsWAJf,1608818297,–•–º—ñ–ª—å–Ω–∏–π –ö–Ω—è–∑—å,5812,5812,-8000,-8000,980,0,0,2727565,False,58P2-11T9-2A0X-EM8X
zubiT8KAfBbW4IZM,1608803685,iPay.ua,7399,7399,-220500,-220500,980,0,0,2735565,False,X86B-K13P-8HX5-7PKP
5DYWW7cSOkB8n0g0,1608802127,Bolt,4121,4121,-6900,-6900,980,0,690,2956065,False
QNR_U2AsVOKZKUsd,1608791456,Bolt,4121,4121,-9800,-9800,980,0,980,2962965,False,PK3A-C365-6BXB-B1T8
Vnd0xK_zoRlWhDhP,1608755075,MAGAZYN DAY AND DAY,5499,5499,-25500,-25500,980,0,510,2972765,False,82M8-X77K-34C5-1XB0
mGm9xz8cxxQZUoTX,1608652635,MAGAZYN DAY AND DAY,5499,5499,-11000,-11000,980,0,220,2998265,False,P9HH-M642-11B6-3HC8
NpVIypgoNFvPRNA6,1608651069,Bolt,4121,4121,-10500,-10500,980,0,1050,3009265,False,B9E4-3PHP-XXBB-P62H
t_nCdoLndiV9gFf086537A,1608597391,Bolt,4121,4121,-6800,-6800,980,0,680,3019765,True
jBpIH7GTrLhbCCuKCPSplA,1608597391,Bolt,4121,4121,-5800,-5800,980,0,580,3026565,True
f8Vec7mPI44k3cpIiAVxmpMzGw,1608597391,–°–∫–∞—Å—É–≤–∞–Ω–Ω—è. Bolt,4121,4121,6400,6400,980,0,-640,3032365,False
8H1sB6mQV_UeWfJlzOxro9kiag,1608597391,–°–∫–∞—Å—É–≤–∞–Ω–Ω—è. Bolt,4121,4121,5500,5500,980,0,-550,3025965,False
TqMXRIs6MRxW4poa,1608575065,MAGAZYN DAY AND DAY,5499,5499,-3350,-3350,980,0,67,3020465,False,5588-KM1P-M8BM-TH5H
6UndLRMswXbtkAH5,1608560775,Lesya,4829,4829,-700000,-700000,980,0,0,3023815,True,E4X6-C239-T2C2-PH4A
M3hO54YV2TAwTJE7,1608535488,MAGAZYN DAY AND DAY,5499,5499,-12650,-12650,980,0,253,3723815,False,3350-H8T6-M4EB-55KP
ScN7rTrxj_o4EYAz,1608464667,Bolt,4121,4121,-6400,-6400,980,0,640,3736465,False
2Cdv5K3ixucn6FGb,1608457621,Bolt,4121,4121,-5500,-5500,980,0,550,3742865,False
dyUAsLMHwMqNjHa5,1608396637,Flower Time,5992,5992,-36000,-36000,980,0,0,3748365,False,7EX3-6C81-TM45-H6BX
wEfcr27Co_yVi_ci,1608395994,MAGAZYN DAY AND DAY,5499,5499,-17300,-17300,980,0,346,3784365,False,H47P-565B-9M1H-P9C7
N5mDTnB69FQK8Zdz,1608393010,Raketa,4215,4215,-71300,-71300,980,0,3565,3801665,False,10B0-XP9T-9BK2-6TK3
z4VrPrL-Ktkp8ahh,1608364111,MAGAZYN DAY AND DAY,5499,5499,-21650,-21650,980,0,433,3872965,False,XC2B-XC6P-P306-MXA6
c4hpsh469mbmqMFO,1608350067,Netflix,7841,4899,-34415,-999,978,0,0,3894615,False,0680-926A-B202-A121
8eCTiBeg0H9-VWqE,1608247362,–°–∫–∞—Å—É–≤–∞–Ω–Ω—è. Bolt,4121,4121,1600,13600,980,0,-160,3929030,False
h81HJ7bF9bh4lZlH,1608244389,Bolt,4121,4121,-13600,-13600,980,0,1360,3927430,False
jkon0F2HxxrJZy5X,1608225973,Bolt,4121,4121,-18400,-18400,980,0,1840,3941030,False,74XB-27K4-K7B3-9E69
X_sWWwaEQNY5lkiT,1608218985,–ù–æ–≤–∞ –ø–æ—à—Ç–∞,7399,7399,-4800,-4800,980,0,0,3959430,False,MT41-BKH8-3799-M5A9
d-c3nLFc0Cb8vsCd,1608206001,516780****6499,4829,4829,-365000,-365000,980,0,0,3964230,True,KB68-1T4X-9925-6PBC
ObuIuoaCOt3y79IJ,1608203999,MAGAZYN DAY AND DAY,5499,5499,-16500,-16500,980,0,330,4329230,False,C146-5KKB-KX37-0KMH
nKwarfJUiusda7BN,1608199560,portmone.com.ua,4816,4816,-22440,-22440,980,0,0,4345730,False,K816-MXP0-2E0A-5PH2
u9xi9IQ4lkzOosmw,1608141904,MAGAZYN DAY AND DAY,5499,5499,-5500,-5500,980,0,110,4368170,False,E3TE-13H2-6T1P-7C6C
J2w7zy3hU3_bMHd9,1608120206,Bolt,4121,4121,-9700,-9700,980,0,970,4373670,False,T2BK-7ABA-3CP9-45B1
Y1fVDOb6YDq34fzQ,1608116812,Bolt,4121,4121,-6000,-6000,980,0,600,4383370,False,A59T-MKM3-M59P-K2B6
S9OM0JAqDjdefYxx,1608112113,Lesya,4829,4829,-200000,-200000,980,0,0,4389370,True,BT83-H9BP-KB24-X4B9
_jSHGsoI6l9rcp65,1608104717,LIQPAY*FOP Naumenko Ol,7278,7278,-214208,-214208,980,0,0,4589370,False,CA02-KKM9-1CHP-T76T
xoCQC74cmuzIigYTbjo5,1608078514,Bolt,4121,4121,-4100,-4100,980,0,410,4803578,True
VzgGWNKG8Vo0U1AXalWaoYwHAw,1608078514,–°–∫–∞—Å—É–≤–∞–Ω–Ω—è. Bolt,4121,4121,3900,3900,980,0,-390,4807678,False
oHZgBpT_en4ym-y4,1608066442,Lesya,4829,4829,-1500000,-1500000,980,0,0,4803778,True,TM88-3PCK-812T-9T30
gZpeaZwtWnZ1SUBE,1608059441,MAGAZYN DAY AND DAY,5499,5499,-24700,-24700,980,0,494,6303778,False,C1TE-A81P-578K-M128
4DfUeBiYn02_-fwC,1608042473,536354****5207,4829,4829,-600000,-600000,980,0,0,6328478,True,MPK9-441T-3778-CB5C
mdx5jwaDJf0LhS6v,1608038605,WINETIME,5411,5411,-51300,-51300,980,0,1026,6928478,False,K7P0-H104-AB9C-44HM
zWlBM-agoqT0-C6x,1608035601,Glovo,4215,4111,-19900,-19900,980,0,0,6979778,False,XTCE-AAA3-H7MC-BTPM
xGw_cH8XI84zHUVn,1608031911,Bolt,4121,4121,-5700,-5700,980,0,570,6999678,False,H3CX-387T-2TTK-PKBC
uJ11Y5WjrFmlhv7F,1608026562,GuniaProject,5631,5631,-130000,-130000,980,0,0,7005378,False,P326-CH9P-6A78-20K0
32qCUmA74dTF3FsQ,1608024787,–íi–¥: –ü–†–ò–•–û–î–¨–ö–û –ï.–í. –§–û–ü,4829,4829,5100000,5100000,980,0,0,7135378,True
-FSaHXm81Tl6rpPy,1608023950,Bolt,4121,4121,-3900,-3900,980,0,390,2035378,False
etvHhER_8WiuD6-5,1607948401,MAGAZYN DAY AND DAY,5499,5499,-32134,-32134,980,0,642,2039278,False,9HX4-H9AT-4KHM-9B2H
7V78UQUjSX630oBe,1607934999,MAGAZYN DAY AND DAY,5499,5499,-29750,-29750,980,0,595,2071412,False,MHP6-360E-55E5-2P29
cEBv100JeLJSZi_j,1607869361,–í—ñ–¥: –û–ª–µ—Å—è –°.,4829,4829,700000,700000,980,0,0,2101162,True
S7dxuBPxAez27aML,1607853532,Fotovramke,7221,7221,-12500,-12500,980,0,0,1401162,False,0BHM-E4M1-723P-26BM
xc_aXFZQ_e7NOQBG,1607779612,Bolt,4121,4121,-14900,-14900,980,0,149,1413662,False,7371-M6BE-KEH2-6C9M
jdXN1O5z1Xtb5sKJ,1607779391,–°—ñ–ª—å–ø–æ,5411,5411,-157114,-157114,980,0,1571,1428562,False,5H9B-AP6T-EKMT-E7KM
QesWDR2SZCN2lOxY,1607776058,–ï–ø—ñ—Ü–µ–Ω—Ç—Ä,5200,5200,-61996,-61996,980,0,0,1585676,False,BB36-B32P-9X0E-E8EB
pBGK8qlCjVhy5A5T,1607773610,–°–∫–∞—Å—É–≤–∞–Ω–Ω—è. Bolt,4121,4121,1000,14200,980,0,-10,1647672,False
RE5VbS4AFdDpI2Nf,1607770892,Bolt,4121,4121,-14200,-14200,980,0,142,1646672,False
OEGWIEc5Dlk7yqnO,1607710237,–ù–æ–≤–∞ –ø–æ—à—Ç–∞,4214,4214,-4100,-4100,980,0,0,1660872,False,XXXA-18TP-B86X-7T2A
TYXHwq0tOk4fSW8A,1607704269,fondy.ua,5499,5499,-72300,-72300,980,0,723,1664972,False,CBEC-CP74-3HTH-0KCC
W3RMJKxbrJSLFVEz,1607697810,Uklon,4121,4121,-10900,-10900,980,0,109,1737272,False,HC9P-8HXE-2EAH-X97T
5DsU2DQA7HMDte8A,1607695732,Bolt,4121,4121,-11800,-11800,980,0,118,1748172,False,KM70-47EB-KM52-481H
nzNKRrybgekU5yzd,1607692125,Bolt,4121,4121,-15000,-15000,980,0,150,1759972,False,THA0-P7M3-8X97-PXMP
T0K5fcixg2jBQ8og-ilD,1607644572,Bolt,4121,4121,-10300,-10300,980,0,103,1774972,True
Mu_TbkW4Emp_wVbGZvkl6j8sPg,1607644572,–°–∫–∞—Å—É–≤–∞–Ω–Ω—è. Bolt,4121,4121,9700,9700,980,0,-97,1785272,False
IW7rawHmftcgLL9r,1607596985,LIQPAY*Foundation Coff,5812,5812,-37800,-37800,980,0,0,1775572,False,TTHC-PB58-X8TP-11BT
az7qWS8r8ZOmLG9l,1607596369,Bolt,4121,4121,-9700,-9700,980,0,97,1813372,False
nfD6wKcC_y_R0X2s,1607591960,–ü–ª–∞—Ç—ñ–∂ stol-i-stul.com.ua,4829,4829,-249950,-249950,980,0,0,1823072,True
MU4dSahMHdG7bCdI,1607547098,ZOOLYUKS,5995,5995,-45700,-45700,980,0,0,2073022,False,P219-EHMH-5H66-MA8P
l8SLjeNKFFDXLn9a,1607544536,Uklon,4121,4121,-6500,-6500,980,0,650,2118722,False,HC6A-HA59-0P9P-MCH0
xBczwqnkqCFjK1mT,1607529760,MAGAZYN DAY AND DAY,5499,5499,-31500,-31500,980,0,630,2125222,False,7TC9-X791-6520-7P0P
-gbUyt4ZRqGH_mOb,1607527103,Bolt,4121,4121,-11400,-11400,980,0,1140,2156722,False,B777-8M2E-8T2C-X1BH
HxYjvPSUlSZMB3Nk,1607522633,Bolt,4121,4121,-8800,-8800,980,0,880,2168122,False,A745-T6X8-E6K6-4BC5
NznR-qXg7eCCkF2s,1607519860,–°–∫–∞—Å—É–≤–∞–Ω–Ω—è. Bolt,4121,4121,8600,8600,980,0,-860,2176922,False
a26yXtYmEDQ6qcqz,1607519810,Bolt,4121,4121,-11600,-11600,980,0,1160,2168322,False,MB51-2MAC-MB39-63CX
KjdyA3vMZKQROuTU,1607519239,Bolt,4121,4121,-6100,-6100,980,0,610,2179922,False,EP40-16K6-AE77-P0BC
NRIWaaSj3RQ3EgIh,1607516379,Bolt,4121,4121,-8600,-8600,980,0,860,2186022,False
pbSiNKyfpTvm6Zh4,1607505258,Bolt,4121,4121,-11700,-11700,980,0,1170,2194622,False,E9B2-6CCX-KCHB-P6P0
iDG5SHsqKhSuKmu8,1607502246,Bolt,4121,4121,-7500,-7500,980,0,750,2206322,False,T2P2-E242-8TK0-M90K
pnwTQ3-bLeYtem9g,1607451202,MAGAZYN DAY AND DAY,5499,5499,-14200,-14200,980,0,284,2213822,False,KK67-202B-MEC0-3E6X
eT71gQnV68TnkU14,1607449906,Glovo,4215,4111,-33400,-33400,980,0,0,2228022,False,0PK1-P6K1-E8PT-10T4
mulIk_xaA5tuRsdWdGtWuw,1607403514,Bolt,4121,4121,-6000,-6000,980,0,600,2261422,True
2O1QqW57At7VpFwaBiA0uz5ZCw,1607403514,–°–∫–∞—Å—É–≤–∞–Ω–Ω—è. Bolt,4121,4121,5600,5600,980,0,-560,2267422,False
snQCxH4nseOsdbt9,1607365489,OkvajnSichovih,5399,5399,-46880,-46880,980,0,937,2261822,False,B0TC-3AA5-M1XT-C7HE
xBQbWwL461t8gkzL,1607364748,Roshen,5441,5441,-18675,-18675,980,0,373,2308702,False,369T-7H15-HB40-5X1B
ysTlNL14e6vk_xbF,1607364000,MAGAZYN DAY AND DAY,5499,5499,-11600,-11600,980,0,232,2327377,False,7KC9-H915-TEPT-MM9H
AwtGDqPY6MHx4wGd,1607263190,"Lifecell
+380631692598",4814,4814,-12000,-12000,980,0,0,2338977,True,KE15-A619-EAKM-K2AC
dzFG0_n8nevq50hs,1607259039,–í—ñ–¥: –û–ª–µ–∫—Å—ñ–π –í.,4829,4829,100000,100000,980,0,0,2350977,True
CfzvXLc0sJEQEY3Y,1607255550,Bolt,4121,4121,-5800,-5800,980,0,580,2250977,False,AP3E-BX45-8MB5-4P71
cC_xYf5QCeE6-IXa,1607254486,Bolt,4121,4121,-5600,-5600,980,0,560,2256777,False
he5P24R8BbRhryXx,1607247232,MAGAZYN DAY AND DAY,5499,5499,-12650,-12650,980,0,253,2262377,False,CA9E-AB6M-PEHK-836P
sLiAn_xUeRXKQL6Q,1607197494,Yaroslaviv Val 37-1,5499,5499,-218880,-218880,980,0,4377,2275027,False,5C2A-141H-8MM4-KT4H
--usOtW8wWFMwpOF,1607168071,MAGAZYN DAY AND DAY,5499,5499,-14800,-14800,980,0,296,2493907,False,T979-K1T2-H5XH-M9PP
yOZFz0kDLLTfZKrU,1607167566,OkvajnSichovih,5399,5399,-111820,-111820,980,0,2236,2508707,False,BM03-PX08-6AHX-B85K
78OrdSndBvM4ZDo7y3_bfg,1607126622,Bolt,4121,4121,-5100,-5100,980,0,510,2620527,True
qwbCKVAuGB3-zPjBqESQkIQcNQ,1607126622,–°–∫–∞—Å—É–≤–∞–Ω–Ω—è. Bolt,4121,4121,4600,4600,980,0,-460,2625627,False
AxzNOuzauxuh4cXb,1607097656,Uklon,4121,4121,-9600,-9600,980,0,960,2621027,False,AC5C-7T12-H53M-7X17
SdltpIgVpnNfTWwq,1607097542,–°–∫–∞—Å—É–≤–∞–Ω–Ω—è. Bolt,4121,4121,8400,8400,980,0,-840,2630627,False
GeOanIuJsRSKbhh-,1607097484,Bolt,4121,4121,-8400,-8400,980,0,840,2622227,False
77txU1WsorQ_I5M1,1607070235,MAGAZYN DAY AND DAY,5499,5499,-23000,-23000,980,0,460,2630627,False,TAC6-TE1H-XKEB-7911
UQPSKLhavDm8FN4I,1607061756,Bolt,4121,4121,-4600,-4600,980,0,460,2653627,False
8TIIdszTPEXbRLIQGTc-uQ,1607040639,Bolt,4121,4121,-8700,-8700,980,0,870,2658227,True
mR8_BwfhHGpIKT50x5lCsgnZEA,1607040639,–°–∫–∞—Å—É–≤–∞–Ω–Ω—è. Bolt,4121,4121,8200,8200,980,0,-820,2666927,False
x0eEX6XSTtAIH2lk,1606935577,Bolt,4121,4121,-8200,-8200,980,0,820,2658727,False
wszKUyfgPI6mTPmQ,1606934611,–ú–∞–º–∞,4829,4829,-1200000,-1200000,980,0,0,2666927,True,HTP0-7TEA-X8T7-XHX7
5jws1MXK3_bFx5Yx,1606929140,–ù–æ–≤–∞ –ø–æ—à—Ç–∞,4214,4214,-3800,-3800,980,0,0,3866927,False,2C90-9PA9-AT2M-M6C5
iNOdDtpKHl4_kUIu,1606929106,–ù–∞–∫–ª–∞–¥–µ–Ω–∏–π –ø–ª–∞—Ç—ñ–∂ (–ù–æ–≤–∞ –ø–æ—à—Ç–∞),6538,6538,-37700,-37700,980,0,0,3870727,False,26BX-25AP-8HH7-18TB
PTC3uqMVuBQoDE1r,1606923397,Bolt,4121,4121,-12800,-12800,980,0,1280,3908427,False,MT05-XH5H-8EE9-ABP2
LOlQlCqUc0zDxv0K,1606898599,MAGAZYN DAY AND DAY,5499,5499,-16500,-16500,980,0,330,3921227,False,26EH-X59X-TK5P-8X3B
-fjQcIZySi1isY2S,1606823732,Lesya,4829,4829,-700000,-700000,980,0,0,3937727,True,XMCK-XKAT-E37T-CCBX
R_X0nI-NiPbz80jV,1606823645,Lesya,4829,4829,-1500000,-1500000,980,0,0,4637727,True,46M5-09X7-MM3P-B472
4LLT3bjZpgmbW6F5,1606823436,WFP.AQUAMAR.,5499,5499,-55380,-55380,980,0,1107,6137727,False,2HM4-384X-X72M-HMC9
kLhpxsfChRQfslfe,1606820461,–°–∫–∞—Å—É–≤–∞–Ω–Ω—è. Bolt,4121,4121,4300,4300,980,0,-430,6193107,False
bvOY9zxS4Mp_74Qu,1606820407,Bolt,4121,4121,-5500,-5500,980,0,550,6188807,False,37PA-87HE-XT22-31C5
osdoqIXqXnWWEuS4,1606818284,Bolt,4121,4121,-4300,-4300,980,0,430,6194307,False
3_uVR7U5G2PulNI7,1606817905,JYSK,5712,5712,-270800,-270800,980,0,0,6198607,False,7KE6-8E99-KMCE-TB0X
VXt7ZxOjBYNUdBcL,1606817875,–°–∫–∞—Å—É–≤–∞–Ω–Ω—è. Bolt,4121,4121,5300,5300,980,0,-53,6469407,False
91fVX81e0K30-XCK,1606817821,Bolt,4121,4121,-6700,-6700,980,0,670,6464107,False,4B88-CC1T-2B4K-C783
jkccGfI81TNE1aeN,1606817410,LIQPAY*FOP Naumenko Ol,4215,4215,-167228,-167228,980,0,0,6470807,False,EM4M-K54C-CMM3-2TC0
HLwf4_u_cruNV4vZ,1606816977,–ù–∞ –¥–æ–ª–∞—Ä–æ–≤—É –∫–∞—Ä—Ç–∫—É,4829,4829,-77302,-2700,840,0,0,6638035,True
WN8iJHg5VuAfAFHE,1606816566,–íi–¥: –ü–†–ò–•–û–î–¨–ö–û –ï.–í. –§–û–ü,4829,4829,5300000,5300000,980,0,0,6715337,True
xXTl6krr6pDpayZ2,1606816289,–°–∫–∞—Å—É–≤–∞–Ω–Ω—è. Bolt,4121,4121,1200,5200,980,0,-12,1415337,False
KR1-OUMTzKxBXWwr,1606815341,Bolt,4121,4121,-5300,-5300,980,0,53,1414137,False
evifMN6LbCiiXKTv,1606814585,Bolt,4121,4121,-5200,-5200,980,0,52,1419437,False
qoVSKevFbyBy6qT1,1606814412,Yakaboo,5942,5942,-79300,-79300,980,0,0,1424637,False,94KK-7K9M-1063-TPT1
l6lYwhgCFfKmSufH,1606804683,–í–∏–≤–µ–¥–µ–Ω–Ω—è –∫–µ—à–±–µ–∫—É 254.37‚Ç¥,4829,4829,20476,20476,980,0,0,1503937,True
UiYeJDyypnLXR2I3,1606794650,–í—ñ–¥—Å–æ—Ç–∫–∏ –∑–∞ –ª–∏—Å—Ç–æ–ø–∞–¥,4829,4829,1904,1904,980,0,0,1483461,True
Pb5iC2PQDU00UD4j,1612013095,LIQPAY*Permatex.com.ua,5533,5533,-30000,-30000,980,0,0,1710869,False,BBMB-E6T6-XX25-P507
2UqwytT8UHwrptiA,1612004458,MAGAZYN DAY AND DAY,5499,5499,-28700,-28700,980,0,0,1740869,False,T7E0-B646-PK1A-6383
CPRqQ7qigqjtJLVw,1611948283,MAGAZYN DAY AND DAY,5499,5499,-35550,-35550,980,0,0,1769569,False,BHT6-5620-16P8-P350
FILLS-_rWAg4etm8,1611942663,"Lifecell
+380631692598",4814,4814,-12000,-12000,980,0,0,1805119,True,859E-28AA-669P-6M9K
E47Qm592nItz5Jg7,1611859971,MAGAZYN DAY AND DAY,5499,5499,-40700,-40700,980,0,0,1817119,False,X0MT-60HK-P7M1-5HKM
X__0SCSRlIMpDqpK,1611751249,Raketa,4215,4215,-30400,-30400,980,0,0,1857819,False,38K9-B8T1-83BK-T4M2
PDvZtMTYLUL59PNE,1611732299,MC UNIVER KLINIK,8062,8062,-28000,-28000,980,0,0,1888219,False,3605-E9E1-P55M-XM1P
Zi-u0ujAq1LxWSLD,1611662684,Beer Market,5921,5921,-4999,-4999,980,0,0,1916219,False,7BBA-A0AK-89B4-P871
qRN3VQC-d57AkQ6U,1611662553,Beer Market,5921,5921,-15549,-15549,980,0,0,1921218,False,E2T2-K24T-15AT-A06C
26_p4sC1T3Vljdg8,1611599212,WFP.AQUAMAR.,5499,5499,-58000,-58000,980,0,0,1936767,False,H846-MX8B-35X6-BXK5
jCDsArY_BHem1fFa,1611589145,MAGAZYN DAY AND DAY,5499,5499,-9139,-9139,980,0,0,1994767,False,P4E5-66H7-XXE3-7546
foL1NSpDyKxJW4wo,1611567839,Lesya,4829,4829,-50000,-50000,980,0,0,2003906,True,KH62-95CM-P62H-7AP2
6S2FbGkIUD8Y1Qaj,1611564521,–ï–∫–æ-–õ–∞–≤–∫–∞,5411,5499,-2750,-2750,980,0,0,2053906,False,CB74-36MC-C0HA-30BP
hwRhVe_vAfm7_9wY,1611563500,MAGAZYN DAY AND DAY,5499,5499,-19150,-19150,980,0,0,2056656,False,62A2-6M4C-562A-2500
LwR-xNobc5Gjavhe,1611418449,–°—ñ–ª—å–ø–æ,5411,5411,-78814,-78814,980,0,0,2075806,False,8B18-XXHH-T509-75M9
Bg9EKPinK4hCtqvR,1611408592,Bolt,4121,4121,-8400,-8400,980,0,840,2154620,False,P4C0-3349-5M9H-CMP1
KWxB4P9X_ubhafOD,1611401785,MAGAZYN DAY AND DAY,5499,5499,-36370,-36370,980,0,0,2163020,False,AC96-7K0C-2510-030B
XCdYxbWRLLJciYBJ,1611401712,Bolt,4121,4121,-8300,-8300,980,0,830,2199390,False,66PP-29B2-T4M7-BBMT
-40ejQkUkWQutN99,1611400196,Lesya,4829,4829,-150000,-150000,980,0,0,2207690,True,HEPE-K29T-12MM-PCHT
I5t6awQM8L_hkqZ8UG1vTLsAMg,1611361583,–°–∫–∞—Å—É–≤–∞–Ω–Ω—è. Bolt,4121,4121,5200,5200,980,0,-520,2357090,False
82JVO7Ui9Fb3zKCBLhlG,1611361583,Bolt,4121,4121,-5800,-5800,980,0,580,2351890,True
UYi0ZV0Jb5GiYCbD,1611359771,Bolt,4121,4121,-8800,-8800,980,0,880,2357690,False,T3E2-2H17-H7HE-65AC
cw_FiZG09mq5jVEJ,1611345658,–Ø–Ω –ó.,4829,4829,-5000,-5000,980,0,0,2367090,True,EKEK-2A6T-E79A-9070
yy0FOwGBTn94H5Z9,1611337225,Beer Market,5921,5921,-20550,-20550,980,0,0,2372090,False,T6T7-X0XM-E45M-7AMK
C-Rgn2vMcgEDUIhg,1611332475,–°–∫–∞—Å—É–≤–∞–Ω–Ω—è. Bolt,4121,4121,14800,14800,980,0,-1480,2392640,False
chOlBKBShysVP6iv,1611332407,Uklon,4121,4121,-14700,-14700,980,0,1470,2377840,False,033P-XAPP-AKA9-194T
h6TDFB1QS8Od_kP9,1611332076,Bolt,4121,4121,-14800,-14800,980,0,1480,2392540,False
jJCldo7uk9Mrghos,1611317858,–°–∫–∞—Å—É–≤–∞–Ω–Ω—è. Bolt,4121,4121,6300,6300,980,0,-630,2407340,False
ZdELK6oN1RY7nBWn,1611317796,Bolt,4121,4121,-8100,-8100,980,0,810,2401040,False,MT20-MMA9-B967-5MAK
JQ_uQug2fZIps4av,1611315486,Bolt,4121,4121,-6300,-6300,980,0,630,2409140,False
AJM7-tMV5Be4moqC,1611301215,Bolt,4121,4121,-5200,-5200,980,0,520,2415440,False
Oeab7utah3oDDbp5,1611249759,MAGAZYN DAY AND DAY,5499,5499,-4750,-4750,980,0,0,2420640,False,H3MT-A637-C3B4-X1PA
gLqZDpAK3_eQzSLB,1611243460,Lesya,4829,4829,-100000,-100000,980,0,0,2425390,True,5CK5-XKCM-XP29-2MHM
uq8n8Ser3JudOb9oLCDm9w,1611186802,Bolt,4121,4121,-5000,-5000,980,0,500,2525390,True
6_vsg4m8ezEqaFUuRwIEMCB_EQ,1611186802,–°–∫–∞—Å—É–≤–∞–Ω–Ω—è. Bolt,4121,4121,4800,4800,980,0,-480,2530390,False
OOX17cbXP8Gl-BAI,1611150964,Lesya,4829,4829,-300000,-300000,980,0,0,2525590,True,H5E4-7XE1-0M1X-8A9T
e5yCXZsvIy4f-G3z,1611135403,–ê–ø—Ç–µ–∫–∞ 28,5912,5912,-51080,-51080,980,0,0,2825590,False,8E54-T979-301X-7M58
gzHMFYMUrKqhyWwE,1611133827,ML DILA,8099,8099,-48000,-48000,980,0,0,2876670,False,655T-M08H-2HHP-9B3M
rgy-5oO2CnGWhTvG,1611062120,Bolt,4121,4121,-5700,-5700,980,0,570,2924670,False,H701-7E3H-4H92-4M34
QB2mhfMQAyncn_bY,1611060089,Bolt,4121,4121,-4800,-4800,980,0,480,2930370,False
ecUNQaxDPFCEyOhv,1611052204,Bolt,4121,4121,-6700,-6700,980,0,670,2935170,False,H9EM-B673-ECE2-28B4
oSG3htMTiAhGlgrE,1611047121,–ù–æ–≤–∞ –ø–æ—à—Ç–∞,7399,7399,-3300,-3300,980,0,0,2941870,False,5PHT-H06T-C3KE-H992
mUItTpRvpArgQtih,1611042192,Bolt,4121,4121,-5000,-5000,980,0,500,2945170,False,C1XA-KEPX-KBE2-X632
2VFCjSx4ifxdLzFP,1611033632,Netflix,7841,4899,-34285,-999,978,0,0,2950170,False,CM83-1552-1AKH-0E38
nMZs7FLv3RJadjKr,1611004996,–íi–¥: –û–ª–µ—Å—è –°.,4829,4829,100,100,980,0,0,2984455,True
A9FxXgzs_PoRrGC6,1611004801,Lesya,4829,4829,-200000,-200000,980,0,0,2984355,True,A460-376C-6XA5-X5A5
ytRauwGAdPwJ5N-i,1610883561,Lesya,4829,4829,-200000,-200000,980,0,0,3184355,True,7T5M-45E7-BH75-XBT4
LUnvD7gHmpU50laW,1610881853,LIQPAY*PP*CATERERS*A/G,5811,5811,-57900,-57900,980,0,0,3384355,False,M7EP-AX1B-0401-K423
cT5X-y4dAUPhw9SF,1610809304,–ê–ª–µ–∫—Å–µ–π –í—ã–∫–∞–ª—é–∫ BCD,4829,4829,-50000,-50000,980,0,0,3442255,True,9M83-8HBB-H342-AX76
n6Eqv_sIcmTE7ZHq,1610796437,OKWINE,5411,5411,-112410,-112410,980,0,0,3492255,False,7900-E1KM-B186-P53C
aSy0T_xW3k3ayaqa,1610729021,–ï–∫–æ-–õ–∞–≤–∫–∞,5411,5499,-53800,-53800,980,0,0,3604665,False,KB9E-EK96-HCKC-1792
ejYiBHJWqmm4vJUm,1610728533,–°—ñ–ª—å–ø–æ,5411,5411,-205313,-205313,980,0,0,3658465,False,CE7C-4T46-T2CE-0026
OOuqTnH_7UNIA4pn,1610718143,LIQPAY*FOP Naumenko Ol,7278,7278,-224382,-224382,980,0,0,3863778,False,BBM6-EBT1-TBAE-5XK2
v5XMLYWVGuhoznrr,1610701555,–û–ª–µ–∫—Å—ñ–π –í.,4829,4829,-104000,-104000,980,0,0,4088160,True,2H14-13CB-XCAB-4X7E
fm0WyIp2x5XQUcfG,1610699499,–ù–∞ –¥–æ–ª–∞—Ä–æ–≤—É –∫–∞—Ä—Ç–∫—É,4829,4829,-121390,-4300,840,0,0,4192160,True
Bc7cb1bCWnQolKes,1610699466,Lesya,4829,4829,-500000,-500000,980,0,0,4313550,True,8A1E-HE88-0M78-TCHK
yjQe81WIzhLFczfd,1610698689,–íi–¥: –ü–†–ò–•–û–î–¨–ö–û –ï.–í. –§–û–ü,4829,4829,3300000,3300000,980,0,0,4813550,True
Vt2MQRyeHhSeYz302Q3abA,1610667508,Bolt,4121,4121,-7500,-7500,980,0,75,1513550,True
UltxB7mp9ZaOg6Zj3Ont123BAA,1610667508,–°–∫–∞—Å—É–≤–∞–Ω–Ω—è. Bolt,4121,4121,6800,6800,980,0,-68,1521050,False
HPKNRG4W3xJyQ9B7,1610658720,–û–ª–µ—Å—è –°.,4829,4829,-3250,-3250,980,0,0,1514250,True
9dCMxuI59iyajPa1,1610619762,MAGAZYN DAY AND DAY,5499,5499,-22000,-22000,980,0,0,1517500,False,XA8H-C1B2-A04E-B13B
zLE23FM7lgxAxGbn,1610550384,Bolt,4121,4121,-8600,-8600,980,0,86,1539500,False,P0BC-AB7X-BC1M-2CK3
-Ac7SdEKfryiOJGt,1610547789,Bolt,4121,4121,-6800,-6800,980,0,68,1548100,False
-wAaqbjqLzquvoo3,1610478406,MAGAZYN DAY AND DAY,5499,5499,-35050,-35050,980,0,0,1554900,False,675M-BM36-MMM3-147H
IOekuSqow1_ZOPvw,1610476711,fondy.ua,5814,5814,-45000,-45000,980,0,0,1589950,False,748C-5B23-0CCM-PX49
EeK5RBYnlQrAnWak,1610475839,–°–∫–∞—Å—É–≤–∞–Ω–Ω—è. fondy.ua,5499,5499,44300,44300,980,0,0,1634950,False
iel2fhZLARDU2XE-,1610475586,fondy.ua,5499,5499,-44300,-44300,980,0,0,1590650,False
zyj6sC7m6orOc9bm,1610451148,Bolt,4121,4121,-5700,-5700,980,0,57,1634950,False,7XE1-9C3C-7P84-M5MM
pkpeSa7ZXeWfK4fD,1610449843,–°–∫–∞—Å—É–≤–∞–Ω–Ω—è. Bolt,4121,4121,5400,5400,980,0,-54,1640650,False
WDgzZ8fAdvdNfcSN,1610449812,Bolt,4121,4121,-5400,-5400,980,0,54,1635250,False,H6MH-AMKT-C2X5-5MXE
nh4M6WlfQttvrLTT,1610449742,Bolt,4121,4121,-5400,-5400,980,0,54,1640650,False
vBKas7DHotiegeBd,1610445732,Portmone,4816,4816,-22440,-22440,980,0,0,1646050,False,9EP0-8P57-T738-100T
-oymk0Wy2TwtxQYg,1610443289,–°–∫–∞—Å—É–≤–∞–Ω–Ω—è. Bolt,4121,4121,5500,5500,980,0,-55,1668490,False
2TcRboPZXVBMYt6b,1610443220,Bolt,4121,4121,-6700,-6700,980,0,67,1662990,False,51AB-19TT-CB94-KT5X
IOUhKDMFQqZ3ultj,1610441642,Bolt,4121,4121,-5500,-5500,980,0,55,1669690,False
4PNPKxsAw0IueoqaGVJ6Nw,1610408995,Bolt,4121,4121,-8900,-8900,980,0,89,1675190,True
oIhfXJPRgaf5ETwcxP3NbQF-Sg,1610408995,–°–∫–∞—Å—É–≤–∞–Ω–Ω—è. Bolt,4121,4121,8500,8500,980,0,-850,1684090,False
ewoLMDtF5oSwOzbm,1610374130,Beer Market,5921,5921,-20550,-20550,980,0,0,1675590,False,6TK5-8P39-KX25-00P8
Gp9nMFfy-_2r_6Ed,1610372184,fondy.ua,7379,7379,-66000,-66000,980,0,0,1696140,False,34TA-20BX-61K3-KME1
2G1JS7Po0IHWIhb5,1610364366,Bolt,4121,4121,-20600,-20600,980,0,206,1762140,False,H5HK-T81P-M12C-M73P
MYybXzKr__YilHiG,1610364254,TOV Gastrocentr,8099,8099,-300000,-300000,980,0,0,1782740,False,185E-8592-92P2-PXE0
-y0X2Cypj5deBpAJ,1610357106,–°–∫–∞—Å—É–≤–∞–Ω–Ω—è. Bolt,4121,4121,6300,21300,980,0,-630,2082740,False
SP1zW8zgPa6zfzLz,1610353139,Bolt,4121,4121,-21300,-21300,980,0,2130,2076440,False
o8gMoBV8yuTeg_0Y,1610301777,MAGAZYN DAY AND DAY,5499,5499,-37100,-37100,980,0,0,2097740,False,2P57-K23P-421A-A5C2
UxCj6Af1TzTXBN6l,1610289678,Bolt,4121,4121,-8000,-8000,980,0,800,2134840,False,0542-0K1B-E5A4-9E22
XXzqhgsA5I05P19n,1610280843,Bolt,4121,4121,-8500,-8500,980,0,850,2142840,False
OxN3pI1F26LNKKdm,1610262686,–ü–ª–∞—Ç—ñ–∂ stol-i-stul.com.ua,4829,4829,-249950,-249950,980,0,0,2151340,True
j9TwVC7ZGC1oMn5puFkGOg,1610239246,Bolt,4121,4121,-11100,-11100,980,0,1110,2401290,True
lKbp2G2hNa3oe_oENvdfQsEalA,1610239246,–°–∫–∞—Å—É–≤–∞–Ω–Ω—è. Bolt,4121,4121,10600,10600,980,0,-1060,2412390,False
h5bwMGxC7M2wXQri,1610203068,MAGAZYN DAY AND DAY,5499,5499,-23150,-23150,980,0,0,2401790,False,MH4H-03AK-5A04-KP3T
NjZogdoUQEbHKafA,1610149035,–°–∫–∞—Å—É–≤–∞–Ω–Ω—è. Bolt,4121,4121,8800,8800,980,0,-880,2424940,False
X6OTNtQ-Fs8pV5xH,1610148992,Bolt,4121,4121,-10900,-10900,980,0,1090,2416140,False,K9TM-K03K-4884-2EPK
B7h06Hj7hL_656yZ,1610147361,Bolt,4121,4121,-8800,-8800,980,0,880,2427040,False
h5EAiMWutUqTBXCp,1610118125,Bolt,4121,4121,-10600,-10600,980,0,1060,2435840,False
_-6VT008BV3jbokN,1610108051,–°—ñ–ª—å–ø–æ,5411,5411,-133900,-133900,980,0,0,2446440,False,T5TM-839K-M5H4-31B5
4ixR4Z-CTQCfhKLT,1610104173,Lesya,4829,4829,-100000,-100000,980,0,0,2580340,True,20P6-T83X-6A9X-6PA0
kEPJvjv0L83am2uF,1610052592,–í–µ–ª–∏–∫–∞ –ö–∏—à–µ–Ω—è,5411,5411,-56591,-56591,980,0,0,2680340,False,A48C-21EM-HMP6-E9HA
R64h0wjPpBPZm9Ee,1610039359,MAGAZYN DAY AND DAY,5499,5499,-45850,-45850,980,0,0,2736931,False,KK1A-AMM5-TK30-MA71
EsA8PGcFZv0ek1sf,1610023224,TCPIZZA,5814,5814,-48000,-48000,980,0,0,2782781,False,TA32-494K-6494-7XE6
7a-3B4yN2AcGzrQn,1609951835,–ï–∫–æ-–õ–∞–≤–∫–∞,5411,5499,-11300,-11300,980,0,0,2830781,False,20CK-0K6T-72B4-12X3
9oXilpNGmuKF-prA,1609941838,–í—ñ–¥: –î–µ–Ω–∏—Å –ö.,4829,4829,11500,11500,980,0,0,2842081,True
s9DT_lkzQ4n-MMoD,1609937802,Glovo,4215,4215,-36300,-36300,980,0,0,2830581,False,A4K1-5157-X5H7-CA19
h8IuSIzOL0IbHSPf,1609927118,–ú—ñ—Å—å–∫–µ –∫–∞—Ñ–µ ¬´–•–∞—Ä–º—Å¬ª (–ö–Ω–∏–∂–∫–æ–≤–∞ –∫—Ä–∞–º–Ω–∏—Ü—è ¬´–•–∞—Ä–º—Å¬ª),5814,5814,-5700,-5700,980,0,0,2866881,False,M8TT-EPK3-KEAK-X138
pXkILAWl6fr3EHiX,1609924575,Glintvejn,5814,5814,-9000,-9000,980,0,0,2872581,False,5M1T-A966-5X7X-4P2T
HxKiqoMMbLMMexe-kbzVXA,1609892149,Bolt,4121,4121,-6600,-6600,980,0,660,2881581,True
sVB8_OdWTb09fs5Di2arfQ,1609892149,Bolt,4121,4121,-8300,-8300,980,0,830,2888181,True
OH7lV7-jQwaj5iv0zxudwuNhhw,1609892149,–°–∫–∞—Å—É–≤–∞–Ω–Ω—è. Bolt,4121,4121,6300,6300,980,0,-630,2896481,False
Y8NIRCk2Cx2rJYh7NU22D8DeoA,1609892149,–°–∫–∞—Å—É–≤–∞–Ω–Ω—è. Bolt,4121,4121,7700,7700,980,0,-770,2890181,False
XeEvtGodPEydlsBx,1609844853,Bolt,4121,4121,-5300,-5300,980,0,530,2882481,False,C93P-M7AC-21H5-4P25
uEDdoh5fNdcD-9UP,1609844819,–°–∫–∞—Å—É–≤–∞–Ω–Ω—è. Bolt,4121,4121,6200,6200,980,0,-620,2887781,False
5qLOJ3bL0-X7N_bB,1609844764,Bolt,4121,4121,-10400,-10400,980,0,1040,2881581,False,B90X-4A6K-XBC1-6C54
t7MUXvFFYFI6NkwA,1609843038,Bolt,4121,4121,-6200,-6200,980,0,620,2891981,False
P7N23DKHKD-LkgrX,1609838893,–°–∫–∞—Å—É–≤–∞–Ω–Ω—è. Bolt,4121,4121,5200,5200,980,0,-520,2898181,False
tVwJ8Ylbxfx3yqwK,1609838848,Bolt,4121,4121,-7500,-7500,980,0,750,2892981,False,EXMA-KC48-HM5A-P142
5NqEVFD5cVfy_iOt,1609836537,Lesya,4829,4829,-300000,-300000,980,0,0,2900481,True,8K94-4P1X-HMH7-4921
Sp2DTmkgjbKE_oAW,1609836533,Bolt,4121,4121,-5200,-5200,980,0,520,3200481,False
vlDodWPKGJB8Kavuh-vu,1609805559,Bolt,4121,4121,-7600,-7600,980,0,760,3205681,True
FiMPK6ocInuT0ZmccCxOMg,1609805559,Bolt,4121,4121,-15000,-15000,980,0,1500,3213281,True
RnGw9pSZFNt6I0Rfoj7XyWwW1g,1609805559,–°–∫–∞—Å—É–≤–∞–Ω–Ω—è. Bolt,4121,4121,7100,7100,980,0,-710,3228281,False
EfplnAOFJS1xpyjYH6wGutxHAA,1609805559,–°–∫–∞—Å—É–≤–∞–Ω–Ω—è. Bolt,4121,4121,13800,13800,980,0,-1380,3221181,False
J1GRqe9-41ZYSDSs,1609780541,Bolt,4121,4121,-6300,-6300,980,0,630,3207381,False
kYYEIISFYCx_HzLn,1609777391,Bolt,4121,4121,-7700,-7700,980,0,770,3213681,False
N_XTLhVzwNTPkSXt,1609768668,Lesya,4829,4829,-500000,-500000,980,0,0,3221381,True,B4B8-CX8A-3581-8A35
fy2-eoec-HN1b3I5,1609763112,Bolt,4121,4121,-8500,-8500,980,0,850,3721381,False,KX7K-3HBH-H09H-K6PC
NZ2YGXQFP8wCZP2G,1609760766,Bolt,4121,4121,-7100,-7100,980,0,710,3729881,False
AmEXKItj1q5_tbNw,1609714603,DP *cosibella.pl,5977,5977,-147700,-147700,980,0,0,3736981,False,BEK9-C7PP-0B22-26KE
3QQz2oiKBsUHHd_K,1609697079,MAGAZYN DAY AND DAY,5499,5499,-19800,-19800,980,0,0,3884681,False,49H0-T3P2-9264-B4X3
dHFVQidSteZUOeFU,1609696608,Raketa,4215,4215,-23300,-23300,980,0,0,3904481,False,0E31-CPPA-C25M-14AM
uTSbjiJM54cbhsp6,1609673114,"Lifecell
+380631692598",4814,4814,-10000,-10000,980,0,0,3927781,True,B33C-5C6H-8MXH-X037
1tAMMfCJtJ4ASkuU,1609623844,Bolt,4121,4121,-13800,-13800,980,0,1380,3937781,False
xrO8yDk_Nidpc6Qj,1609594750,MAGAZYN DAY AND DAY,5499,5499,-34450,-34450,980,0,0,3951581,False,TAP1-5HP3-8271-3E66
-KSg1BSJmz6ubTTB,1609594544,Bolt,4121,4121,-11000,-11000,980,0,1100,3986031,False,KM00-TC6H-3M41-BP7T
vQ97UqDaO0ptDvuQ,1609465977,–í—ñ–¥—Å–æ—Ç–∫–∏ –∑–∞ –≥—Ä—É–¥–µ–Ω—å,4829,4829,3091,3091,980,0,0,3997031,True
ULPKZ5-OwNyR4BwAOLZD-w,1614385144,Bolt,4121,4121,-9600,-9600,980,0,0,4221687,True
CPoJWjnbq51YN8xuXUkbvltH_w,1614385144,–°–∫–∞—Å—É–≤–∞–Ω–Ω—è. Bolt,4121,4121,9400,9400,980,0,0,4231287,False
lf7Xh8SVFgWQ3gn2,1614274879,Fly coffe #3,5814,5814,-43000,-43000,980,0,0,4221887,False,HX22-H81A-KCC1-ECP4
ZGqwkco3BHvkaX50,1614265690,Bolt,4121,4121,-9400,-9400,980,0,0,4264887,False
NE26TVKeDOtU2ETw,1614260250,Lesya,4829,4829,-500000,-500000,980,0,0,4274287,True,90EX-726P-T73A-CE3C
GhTrpSYDUzfjaAw9,1614251950,–íi–¥: –ü–†–ò–•–û–î–¨–ö–û –ï.–í. –§–û–ü,4829,4829,1700000,1700000,980,0,0,4774287,True
Ka6GyeYU3Reuofxp,1614247951,–°–∫–∞—Å—É–≤–∞–Ω–Ω—è. Bolt,4121,4121,9000,9000,980,0,0,3074287,False
hjw1XxfXK45__GrU,1614247901,Bolt,4121,4121,-11400,-11400,980,0,0,3065287,False,K6B4-15B6-8K8H-9H09
uI9u8P4RlrIgLh8u,1614243705,Bolt,4121,4121,-9000,-9000,980,0,0,3076687,False
OX4FEaIPG9OUm_kl,1614233900,Bolt,4121,4121,-8100,-8100,980,0,0,3085687,False,1AMH-T73K-X16X-PHB6
4vE_yhwVFAbee4vfXbxb6w,1614210872,Bolt,4121,4121,-6700,-6700,980,0,0,3093787,True
KSZWRS1NeYSeq52XXhhh1WgG7Q,1614210872,–°–∫–∞—Å—É–≤–∞–Ω–Ω—è. Bolt,4121,4121,6400,6400,980,0,0,3100487,False
lbWmOxaij2YJvWTl,1614185619,Bolt,4121,4121,-6000,-6000,980,0,0,3094087,False,1A65-P98X-C3K6-996A
IiW0mnLOU8zJ7qyH,1614182583,Bolt,4121,4121,-8900,-8900,980,0,0,3100087,False,3M90-6AA4-P9E9-0K37
42AlATm7ihFxmys1,1614174927,Lesya,4829,4829,-300000,-300000,980,0,0,3108987,True,3C0A-250X-M0TE-K2E9
pSyPJ0l2TXmq3nSe,1614149256,MAGAZYN DAY AND DAY,5499,5499,-9200,-9200,980,0,0,3408987,False,C467-995H-61CC-E1XE
O2o53Qu0t7DnWv46,1614148572,MED TS.UNIVERS KLINIK,8062,8062,-260000,-260000,980,0,0,3418187,False,433P-MKXE-H2AA-2PHE
iX_YJY0WId8B9P-yas63,1614125137,Bolt,4121,4121,-6100,-6100,980,0,0,3678187,True
8wJ4mcNT9bO_KEZFN3qrtlrAkA,1614125137,–°–∫–∞—Å—É–≤–∞–Ω–Ω—è. Bolt,4121,4121,5700,5700,980,0,0,3684287,False
KpirSeSk6nXnbFAx,1614107737,Bolt,4121,4121,-6400,-6400,980,0,0,3678587,False
b8Mu4y99QwfTTzV-,1614107056,MAGAZYN DAY AND DAY,5499,5499,-9500,-9500,980,0,0,3684987,False,XP3X-HP40-1227-273A
10eQjDQwDUITJ0km,1614096672,Uklon,4121,4121,-500,-500,980,0,0,3694487,False,6850-A58H-4K08-8MEE
xBGpN6d1qU3PSWu_,1614095488,Uklon,4121,4121,-12700,-12700,980,0,0,3694987,False,PKE5-XC9B-TB05-0978
e1mci-mLgD3N-ZDW,1614088720,–°–∫–∞—Å—É–≤–∞–Ω–Ω—è. Bolt,4121,4121,8900,8900,980,0,0,3707687,False
SbQ4h0dL9vJB43H3,1614088665,Bolt,4121,4121,-12900,-12900,980,0,0,3698787,False,K323-2K9C-P97P-EA1C
VNTyxZQ8RcbTGkMx,1614086267,Bolt,4121,4121,-8900,-8900,980,0,0,3711687,False
AYsI-ckG5vz31KhE,1614071038,Bolt,4121,4121,-5700,-5700,980,0,0,3720587,False
Z5lT_XnBfHboF650,1614070300,MAGAZYN DAY AND DAY,5499,5499,-5800,-5800,980,0,0,3726287,False,AK58-CXHX-H0AK-5KK1
L8UUtqA9k_uCQF0EtbOJvw,1614059385,Bolt,4121,4121,-12500,-12500,980,0,0,3732087,True
u1sfRuB56uV6SkTnTlmiDc_shA,1614059385,–°–∫–∞—Å—É–≤–∞–Ω–Ω—è. Bolt,4121,4121,11900,11900,980,0,0,3744587,False
6py0RpSH89T73d9Q,1614016996,Vayn Taym,5921,5921,-14700,-14700,980,0,0,3732687,False,7H2A-K7C7-1043-757M
GfSW8lHZH6l3feBC,1614016676,Beermood,4215,4215,-33000,-33000,980,0,0,3747387,False,PC4K-22XT-4XM8-PTE1
7LlD3hGgYH_iivcj,1614015636,Lesya,4829,4829,-500000,-500000,980,0,0,3780387,True,PCT5-0AM9-6B3P-7607
6Nylx4CG3iTuN1Lm,1614013508,–ö–∞—Ç–µ—Ä–∏–Ω–∞ –†.,–ø–æ–¥–∞—Ä–æ–∫,4829,4829,-160000,-160000,980,0,0,4280387,True,0HKA-E4E7-668X-9KKM
H5n_Ye3k64a6A5rg,1613996782,"–ë–ª–∞–≥–æ—Ç–≤–æ—Ä–∏—Ç–µ–ª—å–Ω—ã–π —Ñ–æ–Ω–¥ ""–ñ–∏–∑–Ω–µ–ª—é–±""",8398,8398,-200000,-200000,980,0,0,4440387,False,X9A1-73A2-TA0A-PC10
sBWSwDCIwWJ8uuCb,1613987442,–íi–¥: –ü–†–ò–•–û–î–¨–ö–û –ï.–í. –§–û–ü,4829,4829,3800000,3800000,980,0,0,4640387,True
6RilmdEF0iTlU1hA,1613985392,Harms,5814,5814,-27000,-27000,980,0,0,840387,False,CMX2-XC4C-CCP0-A1BB
kymbnPs63Y9NlNnc,1613939612,MAGAZYN DAY AND DAY,5499,5499,-16850,-16850,980,0,0,867387,False,TEA1-AE46-XX57-3CB5
OVUCzVBFQpFUDoMb,1613926539,MAGAZYN DAY AND DAY,5499,5499,-30200,-30200,980,0,0,884237,False,2XM0-12X4-0BE8-E4TM
9eF_G8XQM-WBVrZY,1613848028,Bolt,4121,4121,-6600,-6600,980,0,0,914437,False,4K5A-M5T0-50BC-18HM
P5XbtFpLaL4YBZck,1613839983,Bolt,4121,4121,-7300,-7300,980,0,0,921037,False,88EC-1AXX-B17X-7XH3
xgdAGHFnNLC1y3EH,1613837249,Bolt,4121,4121,-6700,-6700,980,0,0,928337,False,0563-E06A-B5P6-93M4
xCcFQ6GnoZgx2TLY,1613837247,MOYO,5722,5399,-2228200,-2228200,980,0,0,935037,False,PA6C-73TE-4H31-MA4E
U-dNV7sMZruEDYWm,1613831283,Bolt,4121,4121,-10500,-10500,980,0,0,3163237,False,P066-X09X-KKB6-C872
EfePo6WEkNYy6eoW,1613830168,Lesya,4829,4829,-500000,-500000,980,0,0,3173737,True,HPKX-416T-KM3X-BC2H
xUP_j_pRS7hfV-dQ,1613828578,Bolt,4121,4121,-11900,-11900,980,0,0,3673737,False
DGtemUqTdjFSH5H3,1613760397,–•–º—ñ–ª—å–Ω–∏–π –ö–Ω—è–∑—å,5812,5812,-23200,-23200,980,0,0,3685637,False,XP56-27AK-C9HM-X356
z6Zwa8tnLx5sria-,1613760377,RESTORAN KHMILNYY KNYA,5812,5812,-54250,-54250,980,0,0,3708837,False,H179-PXH5-P7A1-K6TT
DwE3XP4VIlGqRQ5b,1613736741,Bolt,4121,4121,-7800,-7800,980,0,0,3763087,False,35A4-HC8T-7A2P-CX94
OAJvsqS6Fv1WHsoO,1613717056,Uklon,4121,4121,-9800,-9800,980,0,0,3770887,False,BAME-C784-79T7-06E7
vMBnP-1E1zh1eosu,1613717037,–°–∫–∞—Å—É–≤–∞–Ω–Ω—è. Bolt,4121,4121,6600,6600,980,0,0,3780687,False
rZ8q_s-IHKfB_oAq,1613716461,Bolt,4121,4121,-6600,-6600,980,0,0,3774087,False
ah9znCf8UZMUWcX5,1613710309,Netflix,7841,4899,-33747,-999,978,0,0,3780687,False,KHMT-672E-059P-E5CK
opCJqj6VHc3ETmpR,1613682379,–°–∫–∞—Å—É–≤–∞–Ω–Ω—è. Bolt,4121,4121,9400,9400,980,0,0,3814434,False
D-L0FpxyFRW8pWt0,1613682373,Uklon,4121,4121,-9300,-9300,980,0,0,3805034,False,KMK4-CMC7-A872-CHT3
YtNIMRGTrRUGkFIj,1613682080,Bolt,4121,4121,-9400,-9400,980,0,0,3814334,False
hu1HHNJ3sWAWAWNr,1613677615,Beer Market,5921,5921,-26550,-26550,980,0,0,3823734,False,0A08-4284-4710-33XP
XBXhOLDWCbQ8B9uk,1613668240,Bolt,4121,4121,-10200,-10200,980,0,0,3850284,False,78X9-5A9A-K18T-C3H9
MVqmLQy9ugcOSyUf,1613650309,MAGAZYN DAY AND DAY,5499,5499,-1950,-1950,980,0,0,3860484,False,3CHM-E3C8-ABPT-E869
yZ_vTqe_0hewtI98,1613649196,McDonald‚Äôs,5814,5814,-22600,-22600,980,0,0,3862434,False,8EM2-AB85-P2M9-ABX9
_3COOY1vPRVKpmsP,1613637526,Harms,5814,5814,-4560,-4560,980,0,0,3885034,False,3P32-K711-9BM4-AAX3
4lVRJ6ZaKiEAD4d1,1613633615,MAGAZYN DAY AND DAY,5499,5499,-17400,-17400,980,0,0,3889594,False,CM6H-E75P-TB5M-EBA8
S2WGwvJHHyg2MkSL,1613556981,Portmone,4816,4816,-25500,-25500,980,0,0,3906994,False,9TEE-6HH1-0MPH-B872
GO7KM9GgJq4x5S3t,1613552540,Salateira,5814,5814,-9800,-9800,980,0,0,3932494,False,E47P-5T10-7M21-EK3H
OPAZOaYQVRbW478g,1613552012,–°–∫–∞—Å—É–≤–∞–Ω–Ω—è. Bolt,4121,4121,9700,9700,980,0,0,3942294,False
lMM6pOk3ZkChu6el,1613551323,VETERENARNYY GOSPITAL,742,742,-95500,-95500,980,0,0,3932594,False,7ABX-6K7H-8065-TC53
aVCb8KHBvPAdn0T9,1613548392,Uklon,4121,4121,-2000,-2000,980,0,0,4028094,False,4484-8071-9E1T-H3MB
Y64TXEneNqTnLdiG,1613546871,Uklon,4121,4121,-10000,-10000,980,0,0,4030094,False,3TM8-9M30-406E-9P93
5a4NWQAAC6i0i4FQ,1613546642,Bolt,4121,4121,-9700,-9700,980,0,0,4040094,False
HccSR6MXzTP2iuHg,1613471861,Lesya,4829,4829,-1000000,-1000000,980,0,0,4049794,True,0761-86X5-07P5-T452
sWe-6yhFpmRpP7fW,1613468848,–íi–¥: –ü–†–ò–•–û–î–¨–ö–û –ï.–í. –§–û–ü,4829,4829,3800000,3800000,980,0,0,5049794,True
vxdZu3qYntLRrJsI,1613465522,MAGAZYN DAY AND DAY,5499,5499,-17400,-17400,980,0,0,1249794,False,MK09-9AT3-E034-B948
vsIt8OsjgMlGihZOJMnv,1613447182,–°–∫–∞—Å—É–≤–∞–Ω–Ω—è. Bolt,4121,4121,4000,4000,980,0,0,1267194,True
E96yge2zRHNiXpLs,1613397974,PayPal,5099,5099,-89981,-89981,980,0,0,1263194,False,PB3C-9263-6HH3-0M1M
uun4MG-AnMcr2lNJ,1613397966,–°–∫–∞—Å—É–≤–∞–Ω–Ω—è. PayPal,5099,5099,100,100,980,0,0,1353175,False
65bEGSHOUAKn4-Mu,1613397947,PayPal,5099,5099,-100,-100,980,0,0,1353075,False
MbYuYWqbbeY5NsKp,1613397892,–°–∫–∞—Å—É–≤–∞–Ω–Ω—è. PayPal,5999,5999,2803,100,840,0,0,1353175,False
l3bZP3_CkAnk3N3V,1613397888,PayPal,5999,5999,-2803,-100,840,0,0,1350372,False
qc7J1lrnG9EyH8BM,1613386325,–°–∫–∞—Å—É–≤–∞–Ω–Ω—è. Bolt,4121,4121,7200,7200,980,0,0,1353175,False
T5kJnxo6zUt-dv15,1613386280,Bolt,4121,4121,-9000,-9000,980,0,0,1345975,False,43A4-B38A-79M5-PKCE
Yn3Th6isE_Tergym,1613383400,Bolt,4121,4121,-7200,-7200,980,0,0,1354975,False
0OHsvsVWu18D3JMP,1613382038,Barbershop Daboroda,7230,7230,-45000,-45000,980,0,0,1362175,False,6H8X-0P79-EEHM-7XMX
UruhiSgnlyloVOTG,1613377411,–°–∫–∞—Å—É–≤–∞–Ω–Ω—è. Bolt,4121,4121,3600,7600,980,0,0,1407175,False
ZwBkQUd_mQ798w-N,1613376487,Uklon,4121,4121,-7100,-7100,980,0,0,1403575,False,6EXP-3B97-E404-20P8
ZbqEWnIaz9iLLujV,1613376305,Bolt,4121,4121,-7600,-7600,980,0,0,1410675,False
-ceyzchtCHPNiNKa,1613303549,Uklon,4121,4121,-9000,-9000,980,0,0,1418275,False,414T-K1ME-T05A-CXC1
4pvmbrZKrBTUv1Gu,1613297186,Bolt,4121,4121,-5300,-5300,980,0,0,1427275,False,AT19-CC1M-BET0-BTC6
FVwuQOjJpu7ZQyYp,1613231511,MAGAZYN DAY AND DAY,5499,5499,-9150,-9150,980,0,0,1432575,False,EX57-5EE3-5554-421K
MW3EeTJFJ-elqT3F,1613231119,Beer Market,5921,5921,-13051,-13051,980,0,0,1441725,False,AKT9-2TAA-6TX3-C592
DgUbBzp0rx_kBnl1,1613205019,MAGAZYN DAY AND DAY,5499,5499,-17400,-17400,980,0,0,1454776,False,B5C3-7T05-BP5A-H84B
FYwH09Q9VRok5KYtlQM3,1613087590,Bolt,4121,4121,-8500,-8500,980,0,0,1472176,True
2XMP4cuM8LvMh7z6meQGkycSKg,1613087590,–°–∫–∞—Å—É–≤–∞–Ω–Ω—è. Bolt,4121,4121,8100,8100,980,0,0,1480676,False
TIosZzZbd0zGV6Bu,1613068277,Simona,5814,5814,-41000,-41000,980,0,0,1472576,False,XXAH-A6MT-XEEB-47TP
FNNhpccqsMrS6iLO,1613068074,Beer Market,5921,5921,-23953,-23953,980,0,0,1513576,False,A3E0-B46C-9XA2-B92X
pWOb8y3ElZ1dF6KQ,1613033672,Bolt,4121,4121,-8100,-8100,980,0,0,1537529,False
KpdoDJh89u8GLWKhGbzq,1613001546,Bolt,4121,4121,-6900,-6900,980,0,0,1545629,True
Yfr_AqsznnMaWbFVIeus1A,1613001546,Bolt,4121,4121,-12500,-12500,980,0,0,1552529,True
Yz2HOOn6GCVP9MRmJpCh1V8HyQ,1613001546,–°–∫–∞—Å—É–≤–∞–Ω–Ω—è. Bolt,4121,4121,6700,6700,980,0,0,1565029,False
dLPelJO6-c4-kh_I_PDfmnKfUw,1613001546,–°–∫–∞—Å—É–≤–∞–Ω–Ω—è. Bolt,4121,4121,11900,11900,980,0,0,1558329,False
xmRIo9Y4ZGED80Bs,1612982407,MAGAZYN DAY AND DAY,5499,5499,-35634,-35634,980,0,0,1546429,False,75E0-2H3H-T1E6-9X08
OaGqaF0N797DPA3C,1612951133,Bolt,4121,4121,-5700,-5700,980,0,0,1582063,False,92BE-P719-ET4P-MTP9
LsYWjF-ev7aaby1J,1612947733,Bolt,4121,4121,-4300,-4300,980,0,0,1587763,False,2TE1-C0B3-H417-P86M
t-_rPWZTKFnTsYnd,1612945105,Bolt,4121,4121,-6700,-6700,980,0,0,1592063,False
elLkFTSnSm7emTcm,1612941813,–ü–ª–∞—Ç—ñ–∂ stol-i-stul.com.ua,4829,4829,-249950,-249950,980,0,0,1598763,True
1hxWSJXNLs_d_tuF,1612894249,–í–∏–≤–µ–¥–µ–Ω–Ω—è –∫–µ—à–±–µ–∫—É 1287.70‚Ç¥,4829,4829,103659,103659,980,0,0,1848713,True
kGyg0VDancX-NGgP,1612894217,–íi–¥: –û–ª–µ—Å—è –°.,4829,4829,1000,1000,980,0,0,1745054,True
toGtsWMd2gk12FLg,1612893950,Bolt,4121,4121,-11900,-11900,980,0,0,1744054,False
exTwKjHBMbtbjXyN,1612874644,Simona,5814,5814,-36500,-36500,980,0,0,1755954,False,ACH9-H4B4-EH30-BMB5
hIdFPA1LQzOnnK_s,1612874434,–ü–∏—Ä—ñ–∂–∫–æ–≤–∞ ¬´–¢—ñ—Ç–∫–∞ –ö–ª–∞—Ä–∞¬ª,5814,5814,-13400,-13400,980,0,0,1792454,False,36B3-TA90-X850-C822
gqPjn2OJImVlz6T4,1612874332,MAGAZYN DAY AND DAY,5499,5499,-5850,-5850,980,0,0,1805854,False,25B4-KX6T-5BEM-K90T
GQkCBN162z_7A-0M,1612865051,–°–∫–∞—Å—É–≤–∞–Ω–Ω—è. Bolt,4121,4121,8000,8000,980,0,0,1811704,False
Syrxpy7c0dJzPPJL,1612865006,Bolt,4121,4121,-10200,-10200,980,0,0,1803704,False,9PHE-BCBE-6XE6-3K0E
SgEE1_yEQ9zmlNsd,1612863991,Bolt,4121,4121,-8000,-8000,980,0,0,1813904,False
ISuctuBs0KDnjL_D,1612863261,–§–∞—É–Ω–∞ –°–µ—Ä–≤—ñ—Å / Fauna Service (–§–∞—É–Ω–∞ –°–µ—Ä–≤—ñ—Å),742,742,-149000,-149000,980,0,0,1821904,False,9715-B8E6-95E1-258B
_m7J-QzXUBZSf13Y,1612789519,MAGAZYN DAY AND DAY,5499,5499,-23550,-23550,980,0,0,1970904,False,B6BT-TA50-CX7K-K2PM
EauAGYavoVtAN1BJ,1612732918,–§–∞—Ä–º–∞—Ü—ñ—è,5912,5912,-23650,-23650,980,0,0,1994454,False,59CX-A7MM-E61E-932E
ZATxtyCdLYCgPPAZ,1612726315,MAGAZYN DAY AND DAY,5499,5499,-15300,-15300,980,0,0,2018104,False,CKK3-CX4C-PX3T-M84X
LcPtGicKxSDVQagk,1612635638,Lesya,4829,4829,-300000,-300000,980,0,0,2033404,True,E4K5-A673-99EM-381M
6MPjAzCsPsdzM3cV,1612633020,Fauna-Servis,5995,5995,-53400,-53400,980,0,0,2333404,False,80P4-6BAC-AXK8-TH7C
LfA378h0uTwIVclc,1612627463,–•–ª–µ–±–Ω—ã–π,5814,5814,-14500,-14500,980,0,0,2386804,False,263C-H842-17KP-EPHX
N-QGRAClEKUA-_e0,1612617877,–ù–æ–≤–∞ –ø–æ—à—Ç–∞,7399,7399,-4100,-4100,980,0,0,2401304,False,93H6-H38E-HTT1-2408
PVGmGo5R-T0Z3uFl,1612616946,–°—ñ–ª—å–ø–æ,5411,5411,-245364,-245364,980,0,0,2405404,False,C5PK-PTTC-B7EK-9B77
yVR7RBdIDWbeWo-J,1612601871,Lesya,4829,4829,-500000,-500000,980,0,0,2650768,True,44MH-701P-64M3-48TX
1lB9GDILDW6ytFrR,1612599150,Bolt,4121,4121,-11400,-11400,980,0,0,3150768,False,8985-XM5X-5PPA-TP8C
b3_kiXkVZnWVr1Gr,1612475404,LIQPAY*FCR,5411,5411,-34400,-34400,980,0,0,3162168,False,9C27-9055-44H5-0C0A
6DMQfqpxHXbB51A9,1612377192,MAGAZYN DAY AND DAY,5499,5499,-22050,-22050,980,0,0,3196568,False,6P3A-0CP2-8B9K-MBC2
Kbslxgs0gUfUhQ-9,1612357721,MAGAZYN DAY AND DAY,5499,5499,-25600,-25600,980,0,0,3218618,False,B1P1-BP6M-AM8E-6EC0
fR6f4ZBwqfmTJ1Ev,1612355102,Lesya,4829,4829,-1000000,-1000000,980,0,0,3244218,True,KEE7-8AMA-6HK2-M7C9
8j5aBvt8ccxlnGjN,1612355080,Lesya,4829,4829,-100,-100,980,0,0,4244218,True,TPX1-KT55-XMME-6062
1KpwU8Fhcg69lxrE,1612352791,Bolt,4121,4121,-5300,-5300,980,0,0,4244318,False,HKB7-2XB0-A206-96XK
r0ALcUrXLKNZDxDx,1612351361,–§–∞—É–Ω–∞ –°–µ—Ä–≤—ñ—Å / Fauna Service (–§–∞—É–Ω–∞ –°–µ—Ä–≤—ñ—Å),742,742,-419000,-419000,980,0,40640,4249618,False,3M42-3XAP-0T1K-B91M
MSofUbOqAMQm4dbq,1612350580,Fauna-Servis,5995,5995,-40200,-40200,980,0,8040,4668618,False,K65T-A5XK-0350-85B7
w_bvEpFXk__hVbmX,1612350278,–ë–∞–Ω–∫–æ–º–∞—Ç UNIV,6011,6011,-100000,-100000,980,0,0,4708818,True,ATP7-476A-T9T0-1879
iicsv-dLD57LezF6,1612350221,–ë–∞–Ω–∫–æ–º–∞—Ç UNIV,6011,6011,-200000,-200000,980,0,0,4808818,True,74BH-EK9X-64M3-C5K5
cO87QrkbXgpFSsIu,1612347316,Bolt,4121,4121,-5400,-5400,980,0,0,5008818,False,5H47-BH6B-KKEE-C8XC
25KyNenTQeKjXSaD,1612275440,Bolt,4121,4121,-5300,-5300,980,0,0,5014218,False,6M38-5ET8-HXEC-E56E
yL596gjn_oIQD4VM,1612274309,Musaphir,5814,5814,-44000,-44000,980,0,1320,5019518,False,85E0-5B0K-AH60-23TA
b2HpzQ53UXrYllgC,1612271742,–ë–∞–Ω–∫–æ–º–∞—Ç –ü—Ä–∏–≤–∞—Ç–ë–∞–Ω–∫,6011,6011,-100000,-100000,980,0,0,5063518,False,BKKT-4M8B-C16X-753E
MwZ82V7RKp-Ywwpf,1612271706,–ë–∞–Ω–∫–æ–º–∞—Ç –ü—Ä–∏–≤–∞—Ç–ë–∞–Ω–∫,6011,6011,-100000,-100000,980,0,0,5163518,False,5KH8-58MX-36PX-55M0
BB0_rqf3BOYf8-ds,1612271647,–ë–∞–Ω–∫–æ–º–∞—Ç –ü—Ä–∏–≤–∞—Ç–ë–∞–Ω–∫,6011,6011,-100000,-100000,980,0,0,5263518,False,H26M-KA06-9320-6TCX
ti5LPnL5wtYqkkzk,1612271614,–ë–∞–Ω–∫–æ–º–∞—Ç –ü—Ä–∏–≤–∞—Ç–ë–∞–Ω–∫,6011,6011,-100000,-100000,980,0,0,5363518,False,AMMH-0KM6-A1TA-3XB4
wE22xXFSCnysV4Dn,1612271581,–ë–∞–Ω–∫–æ–º–∞—Ç –ü—Ä–∏–≤–∞—Ç–ë–∞–Ω–∫,6011,6011,-100000,-100000,980,0,0,5463518,False,5HB2-C3B4-50X7-4T54
UTlOE8rVqv587OtA,1612271545,–ë–∞–Ω–∫–æ–º–∞—Ç –ü—Ä–∏–≤–∞—Ç–ë–∞–Ω–∫,6011,6011,-100000,-100000,980,0,0,5563518,False,9A55-57CK-0P7P-8H33
1gvX4xJfWKwq0hCH,1612271507,–ë–∞–Ω–∫–æ–º–∞—Ç –ü—Ä–∏–≤–∞—Ç–ë–∞–Ω–∫,6011,6011,-100000,-100000,980,0,0,5663518,False,2380-748M-HC6T-8PAA
i9VpMes6hsgrpuQN,1612271462,–ë–∞–Ω–∫–æ–º–∞—Ç –ü—Ä–∏–≤–∞—Ç–ë–∞–Ω–∫,6011,6011,-100000,-100000,980,0,0,5763518,False,HT4H-TH43-TXXM-81A3
SBR2urZHoSiRGT8Q,1612271418,–ë–∞–Ω–∫–æ–º–∞—Ç –ü—Ä–∏–≤–∞—Ç–ë–∞–Ω–∫,6011,6011,-100000,-100000,980,0,0,5863518,False,MA0A-PC57-ECKK-KBB3
FhEQ_HxfOeADETuF,1612271341,–ë–∞–Ω–∫–æ–º–∞—Ç –ü—Ä–∏–≤–∞—Ç–ë–∞–Ω–∫,6011,6011,-100000,-100000,980,0,0,5963518,False,HK9A-4MX6-03AX-2BKC
VaAIHEZ1zP-tL1PU,1612268903,APTEKA 10,5912,5912,-111370,-111370,980,0,0,6063518,False,B671-0H7C-7BMC-CP3K
lW-fF9cqPOUzA6hq,1612266122,–î–º–∏—Ç—Ä–æ –ö.,—Å—Ç—Ä—Ö–≤–∫,4829,4829,-793000,-793000,980,0,0,6174888,True,X515-1AXC-MP4A-HB4A
zSVFDHLx9_8bxTpA,1612260536,–ê–ø—Ç–µ–∫–∞ –ê–ù–¶,5912,5912,-108690,-108690,980,0,4347,6967888,False,1C52-X7AK-4MXC-10A1
j4rGZJ9W1GctA2EN,1612259991,516874****7210,4829,4829,-56985,-56985,980,0,0,7076578,True,6K98-375H-T843-TXH2
YwnmatX2lNfnRUeW,1612259337,–ù–æ–≤–∞ –ø–æ—à—Ç–∞,4214,4214,-9800,-9800,980,0,0,7133563,False,MCX2-H79C-H5K5-B9E7
BDnffTPzWg72IQE9,1612212167,MAGAZYN DAY AND DAY,5499,5499,-42430,-42430,980,0,0,7143363,False,H7E8-34E9-A538-3KM6
28FWR3zS_ytAnbzn,1612180385,–íi–¥: –ü–†–ò–•–û–î–¨–ö–û –ï.–í. –§–û–ü,4829,4829,5500000,5500000,980,0,0,7185793,True
uyO9vjNjxLlD6mjW,1612143678,–í—ñ–¥—Å–æ—Ç–∫–∏ –∑–∞ —Åi—á–µ–Ω—å,4829,4829,2524,2524,980,0,0,1685793,True
iZ2792-WUxc0by06,1612143607,ProduktiSaks,5499,5499,-11600,-11600,980,0,0,1683269,False,C7X4-CM90-CX8E-T1EA
pxk9dGRPKN6L-xWY,1612138066,–°–∫–∞—Å—É–≤–∞–Ω–Ω—è. Bolt,4121,4121,6900,6900,980,0,0,1694869,False
Q9_MAl2H2skGG6Uo,1612138010,Bolt,4121,4121,-8600,-8600,980,0,0,1687969,False,1KBM-C9PP-8696-E4X5
PEFUbcOHZ0Me_4yv,1612137053,Bolt,4121,4121,-6900,-6900,980,0,0,1696569,False
JbB4e4NLTbfiPDQL,1617129992,MAGAZYN DAY AND DAY,5499,5499,-21400,-21400,980,0,428,3942250,False,62MA-0KX5-40T5-1HA2
7qSi1S1xeVbJUDyc,1617118701,Bolt,4121,4121,-14800,-14800,980,0,1480,3963650,False,HK4X-1XH7-875T-CXH6
i3R_XVSHdEPv6L83,1617101704,Bolt,4121,4121,-5300,-5300,980,0,530,3978450,False
JExohLNNBWp15HpA,1617092475,Bolt,4121,4121,-5500,-5500,980,0,550,3983750,False
bWA7GrwCByUjMRnJ,1617091160,MAGAZYN DAY AND DAY,5499,5499,-25400,-25400,980,0,508,3989250,False,1CB2-C680-H16C-P8K7
kYNL0sYCM_hZPCSg,1617089294,Bolt,4121,4121,-4000,-4000,980,0,400,4014650,False,9444-TT4C-P8C4-X6BH
E1mw_IPjzDJPgBGJ,1617089064,ML DILA,8099,8099,-58000,-58000,980,0,0,4018650,False,CTBX-9CEX-C5KM-1P4X
Of0JfKHIhq1uHTn9,1617088130,Bolt,4121,4121,-4000,-4000,980,0,400,4076650,False,K5P7-6M5B-CP5C-T13K
jl9M7vtv2fHgt7dm,1617036426,OK Wine,5411,5411,-249660,-249660,980,0,4993,4080650,False,H62M-TA4T-A71A-H7T0
V8Vt2YMx4_7k2Ns4,1617025305,Lesya,4829,4829,-1500000,-1500000,980,0,0,4330310,True,03TH-X13C-2B48-M774
ifT9kl86so1buNpL,1617018585,–íi–¥: –ü–†–ò–•–û–î–¨–ö–û –ï.–í. –§–û–ü,4829,4829,4300000,4300000,980,0,0,5830310,True
gSiaNVt_Fg48r3-Z,1616937453,Lafabrek,5814,5814,-3000,-3000,980,0,0,1530310,False,4BCK-A3PP-9MA1-E19B
G7Ljb-p69bHoHF1i,1616846053,–°—ñ–ª—å–ø–æ,5411,5411,-18000,-18000,980,0,180,1533310,False,TXH9-10A3-H51P-9MBB
ir5F1ZfVJKxSKjrm,1616845858,–°—ñ–ª—å–ø–æ,5411,5411,-165871,-165871,980,0,1658,1551310,False,0E30-4P9K-8KEC-ATK1
gRSv43Awz0-wZY0OBI096g,1616811062,Bolt,4121,4121,-6600,-6600,980,0,66,1717181,True
2nZ6SwanmhaXb7ybAYVVl5BqeQ,1616811062,–°–∫–∞—Å—É–≤–∞–Ω–Ω—è. Bolt,4121,4121,6500,6500,980,0,-65,1723781,False
OPUZ6Eg76iPC7JfD,1616780437,Beer Market,5921,5921,-42049,-42049,980,0,420,1717281,False,PK6P-6CAK-MXE0-AK3P
xJzE7gctxjdKSEEk,1616766711,WFP*EDA,5814,5814,-117500,-117500,980,0,0,1759330,False,B3KM-3EK7-1H24-983K
3ZDAI8i-dU4WDDRI,1616752923,Bolt,4121,4121,-8900,-8900,980,0,89,1876830,False,CBX8-30E1-ECPP-PME8
E-O1vrm7Q1XAV2FJANg3,1616719758,Bolt,4121,4121,-9100,-9100,980,0,91,1885730,True
hPtPLb1PQnKMcYFhxs1PfKVARA,1616719758,–°–∫–∞—Å—É–≤–∞–Ω–Ω—è. Bolt,4121,4121,8100,8100,980,0,-810,1894830,False
UcgtUZlBgvpwNbHN,1616687555,BalibowlCafe,5814,5814,-9500,-9500,980,0,0,1886730,False,CXE9-HC38-5C9E-57E2
cARQIl0PMSb7ckmL,1616685932,Bolt,4121,4121,-6500,-6500,980,0,65,1896230,False
KryBEWVY5vykIWFf,1616680002,WINETIME,5921,5921,-13700,-13700,980,0,137,1902730,False,P4M3-C79M-X349-823H
ZRPOeTEJcUmDd1q3,1616663665,Right Coffee Bar,5814,5814,-39900,-39900,980,0,0,1916430,False,HK7C-9A4H-T2B3-M885
o0StPXLdi09zbE1k,1616659709,Flower Time,5193,4215,-18000,-18000,980,0,0,1956330,False,0P25-PMT5-TT2T-XA34
WfH-nrVhsUpBrzSC,1616659582,–ö–æ–ª–æ,5411,5499,-18000,-18000,980,0,180,1974330,False,0PXC-2EEH-5923-H308
GR1ryle4HQUxpB_c,1616659444,MAGAZYN DAY AND DAY,5499,5499,-5800,-5800,980,0,58,1992330,False,X157-CABE-16P6-0653
oVJU5c43soQXt9hy,1616658931,Bolt,4121,4121,-5000,-5000,980,0,331,1998130,False,THX8-120C-T04X-HH34
MTzkOu8IgeV9wmhl,1616657416,Bolt,4121,4121,-6900,-6900,980,0,690,2003130,False,BKE1-44EH-4769-A20A
E9HNPk39nmyT43gw,1616654076,Bolt,4121,4121,-8100,-8100,980,0,810,2010030,False
ikYLykYDqrNUiJ6z8wxVqw,1616635084,Bolt,4121,4121,-7900,-7900,980,0,790,2018130,True
Dxgja9b1pR1U7bW-ztbKN8o3gg,1616635084,–°–∫–∞—Å—É–≤–∞–Ω–Ω—è. Bolt,4121,4121,6600,6600,980,0,-660,2026030,False
kkJtOOZcgqfbt8CF,1616613195,WFP*PETHOUSE.UA,5995,5995,-45400,-45400,980,0,0,2019430,False,HA2M-TA13-90B7-EBB2
UeH2ow17Bmii0svp,1616605885,–•–ª–µ–±–Ω—ã–π,5814,5814,-2000,-2000,980,0,0,2064830,False,CHH3-8A47-8AC4-EMXK
zeMZk0jrlPNaFOQS,1616603435,Bolt,4121,4121,-6600,-6600,980,0,660,2066830,False,TK11-2T4P-46X8-T7E3
XbzLt3YSBrt1Bzl8,1616576567,MAGAZYN DAY AND DAY,5499,5499,-9500,-9500,980,0,190,2073430,False,1XK3-HHX6-H6M7-B8BC
yZNgRErdyLXBPCVkG0Hk,1616544277,Bolt,4121,4121,-5800,-5800,980,0,580,2082930,True
BwNVgOU5Gz88bfanF1_CUB29eA,1616544277,–°–∫–∞—Å—É–≤–∞–Ω–Ω—è. Bolt,4121,4121,5300,5300,980,0,-530,2088730,False
ISoamX_z0HWDy8ei,1616523318,–ù–æ–≤–∞ –ø–æ—à—Ç–∞,7399,7399,-3900,-3900,980,0,0,2083430,False,A127-5486-0PP4-23EP
5x7Oi1zKH4245Ccx,1616523066,OK Wine,5411,5411,-52110,-52110,980,0,1042,2087330,False,K33B-KMET-MK1M-MH23
vYtLwrGsGR69SaN2,1616511843,Bolt,4121,4121,-6600,-6600,980,0,660,2139440,False
Y0PIUlMegD2CetZp,1616510038,Bolt,4121,4121,-5400,-5400,980,0,540,2146040,False,5134-363P-PE46-A8H2
hQJgITfjQ4gtIUol,1616503117,Bolt,4121,4121,-5800,-5800,980,0,580,2151440,False,AEAX-X395-6BX5-27TB
Mc_6jX8VwemeoOGg,1616484967,Bolt,4121,4121,-5300,-5300,980,0,530,2157240,False
MfQPH9QU3vh025cA,1616429588,Uklon,4121,4121,-200,-200,980,0,20,2162540,False,A3P0-H05C-TX98-H4X9
e9H-se9qnLJJXqTe,1616427119,Uklon,4121,4121,-500,-500,980,0,50,2162740,False,A0XH-X94H-TK19-T7MK
gqQRSREfSDUcfW3v,1616413407,AIRBNB,7011,7011,-83513,-2523,978,0,0,2163240,False,8KC2-PM04-TCM8-02H3
4jrVDo-neXo7To_J,1616413391,Lesya,4829,4829,-300000,-300000,980,0,0,2246753,True,H3HT-2PC9-3K6H-2M35
0l9VhUmWu36NOoU4,1616398866,MAGAZYN DAY AND DAY,5499,5499,-17400,-17400,980,0,348,2546753,False,3TA2-C6BB-X5TM-36AP
mS6dshqo-AJohN6A,1616325632,–°—ñ–ª—å–ø–æ,5411,5411,-101128,-101128,980,0,2022,2564153,False,830E-14B0-2X59-6H24
vfgUPGwRv2N0NbhHXBWNBw,1616289634,Bolt,4121,4121,-9500,-9500,980,0,950,2665281,True
5ZJYDIv3ZmHX3CcuyHdySXeCzQ,1616289634,–°–∫–∞—Å—É–≤–∞–Ω–Ω—è. Bolt,4121,4121,8600,8600,980,0,-860,2674781,False
eU6LJBYhbA2-huPd,1616241918,Bolt,4121,4121,-8100,-8100,980,0,810,2666181,False,6266-9TA2-MX45-BT79
Qog0ecAAQ_mabYjq,1616234358,Bolt,4121,4121,-6000,-6000,980,0,600,2674281,False,T932-BT85-8C91-PBEX
l1sNbEonstsWJUsY,1616228605,BWTC,5814,5814,-4000,-4000,980,0,0,2680281,False,KABH-9BMA-B3K7-6C78
WveXDgp7KTFHt5tN,1616181808,Bolt,4121,4121,-6000,-6000,980,0,600,2684281,False,0H13-KBMM-7HPC-8XEK
ZpNN0QN6HIK1B4tN,1616173994,Bolt,4121,4121,-8600,-8600,980,0,860,2690281,False
eMHVk-sxSqTc8bPs,1616167821,516875****9527,4829,4829,-45000,-45000,980,0,0,2698881,True,AXCB-2P3P-CTCC-P57K
PMJzbA1FqBwUjbzL,1616156389,BWTC,5814,5814,-41610,-41610,980,0,0,2743881,False,3782-0H7B-CX4E-4KBC
lK992G_26kgBCCnf,1616143474,MAGAZYN DAY AND DAY,5499,5499,-21100,-21100,980,0,422,2785491,False,MA71-6489-3949-M93B
vOgLiyVv28o_Okag,1616126982,Netflix,7841,4899,-33167,-999,978,0,0,2806591,False,PC1X-9CMH-CKE6-71X7
iV0T2IUoxGi3rR698Y_xEQ,1616112831,Bolt,4121,4121,-5300,-5300,980,0,530,2839758,True
WvTNKPjNxtHlCSyYuqTmV4wlwg,1616112831,–°–∫–∞—Å—É–≤–∞–Ω–Ω—è. Bolt,4121,4121,5200,5200,980,0,-520,2845058,False
TGXPEBXHwGCSdS23Lxyk,1616026202,Bolt,4121,4121,-5300,-5300,980,0,530,2839858,True
PbvwJ8A6vbyzKVdsUOj8DCUj0g,1616026202,–°–∫–∞—Å—É–≤–∞–Ω–Ω—è. Bolt,4121,4121,5000,5000,980,0,-500,2845158,False
v_DddFsmvhjnFkpZ,1615981959,Bolt,4121,4121,-5500,-5500,980,0,550,2840158,False,069C-CC75-93KA-8439
NEgamCGijmPUX5Zx,1615976029,Bolt,4121,4121,-5200,-5200,980,0,520,2845658,False
zaPNEIlvPfcNFKfi,1615967090,Bolt,4121,4121,-5000,-5000,980,0,500,2850858,False
IDPCfnly_p6WaWW_7_FZ,1615939818,Bolt,4121,4121,-13300,-13300,980,0,1330,2855858,True
Hk2R3ubdMoTfAOeiP4O3HdqLSA,1615939818,–°–∫–∞—Å—É–≤–∞–Ω–Ω—è. Bolt,4121,4121,12100,12100,980,0,-1210,2869158,False
KsPeiRFONIWQn2k_,1615905930,MAGAZYN DAY AND DAY,5499,5499,-15200,-15200,980,0,304,2857058,False,ME8C-C0BC-HBH2-H2K1
UBczyF5NbHgWeBxp,1615902838,Bolt,4121,4121,-5700,-5700,980,0,570,2872258,False,BM0T-154T-07T5-2K9B
wdXOZT7diTGlZ2-a,1615885817,MAGAZYN DAY AND DAY,5499,5499,-23140,-23140,980,0,462,2877958,False,389M-346B-208A-96PT
cd2vfuYUL2-3AZti,1615885443,Bolt,4121,4121,-19300,-19300,980,0,1930,2901098,False,0C5C-1EBK-62T2-1B37
fI8LSgZhchCohtpr,1615874537,Bolt,4121,4121,-12100,-12100,980,0,1210,2920398,False
Z5vHg-sMSRG99igp,1615826701,Bolt,4121,4121,-10100,-10100,980,0,1010,2932498,False,2KET-CXCA-XCB2-9E34
iCGWSfJCL7tqkexR,1615819367,Bolt,4121,4121,-9600,-9600,980,0,960,2942598,False,X91M-6444-PX3B-98T0
0FQQF8Im4icTy7hA,1615806011,Lesya,4829,4829,-500000,-500000,980,0,0,2952198,True,X0T0-3HMT-9A99-T628
vkYsD-NXroj-zvvr,1615805470,–íi–¥: –ü–†–ò–•–û–î–¨–ö–û –ï.–í. –§–û–ü,4829,4829,2200000,2200000,980,0,0,3452198,True
oVy0XYbAvP15d2V-,1615728022,MAGAZYN DAY AND DAY,5499,5499,-25250,-25250,980,0,252,1252198,False,40T8-XXT0-K98K-ATBH
-MEuAF8wXrUqxX3t,1615727708,OK Wine,5411,5411,-105810,-105810,980,0,1058,1277448,False,6MTE-XHBP-692E-P7PX
og1ZdZf8Y-jP_FJK,1615726661,WINETIME,5921,5921,-27900,-27900,980,0,279,1383258,False,KPA5-8X82-60CC-977E
54uHl_cGAGrA9Cyz,1615725420,LIQPAY*FOP Shubin Olek,7278,7278,-44500,-44500,980,0,0,1411158,False,PK6H-T933-AT20-P5X7
dLZMmmIN7tWyzxgt,1615715936,BWTC,5814,5814,-19010,-19010,980,0,0,1455658,False,0PKT-BECA-6HA2-24HK
gxXfy6PWRELXK0dpYS1y,1615681722,Bolt,4121,4121,-3200,-3200,980,0,32,1474668,True
BcR-KxRzjuQBLa1YqemdUQ4RbA,1615681722,–°–∫–∞—Å—É–≤–∞–Ω–Ω—è. Bolt,4121,4121,2800,2800,980,0,-280,1477868,False
dnyhXgprhxWy-bcb,1615666711,JetBrains,5817,5817,-197733,-7100,840,0,0,1475068,False,35M3-AXCB-B2H9-XE7A
kTwezdaXpxNLhDeA,1615664190,fondy.ua,5814,5814,-39900,-39900,980,0,0,1672801,False,618X-PCCM-A2C8-BP55
nhqjXAjK2DuEevkE,1615661266,fondy.ua,5814,5814,-44600,-44600,980,0,0,1712701,False,2XPT-3H7H-XAM0-C29X
th6AZLV0ZPxGjk9Q,1615649498,OK Wine,5411,5411,-71420,-71420,980,0,714,1757301,False,49T9-TE16-96K7-HPX3
ShPqXb0Tlma82zoC,1615644979,Fishkultura1,5814,5814,-345200,-345200,980,0,0,1828721,False,7P78-TATB-58H1-A5M1
F5GRCfgwuKiFwHKX,1615644953,Fishkultura,5814,5814,-72000,-72000,980,0,0,2173921,False,26EE-X43X-TB7H-E5M0
s5oVTZJgfcLEVk4H,1615635713,Bolt,4121,4121,-4500,-4500,980,0,450,2245921,False,HTT3-TKEC-2TH4-4MTK
vqcLcnWAKbLlWpeG,1615632749,Bolt,4121,4121,-3000,-3000,980,0,300,2250421,False,PM8A-AC8M-MMMH-K5HX
ZLSeh62EGyTLTdBN,1615628829,Bolt,4121,4121,-2800,-2800,980,0,280,2253421,False
aOqQrB6h5oYr5wik,1615625769,EVA,5977,5977,-11910,-11910,980,0,0,2256221,False,HP37-M6M8-MX93-KE65
oOb5gr3R2WyWDGd4,1615574335,OK Wine,5411,5411,-16640,-16640,980,0,332,2268131,False,EAEM-4M1T-K670-824H
C6Gjxrg4LErALft_,1615567578,–°–∫–∞—Å—É–≤–∞–Ω–Ω—è. Bolt,4121,4121,4500,4500,980,0,-450,2284771,False
vS4xV7rJBsUhGsWq,1615567515,–°–∫–∞—Å—É–≤–∞–Ω–Ω—è. Bolt,4121,4121,4500,4500,980,0,-450,2280271,False
CX11xQ4vXHEX8pEl,1615567493,Bolt,4121,4121,-4500,-4500,980,0,450,2275771,False
t7E3B2jaWQJkoeyS,1615567456,Bolt,4121,4121,-4500,-4500,980,0,450,2280271,False
pOHepBTYE0kiDPhX,1615559219,–í—ñ–¥: –ù–∞—Ç–∞–ª—ñ—è –ê.,4829,4829,33000,33000,980,0,0,2284771,True
CmkKSCeWVJkt1kbG,1615559114,–í—ñ–¥: –î–º–∏—Ç—Ä–æ –ö.,4829,4829,21500,21500,980,0,0,2251771,True
gYAOKpUSlj71MaPe,1615558775,MAMA-MANANA,5812,5812,-21360,-21360,980,0,0,2230271,False,M713-3CX2-4P44-1KTH
1HXxEBh9q3y_CCHb,1615557852,MAMA-MANANA,5812,5812,-72250,-72250,980,0,0,2251631,False,111A-XCB1-X96H-PP3P
IzBBvn50TF9D07R4,1615539349,PHotosalonMAN,7221,7221,-4500,-4500,980,0,0,2323881,False,835X-41MT-C14K-36KH
TrwCiP78x1wm5CL-,1615538767,Lesya,4829,4829,-300000,-300000,980,0,0,2328381,True,1ACX-AM0A-35A0-4484
Lf3X-J9hThQh4JC-,1615490205,OK Wine,5411,5411,-176300,-176300,980,0,3526,2628381,False,ME47-92CA-X73A-7AP0
MMG8493vwzEqoP5K,1615482761,–ú–∞–∫—Å–∏–º –ö.,4829,4829,-12000,-12000,980,0,0,2804681,True,846M-3XHT-5EE9-E464
lHxJQLlwz3JQQVpd,1615457366,–•–ª–µ–±–Ω—ã–π,5814,5814,-12000,-12000,980,0,0,2816681,False,8T71-A3CB-KH97-M1A3
8IXfFQRmNIshkVD2,1615457198,WINETIME,5921,5921,-78490,-78490,980,0,1569,2828681,False,5186-120B-16B7-6B68
mVMvGk44dxQzYOwV,1615452179,Lesya,4829,4829,-600000,-600000,980,0,0,2907171,True,H4AB-MPXP-A8B4-47A0
oM6q5g4IKqTiSxb7,1615449819,–íi–¥: –ü–†–ò–•–û–î–¨–ö–û –ï.–í. –§–û–ü,4829,4829,1400000,1400000,980,0,0,3507171,True
J769zmHmDDyaulXM,1615447576,"Lifecell
+380631692598",4814,4814,-14500,-14500,980,0,0,2107171,True,K87A-C53T-812H-43TE
Dtl39e4AfINjDe22,1615376270,MAGAZYN DAY AND DAY,5499,5499,-22760,-22760,980,0,455,2121671,False,2XCH-KP2K-EE06-AA50
llH7YflDyyUt55MY,1615363139,Bolt,4121,4121,-4800,-4800,980,0,480,2144431,False,96K8-0K23-TB44-8TCX
6UNKjENMeSDatUpC,1615361224,–ü–ª–∞—Ç—ñ–∂ stol-i-stul.com.ua,4829,4829,-249950,-249950,980,0,0,2149231,True
HMjO-fqTCYrFnnpQ,1615299166,GOURMET FINE DINE,5812,5812,-197496,-109584,462,0,0,2399181,False,0X3X-H6A0-H63H-5356
rjfL9-C0ibkO7Pes,1615220798,MAHOGANY PVT LTD - REE,7011,7011,-489637,-17600,840,0,0,2596677,False,9CP2-X0C0-MA4H-4KK9
IJrjJe5g_4z6hJUD,1614952694,REETHI FARU RESORT,7011,7011,-1137849,-40900,840,0,0,3086314,False,PCBK-96C1-P899-MC7H
IntWCPWRnAhtc_LR,1614562701,–í—ñ–¥—Å–æ—Ç–∫–∏ –∑–∞ –ª—é—Ç–∏–π,4829,4829,2476,2476,980,0,0,4224163,True
cB1yVeUmogznj1fY,1619699259,Lesya,4829,4829,-300000,-300000,980,0,0,3212558,True,0562-PXXX-96BT-9046
on8Z39C8QB1hiri5,1619620275,–í–∏–ø—É—Å–∫ –ø–ª–∞—Ç–∏–Ω–æ–≤–æ—ó –∫–∞—Ä—Ç–∫–∏,4829,4829,-50000,-50000,980,0,0,3512558,True
h0OvV5RsaqxGwqKF,1619536450,iPay.ua,7399,7399,-677000,-677000,980,0,0,3562558,False,6B49-E13C-TBPA-0140
bQe-NFgH2_uPUZYu,1619536437,–°–∫–∞—Å—É–≤–∞–Ω–Ω—è. Google,7399,7399,600,600,980,0,0,4239558,False
nBJFTRq3h8HnyweS,1619536435,–°–∫–∞—Å—É–≤–∞–Ω–Ω—è. Google,7399,7399,600,600,980,0,0,4238958,False
DVNzw57iqtxocF_t,1619536435,Google,7399,7399,-600,-600,980,0,0,4238358,False
zjISQrSlc9fHY8K8,1619536433,Google,7399,7399,-600,-600,980,0,0,4238958,False
nmp-5nH_Y8ud9Mis,1619531821,Lesya,4829,4829,-1200000,-1200000,980,0,0,4239558,True,44X6-C063-2A1H-2M2H
-TRL1QKmBmJRhxKS,1619524521,Simona,5814,5814,-23500,-23500,980,0,0,5439558,False,0T81-9AAP-62PC-CMT1
QxZPPOCIxl-6z08F,1619524380,–ö–æ–ª–æ,5411,5499,-2200,-2200,980,0,0,5463058,False,XM64-HB41-61PA-C56X
oV_aoFvQPk9bpPEm,1619517625,–íi–¥: –ü–†–ò–•–û–î–¨–ö–û –ï.–í. –§–û–ü,4829,4829,3800000,3800000,980,0,0,5465258,True
zxxeCFwxpSalMKYX,1619447271,–°–∫–∞—Å—É–≤–∞–Ω–Ω—è. Bolt,4121,4121,7600,7600,980,0,-76,1665258,False
jeAsImHYxv6o72H0,1619447219,Bolt,4121,4121,-8100,-8100,980,0,81,1657658,False,K2C9-790B-74B2-TH2X
MRi5-DBR8_MZSAEp,1619444854,Bolt,4121,4121,-7600,-7600,980,0,76,1665758,False
8uWoRSXHf2phlOOV,1619425373,Bolt,4121,4121,-12000,-12000,980,0,120,1673358,False,EB56-H8XM-0470-PA1T
ATYZaw4lpDWJa2BO,1619418428,Bolt,4121,4121,-10700,-10700,980,0,107,1685358,False,0M74-T9XA-7HBB-H742
M3WRcH9AVYx7mTXV,1619269524,fondy.ua,7999,7999,-65200,-65200,980,0,0,1696058,False,33EP-6MX2-X625-96CK
LPr6M-s-vVasVSP9,1619267469,–°–∫–∞—Å—É–≤–∞–Ω–Ω—è. fondy.ua,5499,5499,75300,75300,980,0,0,1761258,False
WUS08Cuzz2CN4k4B,1619267303,fondy.ua,5499,5499,-75300,-75300,980,0,0,1685958,False
hDMA1HfuSafIoQdP,1619266336,Beer Market,5921,5921,-26499,-26499,980,0,0,1761258,False,7904-0MEH-9203-2E3A
yUtgSmHsgMej7FQ_,1619107615,Bolt,4121,4121,-16700,-16700,980,0,167,1787757,False,3H07-E9MK-TP06-52K0
2R_cwCZ0Dy_VsnIG,1619090015,Bolt,4121,4121,-13500,-13500,980,0,135,1804457,False,8MEH-7239-BB63-C7MK
479d7zfwW7IYA-zOb-KEjg,1618961801,Bolt,4121,7394,-1559,-1559,980,0,15,1817957,True
s-BK89JJEufiWQP_Wr1xzg,1618961801,Bolt,4121,7394,-1296,-1296,980,0,12,1819516,True
Qtr0cdwPjt0dMatqy0I2iQ,1618961801,Bolt,4121,7394,-1245,-1245,980,0,12,1820812,True
aJAH9cWjqhUjrdXj6cy6jUdBFA,1618961801,–°–∫–∞—Å—É–≤–∞–Ω–Ω—è. Bolt,4121,7394,7500,7500,980,0,-75,1822057,False
uj-pdgdAnTUQapjh_js3kds5Hw,1618961801,–°–∫–∞—Å—É–≤–∞–Ω–Ω—è. Bolt,4121,7394,7500,7500,980,0,-750,1814557,False
wIryuMAyC8e7sxT_4qnmp5eYWA,1618961801,–°–∫–∞—Å—É–≤–∞–Ω–Ω—è. Bolt,4121,7394,7500,7500,980,0,-750,1807057,False
2FnHkBUsaSPbnYYK,1618957046,Novapay,8999,8999,-5300,-5300,980,0,0,1799557,False,2KA0-KMP2-5613-C826
WGqDYAnKoFRIF9lj,1618953170,fondy.ua,7999,7999,-20000,-20000,980,0,0,1804857,False,KH8T-M3HK-AM13-B0CB
HekHFwFbGs76J_PN,1618953144,fondy.ua,7999,7999,-20000,-20000,980,0,0,1824857,False,0CBA-EKXC-9XEM-ME9C
LSUkdCHbhV0P-ph6,1618952293,–°–∫–∞—Å—É–≤–∞–Ω–Ω—è. Bolt,4121,7394,7500,7500,980,0,-75,1844857,False
DPBkGnLLE1WheXwO,1618952108,Bolt,4121,7394,-7500,-7500,980,0,75,1837357,False
gN_HvZniYDg3ado0,1618938941,–î–µ–Ω–∏—Å –ö.,4829,4829,-13520,-13520,980,520,0,1844857,True,2HC7-KB59-28A9-476K
6DZFm1wq7du5LL_D,1618926779,Beer Market,5921,5921,-42650,-42650,980,0,0,1858377,False,T261-7C53-4918-P9CB
bobnCCZ8TounyNTX,1618848135,LIQPAY*FunKeys,5045,5045,-80000,-80000,980,0,0,1901027,False,PCM4-H4X5-C2HC-M4KP
4gbdO0_-G9QfwFN_,1618848115,–°–∫–∞—Å—É–≤–∞–Ω–Ω—è. Google,7399,7399,600,600,980,0,0,1981027,False
hMFeKGAdIxMfTEAg,1618848112,Google,7399,7399,-600,-600,980,0,0,1980427,False
XfWvPZrxMHmw2poB,1618843451,Bolt,4121,7394,-7500,-7500,980,0,75,1981027,False
rP3FXP_ou9ELTMy2,1618843308,–°—ñ–ª—å–ø–æ,5411,5411,-63800,-63800,980,0,0,1988527,False,3145-BP7A-7E9K-606E
CjgAbuPasoDNIi9d,1618843276,–°–∫–∞—Å—É–≤–∞–Ω–Ω—è. Bolt,4121,7394,7500,7500,980,0,-750,2052327,False
XvVgp1BEmXtxcqEi,1618843093,Bolt,4121,7394,-7500,-7500,980,0,750,2044827,False
r_7EhxeUj52j-_P8,1618842955,Bolt,4121,7394,-7500,-7500,980,0,750,2052327,False
woLAvwcazEbyJ0yd,1618842813,Bolt,4121,7394,-7500,-7500,980,0,750,2059827,False
NoRm1nJGm9Kb9B5b,1618820889,Bolt,4121,4121,-13200,-13200,980,0,1320,2067327,False,8E50-K7T4-P55E-PA8B
ptZiH0y3d705LLcG,1618813440,Bolt,4121,4121,-9700,-9700,980,0,970,2080527,False,6970-81P1-E5XP-EH9C
PDWQyqNDiTc5qWk1,1618761673,–°—ñ–ª—å–ø–æ,5411,5411,-12000,-12000,980,0,0,2090227,False,XPTC-2879-82BK-KTX6
NaGg_eEi6-xFRkTj,1618761626,–°—ñ–ª—å–ø–æ,5411,5411,-89792,-89792,980,0,0,2102227,False,182H-7TAA-1E0E-P6M5
NJRJAEyqerzIprgbC7jaBw,1618700812,Bolt,7394,7394,-1508,-1508,980,0,0,2192019,True
Hs1bHQ96FA3Mm8WtFBY__elTaw,1618700812,–°–∫–∞—Å—É–≤–∞–Ω–Ω—è. Bolt,7394,7394,7500,7500,980,0,0,2193527,False
WLfwOQkbufKFrsYO,1618677953,–ê–ª—å–æ–Ω–∞ –®.,–∫–æ—Ç—ã,4829,4829,-100000,-100000,980,0,0,2186027,True,0BPM-TM49-B69C-AME3
RZEILljmgSFRs4Jt,1618667109,MAGAZYN DAY AND DAY,5499,5499,-88100,-88100,980,0,0,2286027,False,H1HC-9ET2-CH8C-MMX5
2lat9Ff57vZfWZ6x,1618653980,–ö–æ–ª–æ,5411,5499,-2050,-2050,980,0,0,2374127,False,MH67-BMK7-T4H0-AKTE
oaog9pES3lUlUqwc,1618653864,–ö–æ–ª–æ,5411,5499,-18000,-18000,980,0,0,2376177,False,A0TP-KXXK-P995-P4T3
8IHlfRxgDPcvfyHV,1618647318,–ë–æ–≥–¥–∞–Ω –ë.,4829,4829,-23000,-23000,980,0,0,2394177,True,34E5-1103-B849-8KTT
7YF18-NV5JHjA15-,1618608042,ZOOLYUKS,742,742,-79500,-79500,980,0,15900,2417177,False,M69K-B626-4C6P-H55A
z7W6Eci7ekGxsuJe,1618606532,Bolt,4215,7394,-7500,-7500,980,0,0,2496677,False
NF0OYqn9yeto4mkB,1618556443,MAGAZYN DAY AND DAY,5499,5499,-12000,-12000,980,0,0,2504177,False,9494-9559-BEBC-57E9
tAuEa57WJ9kgbS43-vUXMw,1618527728,Bolt,7394,7394,-2806,-2806,980,0,0,2516177,True
F82_B5rpLJMItplWMoD28zjcLA,1618527728,–°–∫–∞—Å—É–≤–∞–Ω–Ω—è. Bolt,7394,7394,7500,7500,980,0,0,2518983,False
gTgFomSEUI9kzifY,1618491565,Lesya,4829,4829,-500000,-500000,980,0,0,2511483,True,12K3-0P7T-3AT2-M32A
f3jDTD5x05cOfrPD,1618478035,FOP PROROChENKO,7230,7230,-50000,-50000,980,0,0,3011483,False,XMP7-M86E-62PA-K305
gJrQQQu5ZlO3ZbRq,1618472870,–íi–¥: –ü–†–ò–•–û–î–¨–ö–û –ï.–í. –§–û–ü,4829,4829,2600000,2600000,980,0,0,3061483,True
NNwlJaCbYniHE0tA-_Mc,1618441670,Bolt,7394,7394,-2879,-2879,980,0,0,461483,True
Lw9QeKRNKC195qfE1Jn69Q,1618441670,Bolt,7394,7394,-2695,-2695,980,0,0,464362,True
Qcoh6ekFh-lPyfT--fvygm_sYQ,1618441670,–°–∫–∞—Å—É–≤–∞–Ω–Ω—è. Bolt,7394,7394,7500,7500,980,0,0,467057,False
1T1-Uj9QN1iGhDrNWVuf0M6dDg,1618441670,–°–∫–∞—Å—É–≤–∞–Ω–Ω—è. Bolt,7394,7394,7500,7500,980,0,0,459557,False
l4g464PIAkfkqfs_,1618423148,Produkti,5499,5499,-18000,-18000,980,0,0,452057,False,TTP5-88MX-4CTX-XE28
rtvaAEWZwVQ_faq5,1618422155,Flowerbox,5992,5992,-52500,-52500,980,0,0,470057,False,P01E-M2M0-68EA-6EEB
K6tfOcfnzSMG5BuW,1618421294,Wine and health,5921,5921,-39000,-39000,980,0,0,522557,False,91MM-1HHX-C9CE-AA80
G7ikERFygxGi_OWc,1618411272,–°–∫–∞—Å—É–≤–∞–Ω–Ω—è. Bolt,4121,4121,10000,10000,980,0,-100,561557,False
TcMTlVk3DAhno_Rf,1618410270,–§–û–ü –§—Ä–æ–ª–æ–≤ –ê—Ä—Ç–µ–º –õ–µ–æ–Ω—ñ–¥–æ–≤–∏—á,4829,4829,-1164800,-1164800,980,44800,0,551557,True,069A-KM8B-3HCE-36PM
LKkoOLk9gM9sp1Nh,1618407712,–í—ñ–¥: –ù–∞—Ç–∞–ª—ñ—è –ê.,4829,4829,28600,28600,980,0,0,1716357,True
JbB4eIJISrTkNjAJ,1618407573,Bolt,4121,4121,-10000,-10000,980,0,100,1687757,False
9KdLUie9x115wxND,1618405407,Markova Alisa,6012,6012,15000,15000,980,0,0,1697757,False
WVNhBpbDLqp-6mpW,1618402503,MAMA-MANANA,5812,5812,-72450,-72450,980,0,0,1682757,False,9C08-XBP7-7T62-6A19
sO8A6WmPrkyKDHWl,1618386798,Bolt,4121,4121,-6500,-6500,980,0,65,1755207,False,T085-XT84-TE85-9598
mnmM0f7dbcogElxP,1618383653,Bolt,4215,7394,-7500,-7500,980,0,0,1761707,False
jL1oK_bEFwewAQjr,1618383278,Produkti,5499,5499,-6000,-6000,980,0,0,1769207,False,4780-62T9-65KH-PXAA
BUF05proFc93kzZ-,1618335934,MAGAZYN DAY AND DAY,5499,5499,-6000,-6000,980,0,0,1775207,False,T94M-915K-MTK2-4TK6
BtJpUouh9IwCG6Xh,1618290857,Bolt,4215,7394,-7500,-7500,980,0,0,1781207,False
sP457wwKLoKzggGN,1618289653,Bolt,4215,7394,-7500,-7500,980,0,0,1788707,False
IDrLd_wylf0w1-63,1618247744,MAGAZYN DAY AND DAY,5499,5499,-9400,-9400,980,0,0,1796207,False,6778-9EMH-KA05-TBA5
5UY7Md5yqQ6PiG8A,1618216194,Bolt,4121,4121,-11800,-11800,980,0,118,1805607,False,K74P-M9TA-1C79-34C4
Z6JqG6lrL5GE3HwM,1618210666,–°–∫–∞—Å—É–≤–∞–Ω–Ω—è. Bolt,4121,4121,8900,8900,980,0,-89,1817407,False
-dIkT2CGU2yaVPWb,1618210621,Bolt,4121,4121,-9000,-9000,980,0,90,1808507,False,4X7P-5T2C-A3C5-155B
S1Lt03E7t0MObAH8,1618208449,MAGAZYN DAY AND DAY,5499,5499,-18000,-18000,980,0,0,1817507,False,9C90-74T0-HT48-T729
tc4ruHZEEVwjg7DI,1618207664,Bolt,4121,4121,-8900,-8900,980,0,89,1835507,False
W1jUpUt99Fpz03j9,1618171693,WFP.FASTFOOD,5811,5811,-130900,-130900,980,0,0,1844407,False,XXHH-26C2-PE4B-803A
lSCXgw9O2pV2G1dh,1618166504,Glovo,4215,5814,-21900,-21900,980,0,0,1975307,False,80X7-M02K-H4C0-B52A
iMqpttW5EK-YNwZB,1618139500,Uklon,4121,4121,-1000,-1000,980,0,10,1997207,False,T25X-2K9H-E2BX-543E
iftykMnM-D_So9Hu,1618135816,Uklon,4121,4121,-21600,-21600,980,0,1998,1998207,False,1PME-935A-4B9A-14H3
v_Nu3YDXQlJPdDVX,1618132819,Beer Market,5921,5921,-45652,-45652,980,0,0,2019807,False,2K2K-26KP-K331-AHB1
tu8TOxGdCSBmNHTv,1618085029,ZOOLYUKS,5995,5995,-50500,-50500,980,0,10100,2065459,False,880M-CK73-EKE9-717C
FvAjen15Fbj9oXBa,1618050368,Lesya,4829,4829,-100000,-100000,980,0,0,2115959,True,BC39-2179-81PB-A7HM
6ZKkVnrMQGk6ooLZ,1618049964,MAGAZYN DAY AND DAY,5499,5499,-23800,-23800,980,0,0,2215959,False,XMPB-H184-2431-ETX3
9qaW4uTHEo2cOpx3,1618048651,Bolt,4121,4121,-6200,-6200,980,0,620,2239759,False,E461-928X-4684-T89T
ozUDifDqahvaN9_A,1618042364,–°–∫–∞—Å—É–≤–∞–Ω–Ω—è. Bolt,4121,4121,5500,5500,980,0,-550,2245959,False
pmCI9g8pNK-6zWD4,1618042319,Bolt,4121,4121,-6300,-6300,980,0,630,2240459,False,4HKM-A5K4-7X59-K297
kchAPwqCVwJpuat2,1618040260,Bolt,4121,4121,-5500,-5500,980,0,550,2246759,False
206hLiH5TLM1z66w,1618036279,MAGAZYN DAY AND DAY,5499,5499,-3500,-3500,980,0,0,2252259,False,P80M-6XPB-XPHC-6MTC
rAf36ZYfXpXZ_S-L,1618036104,–ü–ª–∞—Ç—ñ–∂ stol-i-stul.com.ua,4829,4829,-249950,-249950,980,0,0,2255759,True
oRHesU882WMbl9d5,1617973886,TITKA KLARA,5814,5814,-12100,-12100,980,0,0,2505709,False,APXK-72CP-499C-CT6X
2pDJWGu6iDkDyOaV,1617973601,Beer Market,5921,5921,-29100,-29100,980,0,0,2517809,False,6KE2-EKKX-M3BB-X0X8
oock1MJ53mFbCzJi,1617956292,Lesya,4829,4829,-300000,-300000,980,0,0,2546909,True,MAT3-B8T0-302E-6H60
DBscie_o4_YkA1IX,1617902531,fondy.ua,5499,5499,-61000,-61000,980,0,0,2846909,False,57E9-881E-E957-B789
NQBZHOW3Gcu77rp_,1617898999,Bolt,4121,4121,-7200,-7200,980,0,720,2907909,False,XA70-K28B-TCX6-M4P7
G2nDGv1pI1DoeLDX,1617889188,Bolt,4121,4121,-6000,-6000,980,0,600,2915109,False,T22C-PH29-BACC-7X56
a2x8P5-GNP7TTLZF,1617884921,OK Wine,5411,5411,-100670,-100670,980,0,0,2921109,False,8EM6-5EX7-M80P-5EHM
Uwvjlp6UVNlIYAtx,1617882761,Uklon,4121,4121,-11900,-11900,980,0,1190,3021779,False,XX1C-XE66-855P-PA9A
yCetpGPLQbnAXQQO,1617882290,–°–∫–∞—Å—É–≤–∞–Ω–Ω—è. Bolt,4121,4121,5700,5700,980,0,-570,3033679,False
lJF93mPQqhH7a2Br,1617882203,Bolt,4121,4121,-10500,-10500,980,0,1050,3027979,False,1TEA-P00T-9683-38PA
STFaHp9KtpvO17yD,1617882046,Uklon,4121,4121,-10500,-10500,980,0,1050,3038479,False,43AB-E92A-XX17-298E
zxxeC101oi6vP6MU,1617881985,–°–∫–∞—Å—É–≤–∞–Ω–Ω—è. Uklon,4121,4121,100,100,980,0,-10,3048979,False
P3wGc3Hh6ipw7wWn,1617881984,Uklon,4121,4121,-100,-100,980,0,10,3048879,False
ozG2xid1k0AemJJK,1617881744,AVIC,4812,4812,-3821792,-3821792,980,0,0,3048979,False,EPH0-9C09-6124-8832
NXJcRH8sc72TYoO6,1617881624,–ó –¥–æ–ª–∞—Ä–æ–≤–æ—ó –∫–∞—Ä—Ç–∫–∏,4829,4829,2506500,2506500,980,0,0,6870771,True
SskES0tr9JJQLF2l,1617879073,Bolt,4121,4121,-5700,-5700,980,0,570,4364271,False
CFBmkI7tnd4dYKt7,1617875041,–íi–¥: –ü–†–ò–•–û–î–¨–ö–û –ï.–í. –§–û–ü,4829,4829,2500000,2500000,980,0,0,4369971,True
8X8j2laZG8BwYScS,1617874887,Bolt,4121,4121,-6100,-6100,980,0,61,1869971,False,BPPB-TTKT-B3MC-T624
1b32DW7UUJ3P5Vka,1617873967,Bolt,4121,4121,-4800,-4800,980,0,48,1876071,False,T453-8B2H-0M7T-0B88
lENjdkW79S-hV4kK,1617867310,"Lifecell
+380631692598",4814,4814,-12000,-12000,980,0,0,1880871,True,868C-375C-1531-BKBP
bG-nwFecZbjekjjI,1617815801,LIQPAY*Kuhnya BL,5812,5812,-33500,-33500,980,0,0,1892871,False,E12K-3E9K-HT0T-CK36
2wXwevFqU7J8g486,1617798008,–°–∫–∞—Å—É–≤–∞–Ω–Ω—è. Bolt,4121,4121,8500,8500,980,0,-85,1926371,False
qVe2-kL0WKrEHxug,1617797958,Bolt,4121,4121,-10000,-10000,980,0,100,1917871,False,B7E5-B4B9-P71A-2630
PN_8tRW_Xafm8n0e,1617797275,MAGAZYN DAY AND DAY,5499,5499,-15800,-15800,980,0,0,1927871,False,3HT6-K3P2-BA1T-3HM7
6yGRI5DRHjOlim94,1617796466,Bolt,4121,4121,-8500,-8500,980,0,85,1943671,False
LL9aSDvJA65Ck3VE,1617789709,Portmone,4814,4814,-24794,-24794,980,0,0,1952171,False,C752-TX7P-K8AX-X995
j9Os3adHwIbzf_C7,1617789699,–°–∫–∞—Å—É–≤–∞–Ω–Ω—è. Google,7399,7399,600,600,980,0,0,1976965,False
flCZOwVZ_eFa_gMn,1617789695,Google,7399,7399,-600,-600,980,0,0,1976365,False
c1WIBEveNWzQ7JXa,1617789556,Bolt,4121,4121,-10300,-10300,980,0,103,1976965,False,AE1A-EHTE-X3B6-82X0
Q6p2rb3ZdPS8JXxU,1617787131,Bolt,4121,4121,-8400,-8400,980,0,84,1987265,False,HMKA-1123-K156-BMX3
myVFhdsTyzD4eofE,1617705852,MAGAZYN DAY AND DAY,5499,5499,-13000,-13000,980,0,0,1995665,False,K60X-A8KB-B461-K60B
eY3WgpMOMcO5cx1diIjMiWc,1617675106,Bolt,4121,4121,-10700,-10700,980,0,1070,2008665,True
scWfr20VhS_X0E11lICNfVWFzg,1617675106,–°–∫–∞—Å—É–≤–∞–Ω–Ω—è. Bolt,4121,4121,10600,10600,980,0,-1060,2019365,False
EI_-Sln7JI4tOgS7,1617642183,MAGAZYN DAY AND DAY,5499,5499,-8100,-8100,980,0,0,2008765,False,E2HH-9T06-P73B-P311
o0O-tdpIwGPBVB07,1617527813,OK Wine,5411,5411,-22120,-22120,980,0,0,2016865,False,0TP7-3P8K-A98H-8C5X
eKTBJfc90_XhadGE,1617527715,–ù–æ–≤–∞ –ø–æ—à—Ç–∞,4214,4214,-2600,-2600,980,0,0,2038985,False,PA6T-36T9-88HX-73PA
_zTI2Y7JxoTl2c2c,1617527551,MAGAZYN DAY AND DAY,5499,5499,-66885,-66885,980,0,0,2041585,False,C14H-9XE3-TXXP-TB79
7BilfMFmt8s858jF,1617525741,Bolt,4121,4121,-5000,-5000,980,0,500,2108470,False,C1M1-26EC-CE59-8PBB
2WjtT5dywpepV7Vj,1617522722,–°–∫–∞—Å—É–≤–∞–Ω–Ω—è. Bolt,4121,4121,5900,5900,980,0,-590,2113470,False
I6qb-k2T4X45e6WE,1617522673,Bolt,4121,4121,-7100,-7100,980,0,710,2107570,False,0C59-6C3H-P30T-H7BC
u5DPDEP8pcuR5U5s,1617520596,Bolt,4121,4121,-5900,-5900,980,0,590,2114670,False
CS0AQ2iWzxe5CftM,1617449360,Bolt,4121,4121,-10600,-10600,980,0,1060,2120570,False
PVhyirbeNvz-Fw69,1617447660,Bolt,4121,4121,-9000,-9000,980,0,900,2131170,False,TBE8-X408-HX6B-9281
BtdJFx9l5aP5wzUZ,1617446862,–°–∫–∞—Å—É–≤–∞–Ω–Ω—è. Bolt,4121,4121,5179,7500,980,0,-517,2140170,False
OE5m4LRuREyTmGiJ,1617446467,Bolt,4121,4121,-7500,-7500,980,0,750,2134991,False
02tZrs1zheBHZlWG,1617446228,–°–∫–∞—Å—É–≤–∞–Ω–Ω—è. Bolt,4121,4121,5262,7500,980,0,-526,2142491,False
eNajzABTGbPtu6Hx,1617445777,Bolt,4121,4121,-7500,-7500,980,0,750,2137229,False
0Eer4hjbBrPUmgB-,1617437819,McDonald‚Äôs,5814,5814,-29900,-29900,980,0,0,2144729,False,A9M5-X5E9-6P4B-E2HA
hqY9lHy8dpE-8XpL,1617437274,MAGAZYN DAY AND DAY,5499,5499,-12000,-12000,980,0,0,2174629,False,PM2E-4MT1-0BM6-P7PX
vMZcejfpODGSaZsR,1617437260,Bolt,4121,4121,-10100,-10100,980,0,1010,2186629,False,81H2-M237-PE10-K3T7
wCgoo-VrOctGjErs,1617435891,Right Coffee Bar,5814,5814,-6000,-6000,980,0,0,2196729,False,5M4K-98MP-T36E-A8PC
QceaGvmLz9gHLy5e,1617377569,Lesya,4829,4829,-600000,-600000,980,0,0,2202729,True,41KP-A79K-PX86-5395
tZRzw9mK58RUc_qQ,1617362293,–ë–∞–Ω–∫–æ–º–∞—Ç DN00 st.Sichovykh Stri,6011,6011,-100000,-100000,980,0,0,2802729,False,KH04-MH6M-8MXP-185X
u-rsKCDdDJmPNxAt,1617362250,–ë–∞–Ω–∫–æ–º–∞—Ç DN00 st.Sichovykh Stri,6011,6011,-100000,-100000,980,0,0,2902729,False,1871-2X4X-AM7X-PPC2
DxoFPLpU2ZkAdJ_t,1617362222,MOYO,5722,5045,-299900,-299900,980,0,0,3002729,False,8A24-AM79-ABX4-1PPP
bJptAjX0Qryepy3o,1617362166,–ë–∞–Ω–∫–æ–º–∞—Ç DN00 st.Sichovykh Stri,6011,6011,-100000,-100000,980,0,0,3302629,False,CP4C-4CE2-K5P7-P09C
2RxaPIZZIPAIUrl3,1617362124,–ë–∞–Ω–∫–æ–º–∞—Ç DN00 st.Sichovykh Stri,6011,6011,-100000,-100000,980,0,0,3402629,False,A9PC-0P2H-01A8-H8E3
PJMFybmBN5zQmeHQ,1617362077,–ë–∞–Ω–∫–æ–º–∞—Ç DN00 st.Sichovykh Stri,6011,6011,-100000,-100000,980,0,0,3502629,False,5672-49P6-HPH8-1XT1
FAz3FxWiC86SIu-w,1617350991,MAGAZYN DAY AND DAY,5499,5499,-12000,-12000,980,0,0,3602629,False,H78B-CETT-5647-7EPK
hdgfvvuc0LhhWlYs,1617343866,Uklon,4121,4121,-8300,-8300,980,0,830,3614629,False,BB75-1XB2-5AK1-6TH0
jI23y_fFfMhaXeBU,1617298736,VETERENARNYY GOSPITAL,742,742,-24000,-24000,980,0,0,3622929,False,XB3A-0AAT-B7EM-B426
fZk05gMg2_gIXx-R,1617261192,Uklon,4121,4121,-2700,-2700,980,0,0,3646929,False,9H7C-TM5C-EAP8-4X93
khm3GVEXp_6336Wm,1617259030,Uklon,4121,4121,-13700,-13700,980,0,0,3649629,False,0MMM-0549-AT8M-2867
scZ5Csm8VPZTlNJp,1617255367,MAGAZYN DAY AND DAY,5499,5499,-9800,-9800,980,0,0,3663329,False,P3K9-8HHX-PH5H-577B
-rE1t-Wdtm4-vM41,1617253346,–í—ñ–¥—Å–æ—Ç–∫–∏ –∑–∞ –±–µ—Ä–µ–∑–µ–Ω—å,4829,4829,2419,2419,980,0,0,3673129,True
LymW8s8uzS7HR_9H,1622376812,Bolt,4121,4121,-5600,-5600,980,0,56,1748802,False,3B76-4262-KABC-KEXB
3ODsAhXEOhHDxyul,1622376720,Goodwine,5921,5921,-93900,-93900,980,0,0,1754402,False,P0AA-X22E-P4AB-CP78
jrJmrimYewfp61Fo,1622371148,KAFE,5812,5812,-26500,-26500,980,0,265,1848302,False,K45M-693B-BBX3-91KK
ehjShV7h-RrAMQv5,1622368684,–°–∫–∞—Å—É–≤–∞–Ω–Ω—è. Bolt,4121,4121,3300,7300,980,0,-33,1874802,False
GXjCSFeeZ3OMHQMT,1622367797,Bolt,4121,4121,-7600,-7600,980,0,76,1871502,False,66P8-1E7M-TC55-EH8E
y8IASXxwfexjWz39,1622367031,Bolt,4121,4121,-7300,-7300,980,0,73,1879102,False
xGcYbLfg9yaxFB6W,1622364216,MAGAZYN DAY AND DAY,5499,5499,-32340,-32340,980,0,0,1886402,False,C7KB-ECX0-1A7B-CHC4
5Y6CTUlWZGOPAztbYTZjFw,1622331075,–°–∞–º–æ–∫–∞—Ç—ã Bolt,7999,7999,-2894,-2894,980,0,0,1918742,True
YgbNvTN5y-gI4-8v0bAGa93QLA,1622331075,–°–∫–∞—Å—É–≤–∞–Ω–Ω—è. –°–∞–º–æ–∫–∞—Ç—ã Bolt,7999,7999,7500,7500,980,0,0,1921636,False
s1Ki6l5S3CTjZa2b,1622304756,–í–µ–ª–∏–∫–∞ –ö–∏—à–µ–Ω—è,5499,5499,-12904,-12904,980,0,0,1914136,False,B3PT-38BA-K032-997C
Y5oZj5PPA7HpiVHU,1622303179,–ö–æ–ª–æ,5411,5814,-15200,-15200,980,0,0,1927040,False,K08T-2T8C-5AC0-97E5
jtf6MWOrPoOlCtS0,1622268677,–û–±—Å–ª—É–≥–æ–≤—É–≤–∞–Ω–Ω—è –ø–ª–∞—Ç–∏–Ω–æ–≤–æ—ó –∫–∞—Ä—Ç–∫–∏,4829,4829,-25000,-25000,980,0,0,1942240,True
Di_rZXURwWbYgNd-VPxM0g,1622246714,–°–∞–º–æ–∫–∞—Ç—ã Bolt,7999,7999,-1355,-1355,980,0,0,1967240,True
E_T72ztwKyoetr8l0kIvqw,1622246714,–°–∞–º–æ–∫–∞—Ç—ã Bolt,7999,7999,-2116,-2116,980,0,0,1968595,True
ATsjlFgVLb0ijwhj4ZvqOu-qQA,1622246714,–°–∫–∞—Å—É–≤–∞–Ω–Ω—è. –°–∞–º–æ–∫–∞—Ç—ã Bolt,7999,7999,7500,7500,980,0,0,1970711,False
Y6co8TtB3eCFiNT_Qkd2PfuTeg,1622246714,–°–∫–∞—Å—É–≤–∞–Ω–Ω—è. –°–∞–º–æ–∫–∞—Ç—ã Bolt,7999,7999,7500,7500,980,0,0,1963211,False
5uqA_iEMjVl_Fltz,1622219692,MAGAZYN DAY AND DAY,5499,5499,-38750,-38750,980,0,0,1955711,False,K28P-KC2K-8T89-5H53
kfx108TDMvmkeinp,1622187849,fondy.ua,7999,7999,-7500,-7500,980,0,0,1994461,False
NgCy_p6N3UyBRZYr,1622121322,–°–∫–∞—Å—É–≤–∞–Ω–Ω—è. Bolt,4121,4121,6900,6900,980,0,-690,2001961,False
BsF3iOKRnmAERZnQ,1622121292,Bolt,4121,4121,-6900,-6900,980,0,245,1995061,False,BTET-3H18-2A5B-BMCH
r0ewTBFOrqtlxCjO,1622121054,Bolt,4121,4121,-6900,-6900,980,0,690,2001961,False
4qhBqg3NERn3wRDT,1622106091,fondy.ua,7999,7999,-7500,-7500,980,0,0,2008861,False
CaTpDCyoidz2_A3h,1622102153,Bolt,4121,4121,-5200,-5200,980,0,520,2016361,False,607A-PCB3-045T-KPE7
74lSxrp_39MSpsIH,1622100023,Bolt,4121,4121,-5900,-5900,980,0,590,2021561,False,T7XM-85EH-7M79-P53X
IEV0WjP9YPjiARB_,1622095618,–í–∏–≤–µ–¥–µ–Ω–Ω—è –∫–µ—à–±–µ–∫—É 1232.85‚Ç¥,4829,4829,99243,99243,980,0,0,2027461,True
4qvd7Hc-qoGF7Vdl,1622093582,Bolt,4121,4121,-19700,-19700,980,0,197,1928218,False,H8AE-BK6M-M4A5-8874
KIYOiWb3fi3Vb3j2DXPRPA,1622073760,–°–∞–º–æ–∫–∞—Ç—ã Bolt,7999,7999,-2243,-2243,980,0,0,1947918,True
HIdndELlWCtJyJ9eiKde-g,1622073760,–°–∞–º–æ–∫–∞—Ç—ã Bolt,7999,7999,-1822,-1822,980,0,0,1950161,True
B2dlwRmryJHWxslwGk2SX4e1Wg,1622073760,–°–∫–∞—Å—É–≤–∞–Ω–Ω—è. –°–∞–º–æ–∫–∞—Ç—ã Bolt,7999,7999,7500,7500,980,0,0,1951983,False
W3KdT1xybyelwIH1kSphX0H9-A,1622073760,–°–∫–∞—Å—É–≤–∞–Ω–Ω—è. –°–∞–º–æ–∫–∞—Ç—ã Bolt,7999,7999,7500,7500,980,0,0,1944483,False
AOb3ESYsCp0KzU4t,1622050103,MAGAZYN DAY AND DAY,5499,5499,-31090,-31090,980,0,0,1936983,False,1K58-04X1-KB95-XE0P
_Wc70YeuSgG8gC46,1622034501,fondy.ua,7999,7999,-7500,-7500,980,0,0,1968073,False
Msyp6Dm-CTkCCpVf,1622030333,–°–∫–∞—Å—É–≤–∞–Ω–Ω—è. Bolt,4121,4121,4900,4900,980,0,-49,1975573,False
o3FrI2rz0QWHtexa,1622030282,Bolt,4121,4121,-5600,-5600,980,0,56,1970673,False,8717-CXCC-C7AP-21P9
HxRDHBlGl4ilgXPU,1622027881,Bolt,4121,4121,-4900,-4900,980,0,49,1976273,False
3UyYuIqjFbORMjMc,1622015707,fondy.ua,7999,7999,-7500,-7500,980,0,0,1981173,False
Uc7HbCu4cEIOtrwg,1621964352,MAGAZYN DAY AND DAY,5499,5499,-12490,-12490,980,0,0,1988673,False,5XA2-H53M-A6A4-A334
oeK_9NuXYvwBuOTt,1621941925,bwtc cafe&roasters,5814,5814,-16800,-16800,980,0,504,2001163,False,2K3B-4HM3-BXHB-K2XK
LRNNvbLiG1wwNrpe,1621872075,–í–∞–¥–∏–º –¢.,4829,4829,-12800,-12800,980,0,0,2017963,True,41CM-EP88-AECP-98TB
rnvQDHf-hOsB1SXX,1621869629,Bolt,4121,4121,-8900,-8900,980,0,890,2030763,False,3EC5-X9E8-XCM6-PBCP
0y3uZHXr2hiNOvDW,1621868967,–°–∫–∞—Å—É–≤–∞–Ω–Ω—è. Bolt,4121,4121,7800,7800,980,0,-780,2039663,False
_7MsIu7-C2mDfeUD,1621868764,Bolt,4121,4121,-8100,-8100,980,0,810,2031863,False,30MX-1EKK-76X8-21T2
8gr7oILrs0W9ZeOP,1621866402,Bolt,4121,4121,-7800,-7800,980,0,780,2039963,False
dFe4MgS_yXrV6s_d,1621860597,–°–∫–∞—Å—É–≤–∞–Ω–Ω—è. Bolt,4121,4121,6900,6900,980,0,-690,2047763,False
2_OLGeHcilY-hKec,1621860538,Bolt,4121,4121,-8600,-8600,980,0,860,2040863,False,8CA6-EE25-TET4-K7BH
Nz3_hch_YAkfaumC,1621858989,Bolt,4121,4121,-6900,-6900,980,0,690,2049463,False
XaMRkQm9avaWtwI6,1621848083,Lesya,4829,4829,-500000,-500000,980,0,0,2056363,True,6K46-882E-94K0-CMCE
fQUTtZGiye_mISQG,1621843016,fondy.ua,7999,7999,-7500,-7500,980,0,0,2556363,False
dFFa7V8G46qC48D6,1621842349,fondy.ua,7999,7999,-7500,-7500,980,0,0,2563863,False
w3m3YsTvLa9HLrr_,1621786089,MAGAZYNShop 146,5499,5499,-4370,-4370,980,0,0,2571363,False,8XTT-M4E0-177T-6A6A
EXG5CnaNe-1u3TZN,1621773992,–°—ñ–ª—å–ø–æ,5411,5411,-18000,-18000,980,0,0,2575733,False,8M67-T2PC-P3A7-1TP2
yo2KTTlHllppyE4p,1621773951,–°—ñ–ª—å–ø–æ,5411,5411,-52164,-52164,980,0,0,2593733,False,37XB-A43M-8X7K-6TT3
i52xPUfZLXQbrvFu,1621772425,Bolt,4121,4121,-4800,-4800,980,0,480,2645897,False,4PP2-4PEM-H3A7-4195
jiEJ00OcfV4zMR5N,1621760859,TITKA KLARA,5814,5814,-6300,-6300,980,0,189,2650697,False,5911-7K9T-C4AT-4M7C
o4yB3vAjmWLa0VIPzgMn,1621726988,"–°–∫–∞—Å—É–≤–∞–Ω–Ω—è. LIQPAY*Antonenko Marin, LIQPAY*Antonenko Marin,DN-SK,UA, DN-SK, UA",8999,8999,32800,32800,980,0,0,2656997,True
9XgUVXAr8GBr7VRH,1621706979,MAGAZYN DAY AND DAY,5499,5499,-21800,-21800,980,0,0,2624197,False,3HM1-E07K-8M4A-K7EE
PNjd_ZDAtUvzTUR7,1621697135,Beer Market,5921,5921,-16601,-16601,980,0,0,2645997,False,B01H-6155-B416-7APX
5p2ch3oFsLfrY8yw,1621696333,–ß–µ—Ä–Ω–æ–º–æ—Ä–∫–∞,5814,5814,-48300,-48300,980,0,1449,2662598,False,K7CC-ATP1-X35P-CHCH
r9SRLNN8na-JUIuX,1621620383,–í—ñ–¥: –û–ª–µ–∫—Å–∞–Ω–¥—Ä–∞ –ë.,4829,4829,12000,12000,980,0,0,2710898,True
sYhC7FTVKHyz0nKD,1621618051,Markova Alisa,6012,6012,12000,12000,980,0,0,2698898,False
aqDFXRNvNdf3SwzN,1621599346,–í—ñ–¥: –°–µ—Ä–≥—ñ–π –Æ.,–ü'—è–Ω–∞ –≤–∏—à–Ω—è,4829,4829,12000,12000,980,0,0,2686898,True
FCAfhcH9JRmIiWhq,1621584680,–ü‚Äô—è–Ω–∞ –≤–∏—à–Ω—è,5812,5812,-7800,-7800,980,0,234,2674898,False,XXCP-8HBH-P93B-E8M1
evnUE7KEkygRQpk-,1621584602,Endorphine Coffee To Go,5451,5451,-4700,-4700,980,0,0,2682698,False,KP8T-BT57-M511-A7CE
FW_mRYYknsE2l2-c,1621584549,–°—É–ø–µ—Ä–º–∞—Ä–∫–µ—Ç,5499,5499,-12000,-12000,980,0,0,2687398,False,0P7E-9AHH-419X-A1AK
TgTk1k3QS17lUPxS,1621543194,OldBricks1,5814,5814,-63200,-63200,980,0,1896,2699398,False,858H-TBKC-A6B3-947C
Wfzg3z62GX7KHtoV,1621522504,–ü‚Äô—è–Ω–∞ –≤–∏—à–Ω—è,5812,5812,-127500,-127500,980,0,3825,2762598,False,H3P7-P18E-9BKH-4HM6
7qPm6G0xYJJ1nnq3,1621522463,–ü‚Äô—è–Ω–∞ –≤–∏—à–Ω—è,5812,5812,-3900,-3900,980,0,117,2890098,False,H63H-70X2-2T1K-36C2
ubKVBCFXUZAEgFY3,1621408695,–ù–æ–≤–∞ –ø–æ—à—Ç–∞,7399,7399,-4500,-4500,980,0,0,2893998,False,P0K5-27P5-TK5E-E697
IKaOI--uwR0ck-UG3p2rNQ,1621380822,fondy.ua,7999,7999,-2388,-2388,980,0,0,2898498,True
wLlN26Y7Mk3alCfKOQA33htt4Q,1621380822,–°–∫–∞—Å—É–≤–∞–Ω–Ω—è. fondy.ua,7999,7999,7500,7500,980,0,0,2900886,False
5HgRa6Uhwzyvae19,1621338269,MAGAZYN DAY AND DAY,5499,5499,-18000,-18000,980,0,0,2893386,False,21P4-E4PC-B8AK-EPKB
NXt8pxGKvnC6-LJ_bhmKSA,1621301419,fondy.ua,7999,7999,-6458,-6458,980,0,0,2911386,True
VwDZhQ4CD66jH2sfOFFTDAbmbA,1621301419,–°–∫–∞—Å—É–≤–∞–Ω–Ω—è. fondy.ua,7999,7999,7500,7500,980,0,0,2917844,False
woGGCu6zx4tAbTRD,1621260376,fondy.ua,7999,7999,-7500,-7500,980,0,0,2910344,False
pN60G1PxxQIUqsj4,1621250883,Lesya,4829,4829,-3000000,-3000000,980,0,0,2917844,True,0251-HX71-7TCK-6A6K
7emuta_5VpPKthxp,1621247714,–ú—ñ—Å—å–∫–µ –∫–∞—Ñ–µ ¬´–•–∞—Ä–º—Å¬ª (–ö–Ω–∏–∂–∫–æ–≤–∞ –∫—Ä–∞–º–Ω–∏—Ü—è ¬´–•–∞—Ä–º—Å¬ª),5814,5814,-8960,-8960,980,0,268,5917844,True,XT7X-PXX1-0X3C-MM9K
GAY-6svcFemyG7pM,1621247112,–íi–¥: –ü–†–ò–•–û–î–¨–ö–û –ï.–í. –§–û–ü,4829,4829,5000000,5000000,980,0,0,5926804,True
_Ei6LbkErx_8a9As,1621238770,SIGARNIY DIM FORTUNA,5993,5993,-18000,-18000,980,0,0,926804,False,AH68-075C-H5P8-CP7M
Zkcc_QCsmhY3kmBP,1621187552,MAGAZYN DAY AND DAY,5499,5499,-8300,-8300,980,0,0,944804,False,CH76-KCPP-2KT7-H1E5
7rJao-GZplwvE3ut,1621165268,–ß—ñ–∑–∞—Å–∫–∞,5814,5812,-36500,-36500,980,0,365,953104,False,A0T4-B899-C13M-X414
zTox4jYq8cQO_wMx,1621162713,MAGAZYN DAY AND DAY,5499,5499,-24150,-24150,980,0,0,989604,False,8MAK-K48K-MB3H-CP0X
4c588l02M1bYWvIO,1621159972,fondy.ua,7999,7999,-7500,-7500,980,0,0,1013754,False
MJHN5Qe2skomwI9A,1621157688,Simona,5814,5814,-7500,-7500,980,0,75,1021254,False,24AP-2P3X-MT4X-84K6
YSGP_jQLWdj46ZpD,1621157684,Simona,5814,5814,-38000,-38000,980,0,380,1028754,False,1C17-04MA-T4TE-PA1H
ygXQAvK_q6ofPCCD,1621084893,–ù–æ–≤–∞ –ø–æ—à—Ç–∞,4214,4214,-5900,-5900,980,0,0,1066754,False,P3P7-C164-CX1E-4X23
iSO1N4NqTrhtCjpQ,1621084628,EAS ZBROYA NESTERIVSKI,5941,5941,-46400,-46400,980,0,0,1072654,False,90M5-6PB2-AP3A-0P32
qLU5DQ3Pyky-h_He,1621082557,restoranChChKO,5812,5812,-15000,-15000,980,0,150,1119054,False,0TX8-4TCE-T6B7-7MX0
EgeFMcEBY-2fRMvW,1621082540,restoranChChKO1,5812,5812,-138300,-138300,980,0,1383,1134054,False,TEAE-4E8P-P7X4-B252
N44RlPiNHpZR2Mju,1621071664,–í—ñ–¥: –ë–æ–≥–¥–∞–Ω –ë.,4829,4829,17000,17000,980,0,0,1272354,True
XyhIOrNm7yAvvW82,1621070365,FUIB MoneyTransfer,6012,6012,60000,60000,980,0,0,1255354,False
fHoUP34xCIfZOosu,1621029226,RESTAURANT COSMOPOLITE,5812,5812,-6000,-6000,980,0,60,1195354,False,60BE-2HK0-05CM-5XAP
lI2-Vid65bUi44x7,1621029202,RESTAURANT COSMOPOLITE,5812,5812,-65000,-65000,980,0,650,1201354,False,0CH9-M7M5-BTT8-PH58
ab9ah0rszLsDIciC,1621014572,KuznjaRebrataPiva,5814,5814,-38400,-38400,980,0,384,1266354,False,CPXC-MMCT-1T3P-51T4
pUVnKi0889Ixv5CM,1621014552,KuznjaRebrataPiva1,5814,5814,-146900,-146900,980,0,1469,1304754,False,CH54-1905-X732-5990
gqDAtunemLwacoAo,1620982819,PHotovramke,7221,7221,-35500,-35500,980,0,0,1451654,False,AX56-8A2X-0BKX-C36B
LenQlA6ER2jXuOyB,1620930011,LIQPAY*FOP Kabardin Vo,5942,5942,-95000,-95000,980,0,0,1487154,False,CXCP-MP43-5413-K5H1
PWxXzcKIGgCtfF1Y,1620930000,–°–∫–∞—Å—É–≤–∞–Ω–Ω—è. Google,7399,7399,600,600,980,0,0,1582154,False
DQ1eMsQ3Y957OwM7,1620929999,Google,7399,7399,-600,-600,980,0,0,1581554,False
S22HUQ0pbwWfxEQn,1620925472,–ö–æ–ª–æ,5411,5499,-18000,-18000,980,0,0,1582154,False,5948-0EK7-X9XC-KK4A
YIVI3Nq3ImPI9Yi1,1620823686,MAGAZYN DAY AND DAY,5499,5499,-16100,-16100,980,0,0,1600154,False,B4XX-75TP-B093-T973
38hf23zJkq_vUEbe,1620756702,MAGAZYN DAY AND DAY,5499,5499,-16950,-16950,980,0,0,1616254,False,ME31-4E3H-H823-EKA2
My73NZWmT-JuQEM_,1620739693,Simona,5814,5814,-43000,-43000,980,0,430,1633204,False,6M90-5C4X-TKP5-X2TX
OvulzMS0zdLObwj2,1620717518,–ö–æ–ª–æ,5411,5499,-21200,-21200,980,0,0,1676204,False,3M6A-8CEB-2MM2-7M1H
WEBbsx1fytRF_MCq,1620677679,–°–∫–∞—Å—É–≤–∞–Ω–Ω—è. PayPal,5999,5999,2785,100,840,0,0,1697404,False
3gLnzwSWHYKYP6Xz,1620677676,PayPal,5999,5999,-2785,-100,840,0,0,1694619,False
IpMQXpmBtciiYDh_,1620677645,–°–∫–∞—Å—É–≤–∞–Ω–Ω—è. PayPal,5999,5999,2785,100,840,0,0,1697404,False
RzJFdkuFSQ1staDD,1620677641,PayPal,5999,5999,-2785,-100,840,0,0,1694619,False
nidwbGUOIf_yxuL6,1620677613,–°–∫–∞—Å—É–≤–∞–Ω–Ω—è. Google,7399,7399,600,600,980,0,0,1697404,False
znfauOjO3Ws9Yytz,1620677611,Google,7399,7399,-600,-600,980,0,0,1696804,False
3I7lfEP9UwO1KKr2,1620677474,–°–∫–∞—Å—É–≤–∞–Ω–Ω—è. Google,7399,7399,600,600,980,0,0,1697404,False
HL8gqle_yQSwGB3V,1620677472,Google,7399,7399,-600,-600,980,0,0,1696804,False
z_sDJ4IvMzePKo4-,1620677406,–°–∫–∞—Å—É–≤–∞–Ω–Ω—è. Google,7399,7399,600,600,980,0,0,1697404,False
n_1DDinyo1i6QZdd,1620677405,–°–∫–∞—Å—É–≤–∞–Ω–Ω—è. PayPal,5999,5999,2785,100,840,0,0,1696804,False
X2pbS3SGScL5i-7n,1620677404,Google,7399,7399,-600,-600,980,0,0,1694019,False
H3zwaSFn5Liwv_FI,1620677401,PayPal,5999,5999,-2785,-100,840,0,0,1694619,False
EJ5KABR9PURH2xBA,1620656194,TOV KEYTERING SERVIS,5812,5812,-95900,-95900,980,0,959,1697404,False,PE0C-8P4C-7T47-1PBK
xd-8v-F1sKoVYGsl,1620656168,RESTORANMYaSOUVOGN,5814,5814,-28400,-28400,980,0,284,1793304,False,2665-7PP4-XHM2-2BAP
2BvJhJUyeQH3zQCj,1620646153,–°–∫–∞—Å—É–≤–∞–Ω–Ω—è. Bolt,4121,4121,11300,11300,980,0,-113,1821704,False
rBwgjvVPkSbQXrcG,1620646092,Bolt,4121,4121,-14000,-14000,980,0,140,1810404,False,C0B9-MK88-C058-88B1
frTUOjVayy8k1xCW,1620642401,Bolt,4121,4121,-11300,-11300,980,0,113,1824404,False
dZd0aWnHZ-zh2iOK,1620626964,–ü–ª–∞—Ç—ñ–∂ stol-i-stul.com.ua,4829,4829,-249950,-249950,980,0,0,1835704,True
XihxjjlIeGjP8G6M,1620565280,MAGAZYN DAY AND DAY,5499,5499,-49500,-49500,980,0,0,2085654,False,C889-982P-P82X-802M
6-fEPPqOn7hrRcfo,1620555074,Bolt,4121,4121,-8600,-8600,980,0,860,2135154,False,4HM9-P9C6-A459-C134
7bEY2PcIENGJ0akM,1620555066,–°–∫–∞—Å—É–≤–∞–Ω–Ω—è. Bolt,4121,4121,6800,6800,980,0,-680,2143754,False
Uckao3-SFmW5eD4t,1620554529,Bolt,4121,4121,-6800,-6800,980,0,680,2136954,False
23lwlKElCsXAL-IK,1620549799,MAGAZYN DAY AND DAY,5499,5499,-120607,-120607,980,0,0,2143754,False,86AB-HT8E-MXE9-PE8H
2jwjO5ruUisP-sIW,1620549758,Bolt,4121,4121,-6600,-6600,980,0,660,2264361,False,50PK-MB00-7H51-2X89
gBRLviPVV9d0f4Yf,1620485872,Beermood,4215,4215,-35400,-35400,980,0,0,2270961,False,PB10-E7T6-KM7P-KAP3
JsvOVPSVr6335X8M,1620483196,McDonald‚Äôs,5814,5814,-30700,-30700,980,0,921,2306361,False,H75H-P48T-EEHK-H758
NRWm0P2RAt7HqxWP,1620480593,FELIZPodol,5814,5814,-52000,-52000,980,0,1560,2337061,False,C8CX-MK29-C5E7-TB0P
lnAiFK2PKWGTXw69,1620466694,MAGAZYN DAY AND DAY,5499,5499,-12440,-12440,980,0,0,2389061,False,0KH9-P905-417K-3C33
CwDL4W6CvPoELpx6,1620406104,MAGAZYN DAY AND DAY,5499,5499,-26040,-26040,980,0,0,2401501,False,2C54-753P-X337-8X0H
wz4mi9mAwhPNpgyA,1620402867,PHotovramke,7221,7221,-58000,-58000,980,0,0,2427541,False,4A0X-0T4B-CAMA-7592
3ZZbVJWwnDLRpM62,1620387187,–ö–∞—Ç–µ—Ä–∏–Ω–∞ –ë.,4829,4829,-24500,-24500,980,0,0,2485541,True,1894-M9H5-M570-A956
WagDeq1QrHaY8u6I,1620380753,Harms,5814,5814,-4560,-4560,980,0,136,2510041,False,KH16-P1TA-81PK-ABC2
KjQIA8ioxS3_Kbbs,1620320961,MAGAZYN DAY AND DAY,5499,5499,-42300,-42300,980,0,0,2514601,False,MP28-6X5M-2K8C-2BT3
Dj-unsYxrAuU53WW,1620315167,fondy.ua,5499,5499,-68700,-68700,980,0,0,2556901,False,BPTC-2B31-8545-HM52
yn6B4cikmfl3qFAd,1620313141,–ù–æ–≤–∞ –ø–æ—à—Ç–∞,7399,7399,-4500,-4500,980,0,0,2625601,False,51B3-CTA7-H74X-PT8K
9UyetMsgZMl7xwt_,1620309309,–°–∫–∞—Å—É–≤–∞–Ω–Ω—è. MC Fastline,4111,4111,100,100,980,0,0,2630101,False
9rygjzNyi_qeZHGX,1620309305,MC Fastline,4111,4111,-100,-100,980,0,0,2630001,False
BjubQnkY4dOsTy09,1620308664,–°–∫–∞—Å—É–≤–∞–Ω–Ω—è. MC Fastline,4111,4111,100,100,980,0,0,2630101,False
VVhdVbxRRpAhaWf9,1620308658,MC Fastline,4111,4111,-100,-100,980,0,0,2630001,False
w6VLSTG4sKoVjoCn,1620308269,"Lifecell
+380631692598",4814,4814,-20000,-20000,980,0,0,2630101,True,1C72-X52E-X0E3-E2A5
w8RW-BWxSGlHqjgJ,1620293743,TAKSIDE POS,4121,4121,-71341,-21295,949,0,7134,2650101,False,TA32-BB5B-1856-7ACC
nAY5ROw2n6Jdz_Mm,1620283585,Lesya,4829,4829,-600000,-600000,980,0,0,2721442,True,4968-1KK0-P8C6-CBT3
F8xu5C-OfofNyQ_8,1620240900,HABIP AKTAN,5812,5812,-74388,-22000,949,0,2231,3321442,False,300X-2K9T-91XA-H92A
cVL8H1i-6dBDRbpU,1620219595,DembalIk,5812,5812,-20295,-6000,949,0,608,3395830,False,EPXA-5PA7-3X6B-63KE
CiriKSEYUN31Ukqa,1620215778,BALIKCI KEMAL,5812,5812,-4066,-1200,949,0,121,3416125,False,C713-6KPM-T75K-36XX
BQukCKBO-P30FrEE,1620197993,ISTANBUL TOPKAPI SAR,7991,7991,-192776,-57000,949,0,0,3420191,False,M62A-7AXH-P7CC-7MET
1_njFE7XqE1s3bAQ,1620144771,CANTINE CAFE,5812,5812,-104938,-31000,949,0,3148,3612967,False,059T-387H-00XH-81HP
3qK1UTQU64hU87R8,1620131451,MILLI SARAYLAR,5499,5499,-81238,-24000,949,0,0,3717905,False,970C-PXMA-K9EX-A3M9
eKImgDMehaX9FiiX,1620131451,–°–∫–∞—Å—É–≤–∞–Ω–Ω—è. MILLI SARAYLAR,5499,5499,81238,24000,949,0,0,3799143,False
KpXei4isgCGzX20e,1620131393,MILLI SARAYLAR,5499,5499,-81238,-24000,949,0,0,3717905,False
4P5mEiltB0_hUaUN,1620114046,–ë–∞–Ω–∫–æ–º–∞—Ç SULTANAHMET MEYDANI,6011,6011,-88841,-26248,949,0,0,3799143,False,HMC5-BAPX-969A-MC26
3eIHxjT6WTHRC10u,1620060529,ACEMOGLU BAKLAVALARI,5441,5441,-19718,-5785,949,0,0,3887984,False,P164-30T5-E30K-4ETE
p8wn0etbDkGtpHTG,1620021776,–°–∫–∞—Å—É–≤–∞–Ω–Ω—è. MasterCard Business Lounge,4111,4111,100,100,980,0,0,3907702,False
IG3bU4UX0-6mUk0g,1620021768,MasterCard Business Lounge,4111,4111,-100,-100,980,0,0,3907602,False
m1DQkqUUvT5ogDGg,1620021560,–°–∫–∞—Å—É–≤–∞–Ω–Ω—è. MC Fastline,4111,4111,100,100,980,0,0,3907702,False
CSJnhru8PLSDdrJj,1620021554,MC Fastline,4111,4111,-100,-100,980,0,0,3907602,False
QaF1fi4KLhANYL5Q,1620021213,–°–∫–∞—Å—É–≤–∞–Ω–Ω—è. MC Fastline,4111,4111,100,100,980,0,0,3907702,False
g4XME_nJMpoAlGjG,1620021205,MC Fastline,4111,4111,-100,-100,980,0,0,3907602,False
heppWL_BkacDH9st,1619990941,LIQPAY*FunKeys,5045,5045,-89000,-89000,980,0,0,3907702,False,K9CE-M7K1-PH2P-PB01
ACNqHDKgu0wXA1K4,1619989049,"SP * NOVELKEYS, LLC",5045,5045,-168491,-6050,840,0,0,3996702,False,4P0H-55AM-T670-K9HH
9KUKgJ8qs_K4HzFv,1619941434,MAGAZYN DAY AND DAY,5499,5499,-30000,-30000,980,0,0,4165193,False,H7AK-M7C3-CP5E-16CB
EbWiyNV0iRBGluPW,1619877647,BWTC,5814,5814,-16450,-16450,980,0,493,4195193,False,H105-30TX-1112-2K1M
O7lZ-6Diar0FkJtl,1619859112,Lesya,4829,4829,-1500000,-1500000,980,0,0,4211643,True,H0XB-X9X3-08B0-P624
_iIaorAVj631xVFx,1619828505,–í—ñ–¥—Å–æ—Ç–∫–∏ –∑–∞ –∫–≤—ñ—Ç–µ–Ω—å,4829,4829,795,795,980,0,0,5711643,True
h99G5Uq2IVqVaAiu,1624987522,fondy.ua,7999,7999,-61000,-61000,980,0,0,2122062,False,KX99-B7PK-M9XM-5EBB
peE3IFZU9NXXNF8J,1624977566,MAGAZYN DAY AND DAY,5499,5499,-11300,-11300,980,0,0,2183062,False,9PCX-A136-PP5X-364E
eIHmjQSwthpVXZLb,1624968335,FDY*Bolt,7999,7999,-7500,-7500,980,0,0,2194362,False
jrEJ38DzxlNCja92,1624957778,–°–∫–∞—Å—É–≤–∞–Ω–Ω—è. Bolt,4121,4121,7200,7200,980,0,0,2201862,False
V5sex1sWcbNN86NS,1624957713,Bolt,4121,4121,-7800,-7800,980,0,0,2194662,False,88KE-K1HA-B6AC-8MC2
TP9559SeeWieriRo,1624955570,Bolt,4121,4121,-7200,-7200,980,0,0,2202462,False
xwCEVnFmdDcGSA0H,1624947068,–û–±—Å–ª—É–≥–æ–≤—É–≤–∞–Ω–Ω—è –ø–ª–∞—Ç–∏–Ω–æ–≤–æ—ó –∫–∞—Ä—Ç–∫–∏,4829,4829,-25000,-25000,980,0,0,2209662,True
WKY62RxqLBEggOW72H72gXsu6w,1624923229,–°–∫–∞—Å—É–≤–∞–Ω–Ω—è. FDY*Bolt,7999,7999,7500,7500,980,0,0,2234662,False
sN16Erm83g6oo4RVF-I2hQ,1624923229,"FDY*Bolt, Kyiv, UA",7999,7999,-3967,-3967,980,0,0,2227162,True
-XcfTUDOyCSfesJk,1624896695,Lesya,4829,4829,-250000,-250000,980,0,0,2231129,True,0K1H-E93C-5CHT-55EB
DosKX2A3Azum4sHS,1624882524,OK Wine,5411,5411,-9950,-9950,980,0,0,2481129,False,5EE1-ETEP-XMEH-2APB
smAqre9bNUgcy9HG,1624882222,MAGAZYN DAY AND DAY,5499,5499,-11200,-11200,980,0,0,2491079,False,K3HE-B242-7C98-BB84
BT4wmkaSTcpqJQ3S,1624818769,"–Ø—Ä–æ—Å–ª–∞–≤—ñ–≤ –í–∞–ª, 19",5499,5499,-18900,-18900,980,0,0,2502279,False,7T2A-2633-9KH4-719T
uGFc8rlohmXqW7ES,1624817021,–ë–æ–≥–¥–∞–Ω –ë.,4829,4829,-35200,-35200,980,0,0,2521179,True,K11K-B2EK-TM44-1XE9
DutPyhIWULTFUtVB,1624791513,MAGAZYN DAY AND DAY,5499,5499,-12150,-12150,980,0,0,2556379,False,HX5E-049K-2007-BEXT
dw4m-nXjd9RjefMi,1624714797,Bolt,4121,4121,-9100,-9100,980,0,0,2568529,False,08CM-046E-T4EH-T9EK
JcJuU4nBD5C4Z1Zh,1624709116,–°–∫–∞—Å—É–≤–∞–Ω–Ω—è. Bolt,4121,4121,16900,16900,980,0,0,2577629,False
kJbsJoCg70ZdNyPr,1624709064,Bolt,4121,4121,-17800,-17800,980,0,0,2560729,False,4HE5-83M5-690C-4M5E
kdQSeeTftozja-Tv,1624706061,Bolt,4121,4121,-16900,-16900,980,0,0,2578529,False
2Nq65VI2Ng5Hpug2,1624700086,Bolt,4121,4121,-8900,-8900,980,0,0,2595429,False,0756-7208-2M23-ME4A
9N6ZDFebzoD8cBdT,1624694906,–°–∫–∞—Å—É–≤–∞–Ω–Ω—è. Bolt,4121,4121,6100,6100,980,0,0,2604329,False
wGNBm34u8rGW4SDW,1624694846,Bolt,4121,4121,-6300,-6300,980,0,0,2598229,False,HC67-6KB5-MAX7-T8X5
KRB2bQVM-44V_qvJ,1624692797,Bolt,4121,4121,-6100,-6100,980,0,0,2604529,False
B14Y8KVxNCXrV4gu,1624646330,MAGAZYN DAY AND DAY,5499,5499,-18900,-18900,980,0,0,2610629,False,AMCA-079A-79B7-76XA
U96ihwUtC2d3LE7t,1624645097,Bolt,4121,4121,-11200,-11200,980,0,0,2629529,False,X5XP-3A06-HMK0-36C1
OX_e8NSjXKqiIa_i,1624636083,Bolt,4121,4121,-17600,-17600,980,0,0,2640729,False,A07H-A513-3A26-3871
jLpE23T1je9bLk_t,1624634266,Bolt,4121,4121,-15700,-15700,980,0,0,2658329,False,3PA9-49HA-2H4X-KA00
qouFBZa40JkDfZat,1624631456,–°–∫–∞—Å—É–≤–∞–Ω–Ω—è. Bolt,4121,4121,22800,22800,980,0,0,2674029,False
3MlPCDkOrTLgBHCq,1624631400,Bolt,4121,4121,-23500,-23500,980,0,0,2651229,False,H502-E874-B28K-23E1
WkmKCPcCJrQtXIeV,1624627680,Bolt,4121,4121,-22800,-22800,980,0,0,2674729,False
7UzVRl7DIwBKuxdB,1624621387,Lesya,4829,4829,-650000,-650000,980,0,0,2697529,True,X1EK-AHA6-4CC4-AA57
33sK2o7CYV_tKLoc,1624615456,–°–∫–∞—Å—É–≤–∞–Ω–Ω—è. Bolt,4121,4121,10900,10900,980,0,0,3347529,False
SDxZevGISHrahkH_,1624615320,Bolt,4121,4121,-11400,-11400,980,0,0,3336629,False,ME47-0P21-872B-8X4E
i7SN_BZr5kkEb57e,1624614066,Bolt,4121,4121,-10900,-10900,980,0,0,3348029,False
i5FdfTe1pLHGXDBe,1624609228,FDY*Bolt,7999,7999,-7500,-7500,980,0,0,3358929,False
FQK9BIC36jyckA_i,1624564263,–°–∫–∞—Å—É–≤–∞–Ω–Ω—è. Bolt,4121,4121,3800,3800,980,0,0,3366429,False
cdXRpekC6Jr4Q5bk,1624564216,Bolt,4121,4121,-3900,-3900,980,0,0,3362629,False,B9AK-4T9H-8EE9-TC84
lnJqTxD5WyLt4k4x,1624563454,MAGAZYN DAY AND DAY,5499,5499,-22100,-22100,980,0,0,3366529,False,KKE3-PCMX-KT99-9MX0
zc98knBLjkwkwgbe,1624562498,Bolt,4121,4121,-3800,-3800,980,0,0,3388629,False
st7UtpnuBKQvnQPO,1624558751,–°–∫–∞—Å—É–≤–∞–Ω–Ω—è. Passport Control,4111,4111,100,100,980,0,0,3392429,False
Qe1LAHXlCYPQl-SN,1624558745,Passport Control,4111,4111,-100,-100,980,0,0,3392329,False
K3wTfpl3Uk6SNOxE,1624535585,TO LAINI,5812,5812,-82783,-2520,978,0,0,3392429,False,9HA2-CAKM-4BEX-XHH5
5vB9tkjWicbJHuL9,1624529071,TAVLAS NIKOLAOS,5813,5813,-37778,-1150,978,0,0,3475212,False,P83K-7459-TAA9-MH8M
fQemFEr0SFNwkNA9,1624470940,CHAVAS ALEXANDROS,5411,5411,-62397,-2269,840,0,0,3512990,False,ABM4-787M-5XT5-E149
gZ7Y7SdItG3eA80L,1624440827,PERIPTERO LIMANIOU,5399,5399,-8168,-250,978,0,0,3575387,False,BP4E-MHK1-TAM2-30KC
zwx8p4UiVIPUxVIm,1624440669,SYSTEGASMENA FARMAKE,5912,5912,-15290,-468,978,0,0,3583555,False,98A4-2TTK-51K0-H390
jzvwkpapXhzB8wV3,1624432532,ASTERIA,5812,5812,-13068,-400,978,0,0,3598845,False,0PKM-7H6B-C48E-T57K
O--aIC0y1cOp6OPC,1624432154,PERIPTERO LIMANIOU,5399,5399,-18949,-580,978,0,0,3611913,False,T3X8-6544-HM7P-4MBM
N9c9fV5gKHrlC0Yp,1624400208,TAVLAS NIKOLAOS,5813,5813,-277696,-8500,978,0,0,3630862,False,407K-KP1C-C193-BKK7
6vwlwEOx97aJ6hd4,1624371215,Lesya,4829,4829,-2000000,-2000000,980,0,0,3908558,True,KE7C-9K0P-CC1K-P19C
yjiqEx4eg7uSEs_K,1624368387,–íi–¥: –ü–†–ò–•–û–î–¨–ö–û –ï.–í. –§–û–ü,4829,4829,5100000,5100000,980,0,0,5908558,True
wJJFANzc0eQvx0U3,1624309808,MINOS BEACH ART HOTEL,7011,7011,-97800,-3000,978,0,0,808558,False,7P0P-XKX1-HMK2-6060
AuZoGw3xYc-CNdvJ,1624304047,SFYRAKIS DIMITRIOS KAI,5813,5813,-97800,-3000,978,0,0,906358,False,EMK7-B6XK-B9XH-MX99
FsGGFdueTCpaLix5,1624299846,KAFENEIO TO PEFKO,5921,5921,-45640,-1400,978,0,0,1004158,False,KTXB-XH98-9C93-2006
3j3dvr82fYZ0RrpZ,1624295425,MAKRAKIS GEORGIOS,5812,5812,-356968,-10950,978,0,0,1049798,False,HA4M-5XTP-CE3T-3CCB
YFYSoBiW90Yfolyu,1624269654,GUSTO,5651,5651,-162851,-5000,978,0,0,1406766,False,8ATB-K69H-CBB8-T85A
FhT3i1OknRL-9UkI,1624268942,MIGOMIS,5812,5812,-25079,-770,978,0,0,1569617,False,A7T4-6KTK-2960-42PX
MC8c7L0zu-NnFlqx,1624223046,BP-GIANNAKAKIS,5541,5541,-97710,-3000,978,0,0,1594696,False,P97K-4CE7-5HHC-MEEB
aWtcasyzFhJ4toKo,1624211166,AYLH AXTE,7011,7011,-247533,-7600,978,0,0,1692406,False,C846-HPA1-B3BX-5A14
ngWpBMbNeUw_0Cx_,1624193608,TSIOTSIOS  GEORGIOS NI,7299,7299,-48855,-1500,978,0,0,1939939,False,8K6P-E3P3-C6M4-097K
SyOOvqoRk0OK0fIV,1624180255,MARINOPOULOS COFFEE CO,5813,5813,-55206,-1695,978,0,0,1988794,False,8098-349A-K2A8-0180
CAL-27asZrrffMpt,1624178964,SALIS,5813,5813,-79797,-2450,978,0,0,2044000,False,T45B-H7T0-M0A5-B72H
X18g8ZksvaaLORYP,1624135401,KRITAMON COFFEE WINE F,5813,5813,-190535,-5850,978,0,0,2123797,False,HT86-26EE-H0E3-9TA6
vk3rdQVjfTEdTMtt,1624115044,SELINOU AKINITA MONOM.,5814,5814,-29313,-900,978,0,0,2314332,False,58EB-3TK6-58MM-B57A
sBPSHpYqEuaE1hGcmjkRE9J8fg,1624059611,–°–∫–∞—Å—É–≤–∞–Ω–Ω—è. FDY*BOLT,7999,7999,7500,7500,980,0,0,2343645,False
1NcbTj0Gw77fQfsDQmhuOC7sOA,1624059611,–°–∫–∞—Å—É–≤–∞–Ω–Ω—è. FDY*BOLT,7999,7999,7500,7500,980,0,0,2336145,False
mxeGrB3nmmMjdA2v7caTviNZsA,1624059611,–°–∫–∞—Å—É–≤–∞–Ω–Ω—è. FDY*BOLT,7999,7999,7500,7500,980,0,0,2328645,False
1zq_x7JWzsjp24CLIzw_Kv3nMw,1624059611,–°–∫–∞—Å—É–≤–∞–Ω–Ω—è. FDY*BOLT,7999,7999,7500,7500,980,0,0,2321145,False
xWK8c9lBrkXDuRhbs_Kau0S5pQ,1624059611,–°–∫–∞—Å—É–≤–∞–Ω–Ω—è. FDY*BOLT,7999,7999,7500,7500,980,0,0,2313645,False
jveSUfI_K-ccFU5zDrSAbT1oTw,1624059611,–°–∫–∞—Å—É–≤–∞–Ω–Ω—è. FDY*BOLT,7999,7999,7500,7500,980,0,0,2306145,False
t2mppn_NQvC7xy3Ti-j21g,1624059611,"FDY*BOLT, Kyiv, UA",7999,7999,-2908,-2908,980,0,0,2298645,True
6XQOP9v8Ozps4goQGSXuFQ,1624059611,"FDY*BOLT, Kyiv, UA",7999,7999,-4062,-4062,980,0,0,2301553,True
rmKs-4woVUlk-MBxiqBFiQ,1624059611,"FDY*BOLT, Kyiv, UA",7999,7999,-1551,-1551,980,0,0,2305615,True
VVN2d1Q6zARPSdpQKvpS13s,1624059611,"FDY*BOLT, Kyiv, UA",7999,7999,-4262,-4262,980,0,0,2307166,True
jWBMGQafmPn9PRYvNWTwtPU,1624059611,"FDY*BOLT, Kyiv, UA",7999,7999,-1540,-1540,980,0,0,2311428,True
CVh_K3gaXNQFLY9fjHasy48,1624059611,"FDY*BOLT, Kyiv, UA",7999,7999,-1632,-1632,980,0,0,2312968,True
u905HGcG7YnvZj51,1624038193,DIMOSTHENIS METHYMAK,5411,5411,-13028,-400,978,0,0,2314600,False,TC7K-55EC-K885-XM7C
ZXJ89GIb0l4xBotn,1624002146,SGOUROS ARISTIDIS,5441,5441,-52160,-1600,978,0,0,2327628,False,TK6C-0KC3-K83B-1THC
mHOeB6RCBSa7Xjg_6jJjXAUT7w,1623973247,–°–∫–∞—Å—É–≤–∞–Ω–Ω—è. FDY*BOLT,7999,7999,7500,7500,980,0,0,2379788,False
Syc_UNtJfnUjhcbbfMRD1Q,1623973247,"FDY*BOLT, Kyiv, UA",7999,7999,-1976,-1976,980,0,0,2372288,True
Y3f2Cxxm-gbZ0Xpr,1623958855,PIATO,5812,5812,-344985,-10550,978,0,0,2374264,False,1958-094T-KM91-C055
BgfxTPk4TCxqF2SV,1623927488,–°–∫–∞—Å—É–≤–∞–Ω–Ω—è. Bolt,4121,4121,42300,42300,980,0,0,2719249,False
rOf8VtOyLBYPUiZT,1623927269,–°–∫–∞—Å—É–≤–∞–Ω–Ω—è. MasterCard Business Lounge,4111,4111,100,100,980,0,0,2676949,False
LKAmmjHvbjWVZDLO,1623927261,MasterCard Business Lounge,4111,4111,-100,-100,980,0,0,2676849,False
gfwVevv-JTrY-bs6,1623927128,Duty Free Shop,5309,5309,-29700,-29700,980,0,0,2676949,False,2T0M-C620-AH38-H1XX
USfV9tS_mnJLgD-E,1623926737,–°–∫–∞—Å—É–≤–∞–Ω–Ω—è. Passport Control,4111,4111,100,100,980,0,0,2706649,False
dUY-gCJOLYPrW19y,1623926730,Passport Control,4111,4111,-100,-100,980,0,0,2706549,False
uPbaoJ4dE-eyVaCM,1623926368,–°–∫–∞—Å—É–≤–∞–Ω–Ω—è. Passport Control,4111,4111,100,100,980,0,0,2706649,False
mIf7fOTb5no0ec93,1623926360,Passport Control,4111,4111,-100,-100,980,0,0,2706549,False
2cIExmv9h89jF8Pl,1623925700,Bolt,4121,4121,-45900,-45900,980,0,0,2706649,False,T8A9-H1CK-7K2X-K23E
V4OlFpUjgeJLJouK,1623921592,Bolt,4121,4121,-42300,-42300,980,0,0,2752549,False
RwPvPAYwos2VS3jr,1623855700,–°–∫–∞—Å—É–≤–∞–Ω–Ω—è. FDY*BOLT,7999,7999,7500,7500,980,0,0,2794849,False
nkMDcx8E7yQadUea,1623855684,FDY*BOLT,7999,7999,-7500,-7500,980,0,0,2787349,False
9s_n6hda-g5bLWcj,1623855162,FDY*BOLT,7999,7999,-7500,-7500,980,0,0,2794849,False
zx6qHCewJbNE_3Vr,1623847768,FDY*BOLT,7999,7999,-7500,-7500,980,0,0,2802349,False
-JoXIN3bTVlaSn9W,1623846909,FDY*BOLT,7999,7999,-7500,-7500,980,0,0,2809849,False
DyLcB95MVyq49VqS,1623845350,FDY*BOLT,7999,7999,-7500,-7500,980,0,0,2817349,False
bT-lzWvr7LL9-uV0,1623845265,–°–∫–∞—Å—É–≤–∞–Ω–Ω—è. FDY*BOLT,7999,7999,7500,7500,980,0,0,2824849,False
6UnfJBstxXzvkAX6,1623845162,FDY*BOLT,7999,7999,-7500,-7500,980,0,0,2817349,False
aHJxdFdFoNXcyJmW,1623842654,FDY*BOLT,7999,7999,-7500,-7500,980,0,0,2824849,False
xi_Y3jcyrlRiveg9,1623835942,FDY*BOLT,7999,7999,-7500,-7500,980,0,0,2832349,False
EWz5zvJ4l1vKNJAs,1623830177,–°–∫–∞—Å—É–≤–∞–Ω–Ω—è. Bolt,4121,4121,6000,6000,980,0,0,2839849,False
sQCjrpvR3SxMTrxI,1623830117,Bolt,4121,4121,-6600,-6600,980,0,0,2833849,False,27AA-CME6-B3C4-81M7
KiK1z18HgAxppCxP,1623828993,Bolt,4121,4121,-6000,-6000,980,0,0,2840449,False
VrAr-A3z1TvjdCmf,1623780133,MAGAZYN DAY AND DAY,5499,5499,-64700,-64700,980,0,0,2846449,False,8381-M435-75T4-60KP
2-b7gtAtevQ_kJIR,1623777303,–°–∫–∞—Å—É–≤–∞–Ω–Ω—è. FDY*BOLT,7999,7999,7500,7500,980,0,0,2911149,False
PN_9sBOyVKzl83cb,1623777266,FDY*BOLT,7999,7999,-7500,-7500,980,0,0,2903649,False
3snmzexjVe5Kppe_,1623753256,FDY*BOLT,7999,7999,-7500,-7500,980,0,0,2911149,False
f3c6bBV2F6vZTzlY,1623752220,–ù–æ–≤–∞ –ø–æ—à—Ç–∞,7399,7399,-5600,-5600,980,0,0,2918649,False,3MA1-A268-8PT8-CK80
0gLhImJJ0h_DTAyD,1623695903,MAGAZYN DAY AND DAY,5499,5499,-32650,-32650,980,0,0,2924249,False,MBB0-7B2T-XK7E-A07P
IzfjrY8zHlOFFfZC,1623669121,–Ø–Ω–∞ –ù.,–ö–≤–∞—Ä—Ç–∏—Ä–∞,4829,4829,-1600000,-1600000,980,0,0,2956899,True,2XK6-85KC-5P4X-355H
ZroH6Gqpz3sC7LS9,1623663537,Lesya,4829,4829,-4000000,-4000000,980,0,0,4556899,True,98A5-A853-8E49-6H68
wYIaiWHsb5Ov_TKa,1623662603,–íi–¥: –ü–†–ò–•–û–î–¨–ö–û –ï.–í. –§–û–ü,4829,4829,6500000,6500000,980,0,0,8556899,True
jXwgSOK7lVkEmDu4,1623655567,MagazinProdukti,5499,5499,-17600,-17600,980,0,0,2056899,False,T082-0110-X80A-214H
kwEMOkJ5zpivZvU3,1623523473,foundation.com.ua1,5411,5411,-39200,-39200,980,0,0,2074499,False,98E5-A7X9-X574-TX47
agi2gBFixyK5JSYg,1623499953,Beer Market,5921,5921,-34352,-34352,980,0,0,2113699,False,626B-54K0-H9A2-8BC2
LDJrdum10LP3OsqP,1623498426,Bolt,4121,4121,-9400,-9400,980,0,0,2148051,False,2E7X-7CPT-4C2P-ATBC
Jmw_PyfcsONsKzjV,1623487031,Bolt,4121,4121,-6800,-6800,980,0,0,2157451,False,9E4X-P3AH-B580-T89X
9qzv7GhNVCePIY-9OmbpWg,1623454793,"FDY*BOLT, Kyiv, UA",7999,7999,-3045,-3045,980,0,0,2164251,True
wvKoQPwoYE3CJq96Q_2UR3rt-w,1623454793,–°–∫–∞—Å—É–≤–∞–Ω–Ω—è. FDY*BOLT,7999,7999,7500,7500,980,0,0,2167296,False
5UhzS7UyAMbP5g-H,1623391272,Produkti,5499,5499,-18900,-18900,980,0,0,2159796,False,E59H-40K7-7748-7XM0
Z_isZWGDKefwjwFZGA6WMw,1623375734,"FDY*BOLT, Kyiv, UA",7999,7999,-3984,-3984,980,0,0,2178696,True
SeVHH_LzpznyUdup5Hi_eaSElQ,1623375734,–°–∫–∞—Å—É–≤–∞–Ω–Ω—è. FDY*BOLT,7999,7999,7500,7500,980,0,0,2182680,False
Sbthiqpz03FnaIHf,1623316973,TITKA KLARA,5814,5814,-11100,-11100,980,0,0,2175180,False,H55B-E33B-5CME-KH49
SOXzpsifYrH8hT7j,1623316813,–ê–ø—Ç–µ–∫–∞ –ê–ù–¶,5912,5912,-5500,-5500,980,0,0,2186280,False,75K2-TB5P-453T-XP8C
zmvXxu0ZIThMNuXv,1623244593,FDY*BOLT,7999,7999,-7500,-7500,980,0,0,2191780,False
xw3Mbk28lZ5svQdq,1623224547,Lesya,4829,4829,-370000,-370000,980,0,0,2199280,True,1X03-MPC6-PPKC-5A82
3dNUjLrVRTJEzTN5,1623220516,–ö–æ–ª–æ,5411,5499,-25350,-25350,980,0,0,2569280,False,2KBM-EE2H-3693-4P54
gWwbQJSUc9qVXcbK,1623173274,MAGAZYN DAY AND DAY,5499,5499,-8200,-8200,980,0,0,2594630,False,MACB-E0CT-CKK4-29X5
eac8Fas6ri4oS53m,1623151598,FDY*BOLT,7999,7999,-7500,-7500,980,0,0,2602830,False
rHwmZ7j8coaT3wUv,1623137915,–°–∫–∞—Å—É–≤–∞–Ω–Ω—è. Bolt,4121,4121,6700,6700,980,0,0,2610330,False
5J-ygru55X-yfJ__,1623137806,Bolt,4121,4121,-7700,-7700,980,0,0,2603630,False,7380-609H-AMM1-A3BP
J3NrJAbussFOqoqg,1623137220,MAGAZYN DAY AND DAY,5499,5499,-23040,-23040,980,0,0,2611330,False,5B4B-H989-97B8-A13M
TyuxYEPkClc1BuW8,1623136404,Bolt,4121,4121,-6700,-6700,980,0,0,2634370,False
TCl-rAwgJKBtDkFd,1623086164,Bolt,4121,4121,-6200,-6200,980,0,0,2641070,False,78H0-3C8X-P598-4AMM
4Es8LSt2VON7z8f9,1623066058,LIQPAY*FunKeys,5045,5045,-340000,-340000,980,0,0,2647270,False,36PX-X76A-PEKX-787H
SMSwpfuvDbr2l4YK,1623061814,Lesya,4829,4829,-4500000,-4500000,980,0,0,2987270,True,CX1X-95H7-2C72-875M
gcfk8EvwG1sOH4go,1623061082,–íi–¥: –ü–†–ò–•–û–î–¨–ö–û –ï.–í. –§–û–ü,4829,4829,6000000,6000000,980,0,0,7487270,True
STFaEpJItJDI0ruH,1623053762,–ó–æ–æ–ª—é–∫—Å,742,742,-25000,-25000,980,0,0,1487270,False,THE3-8876-1AC4-55AH
ZwYZBuFsW6tMhv7h,1623050073,MAGAZYN DAY AND DAY,5499,5499,-12000,-12000,980,0,0,1512270,False,EC6K-67XP-MEB4-8KPA
mu4AmAeorSJSdMOW,1623025543,–ó–æ–æ–ª—é–∫—Å,742,742,-127216,-127216,980,0,0,1524270,False,AT98-677A-AXX9-EE4T
5SuuccoG68ZGpQ0p,1622996328,Lesya,4829,4829,-31050,-31050,980,1050,0,1651486,True,7CKK-0PB8-1P9H-CCPC
hFPRZ4cIjqsY1DAghXD8Cg,1622935396,–ï–ª–µ–∫—Ç—Ä–æ—Å–∞–º–æ–∫–∞—Ç–∏ Bolt,7999,7999,-2006,-2006,980,0,0,1682536,True
CfXWPaMGpQpSbFgYdIPpNketBg,1622935396,–°–∫–∞—Å—É–≤–∞–Ω–Ω—è. –ï–ª–µ–∫—Ç—Ä–æ—Å–∞–º–æ–∫–∞—Ç–∏ Bolt,7999,7999,7500,7500,980,0,0,1684542,False
CjR_F1M27OHawdqC,1622898861,WFP.FASTFOOD,5811,5811,-206000,-206000,980,0,0,1677042,False,7PT7-B68A-86M8-M78A
6W2rZNna3auKIqzu,1622897684,–ö–æ–ª–æ,5411,5499,-24700,-24700,980,0,0,1883042,False,1B3P-7X6A-EPAC-M639
3wrUbB_feCphqzjL,1622897337,Beer Market,5921,5921,-18601,-18601,980,0,0,1907742,False,MEE3-584X-4TXH-K9K0
Q_9_9YsPj1QMgVeb,1622896470,fondy.ua,7999,7999,-132500,-132500,980,0,0,1926343,False,TX6E-1AH3-1A42-9P1X
2BO8MIQIBQiCNaA_,1622892701,Bolt,4121,4121,-10500,-10500,980,0,0,2058843,False,M558-XHTT-0HX6-326P
xgJoeGGLnlD2MskS,1622890708,–°–∫–∞—Å—É–≤–∞–Ω–Ω—è. Bolt,4121,4121,7800,7800,980,0,0,2069343,False
pFQ1-U-wi5k8ARbm,1622890657,Bolt,4121,4121,-7900,-7900,980,0,0,2061543,False,0BK2-B534-38PM-8A7C
3Sr-Hvps9BV-Qxen,1622886346,Bolt,4121,4121,-7800,-7800,980,0,0,2069443,False
2TvP3v-hwqIKWiWcW_jxpQ,1622850533,–ï–ª–µ–∫—Ç—Ä–æ—Å–∞–º–æ–∫–∞—Ç–∏ Bolt,7999,7999,-1220,-1220,980,0,0,2077243,True
fb5BJJ2jl-qGb0cRAbvR1QFGbw,1622850533,–°–∫–∞—Å—É–≤–∞–Ω–Ω—è. –ï–ª–µ–∫—Ç—Ä–æ—Å–∞–º–æ–∫–∞—Ç–∏ Bolt,7999,7999,7500,7500,980,0,0,2078463,False
ED7x9JnHnTEa5y7S,1622810569,Produkti,5499,5499,-12000,-12000,980,0,0,2070963,False,7H1T-22MM-MCHA-8EEK
wi7S_Beoy335F7sFEVYaJw,1622764202,–ï–ª–µ–∫—Ç—Ä–æ—Å–∞–º–æ–∫–∞—Ç–∏ Bolt,7999,7999,-3589,-3589,980,0,0,2082963,True
UIh4JOh-z8dFKk9Mao93qw,1622764202,–ï–ª–µ–∫—Ç—Ä–æ—Å–∞–º–æ–∫–∞—Ç–∏ Bolt,7999,7999,-1648,-1648,980,0,0,2086552,True
VLdm4S6G9hK7Go8QztSpS07czQ,1622764202,–°–∫–∞—Å—É–≤–∞–Ω–Ω—è. –ï–ª–µ–∫—Ç—Ä–æ—Å–∞–º–æ–∫–∞—Ç–∏ Bolt,7999,7999,7500,7500,980,0,0,2088200,False
VUJzlC_YnyD1KwdGuJECDvJiUw,1622764202,–°–∫–∞—Å—É–≤–∞–Ω–Ω—è. –ï–ª–µ–∫—Ç—Ä–æ—Å–∞–º–æ–∫–∞—Ç–∏ Bolt,7999,7999,7500,7500,980,0,0,2080700,False
gCeM4bC-Ey2yunlT,1622724682,Bolt,4121,4121,-4400,-4400,980,0,0,2073200,False,9HAC-KP1M-90PK-PTHT
whzb0PHVH_9yzqng,1622709309,–ï–ª–µ–∫—Ç—Ä–æ—Å–∞–º–æ–∫–∞—Ç–∏ Bolt,7999,7999,-7500,-7500,980,0,0,2077600,False
abUXnmBGjpOTLlYY,1622706200,"Lifecell
+380631692598",4814,4814,-8000,-8000,980,0,0,2085100,True,8T62-P3KT-E5A5-KBB9
FIb9z1ldeMTb-EkR0azkoQ,1622676362,–ï–ª–µ–∫—Ç—Ä–æ—Å–∞–º–æ–∫–∞—Ç–∏ Bolt,7999,7999,-1821,-1821,980,0,0,2093100,True
34iJ5drnnF68lpsVMs8RI0LuQQ,1622676362,–°–∫–∞—Å—É–≤–∞–Ω–Ω—è. –ï–ª–µ–∫—Ç—Ä–æ—Å–∞–º–æ–∫–∞—Ç–∏ Bolt,7999,7999,7500,7500,980,0,0,2094921,False
U60W-qbRGc59aCc3,1622647920,MAGAZYNShop 146,5499,5499,-12000,-12000,980,0,0,2087421,False,BA3B-0CM6-K93P-960T
eYSOx6VIyl-nNYH1,1622647150,–ó–æ–æ–ª—é–∫—Å,742,742,-690700,-690700,980,0,48600,2099421,False,AE9B-5TPP-6MMA-0409
VLJh2OS2BOmEdDFw,1622647065,–ó–æ–æ–ª—é–∫—Å,742,742,-7000,-7000,980,0,1400,2790121,False,8XCT-H60X-CH57-9MKM
qrh1NzeI6Rs1NNU0,1622633725,–ë–∞–Ω–∫–æ–º–∞—Ç Filetto,6011,6011,-50000,-50000,980,0,0,2797121,False,EBTB-EB83-13E7-291M
L4AZ6TWJ0NnAKfaU,1622619812,–ï–ª–µ–∫—Ç—Ä–æ—Å–∞–º–æ–∫–∞—Ç–∏ Bolt,7999,7999,-7500,-7500,980,0,0,2847121,False
2pZzQyMzZGXe0hjX,1622569114,MAGAZYN DAY AND DAY,5499,5499,-17400,-17400,980,0,0,2854621,False,5MBM-8TB9-K7BM-7ATB
P34PbMgNELxsV6DV,1622567530,KonditerskaDolcheteka,5814,5814,-28500,-28500,980,0,0,2872021,False,AP7A-H7BA-K65K-5E0X
bwKx16LJKsDY60Bz,1622565331,FOPBulatovaYaroslavaOl,5814,5814,-6900,-6900,980,0,0,2900521,False,353C-MM0A-8583-17MK
c2mOZcQkrDlxWQce,1622552209,Simona,5814,5814,-40000,-40000,980,0,0,2907421,False,P519-XCH9-81HT-B982
1C5UmcA6NO66NyCK,1622550879,Produkti,5499,5499,-6000,-6000,980,0,0,2947421,False,PX1E-BXK9-1P5T-TPB1
6cYfdhSS9DBOHA8X,1622547044,fondy.ua,7999,7999,-7500,-7500,980,0,0,2953421,False
ofaa4kE6F2hgtMxC,1622546232,–ï–ª–µ–∫—Ç—Ä–æ—Å–∞–º–æ–∫–∞—Ç–∏ Bolt,7999,7999,-7500,-7500,980,0,0,2960921,False
uHFOLcYgPRvijDSS,1622533998,–ï–ª–µ–∫—Ç—Ä–æ—Å–∞–º–æ–∫–∞—Ç–∏ Bolt,7999,7999,-7500,-7500,980,0,0,2968421,False
a8QS0zZZMg6T1vhZ,1622505717,–í—ñ–¥—Å–æ—Ç–∫–∏ –∑–∞ —Ç—Ä–∞–≤–µ–Ω—å,4829,4829,1615,1615,980,0,0,2975921,True
DIxt1QTv7ZChbR-S,1627678264,FOP MUKOVOZOV SIu,5814,5814,-13500,-13500,980,0,0,4318837,False,9T98-26XX-KBP2-T40B
MQQy_Ro81cTs3w1U,1627674655,MADHOUSE,5814,5814,-6500,-6500,980,0,0,4332337,False,H75E-0KXE-206H-X4C0
naCS7Vgz7y6g-f_T,1627672871,MADHOUSE,5814,5814,-7500,-7500,980,0,0,4338837,False,CC6B-9BX3-91K5-B250
bYlLv9Aj2y6hjv-b,1627667529,Niceguys1,5814,5814,-7400,-7400,980,0,0,4346337,False,H4XA-HT21-E0C8-P59B
hWoUoCgaxTaqaEwQ,1627667414,Niceguys,5814,5814,-27400,-27400,980,0,0,4353737,False,B80C-E9M6-93TM-A00M
LETF_9dt4rjtn6YQ,1627651179,"–¢–µ–∞—Ç—Ä –ø–∏–≤–∞ ""–ü—Ä–∞–≤–¥–∞""",5812,5812,-4800,-4800,980,0,0,4381137,False,M2CP-PT37-EA02-T21C
khbGKieU4lQTgZ7T,1627650817,Bolt,4121,4121,-8800,-8800,980,0,0,4385937,False,P78K-A0AB-9EA8-16AH
Dfs_2b9FcpZ3DxUi,1627650281,TSUKORRED1,5814,5814,-22000,-22000,980,0,0,4394737,False,3HE1-T2AH-P2T0-C299
fVchAv1zQQtymjdF,1627650130,–°–∫–∞—Å—É–≤–∞–Ω–Ω—è. EPKChIZBURGER,5814,5814,22000,22000,980,0,0,4416737,False
CRsdAPNlUohzFVTN,1627649994,EPKChIZBURGER,5814,5814,-22000,-22000,980,0,0,4394737,False
xDhbBsvu3kyuZjiW,1627649957,Epic Cheeseburger Cafe,5814,5814,-7800,-7800,980,0,0,4416737,False,4229-596P-4H7C-1217
Z7AycDG9oC96FSOR,1627643593,–ï–ª–µ–∫—Ç—Ä–æ—Å–∞–º–æ–∫–∞—Ç–∏ Bolt,7999,7999,-7500,-7500,980,0,0,4424537,False
eNaiygRSEr7rv6v9,1627642266,Bolt,4121,4121,-8300,-8300,980,0,0,4432037,False,T65P-EK33-248T-4E75
9XBTLnaxFBgeAMWz,1627638167,Bolt,4121,4121,-7700,-7700,980,0,0,4440337,False,47HK-1AT7-44BT-B3H4
YyPmc1sMhCYeOXB6,1627628142,Bolt,4121,4121,-7700,-7700,980,0,0,4448037,False,P319-8582-E03M-H6B8
Bw8VbsLnn6pkWjYY,1627616672,–°–∫–∞—Å—É–≤–∞–Ω–Ω—è. Bolt,4121,4121,5800,5800,980,0,0,4455737,False
PIwvtpW7CpLYTFpm,1627616612,Bolt,4121,4121,-5900,-5900,980,0,0,4449937,False,3P68-M9X8-H1BA-K61C
WtHCU-5n-0y0f_vb,1627615404,–û–ª–µ—Å—è –°.,4829,4829,-1000000,-1000000,980,0,0,4455837,True,8C93-KA3H-C89E-5896
a5lNWwPa1MbH6RXS,1627614806,Bolt,4121,4121,-5800,-5800,980,0,0,5455837,False
C0mwBwbvJ1Vjjp1i,1627580247,–û–ª–µ—Å—è –°.,4829,4829,-200000,-200000,980,0,0,5461637,True,0HKX-80KK-4KTT-M2KT
_FMuhRJym5Dl8ziq,1627579375,Lesya,4829,4829,-200000,-200000,980,0,0,5661637,True,AAPH-64P3-5PKB-9KM5
Gq1Gh7G5Cvoc4NSS,1627563800,–íi–¥: –ü–†–ò–•–û–î–¨–ö–û –ï.–í. –§–û–ü,4829,4829,4000000,4000000,980,0,0,5861637,True
Yot4eLhmGTqjdq45,1627558893,Bolt,4121,4121,-9800,-9800,980,0,0,1861637,False,5CPH-KM06-A092-0BXE
ua9KKoVr9DgO1ErY,1627558819,–ï–ª–µ–∫—Ç—Ä–æ—Å–∞–º–æ–∫–∞—Ç–∏ Bolt,7999,7999,-19768,-19768,980,0,0,1871437,False,3H53-7MET-K9H9-KAT7
h99G50uxKlOWaw2o,1627558817,–°–∫–∞—Å—É–≤–∞–Ω–Ω—è. –ï–ª–µ–∫—Ç—Ä–æ—Å–∞–º–æ–∫–∞—Ç–∏ Bolt,7999,7999,7500,7500,980,0,0,1891205,False
5r1p5w14Z6HRHys5,1627551640,–ï–ª–µ–∫—Ç—Ä–æ—Å–∞–º–æ–∫–∞—Ç–∏ Bolt,7999,7999,-7500,-7500,980,0,0,1883705,False
4a8Us4h5l3WC4Gcs,1627539088,–û–±—Å–ª—É–≥–æ–≤—É–≤–∞–Ω–Ω—è –ø–ª–∞—Ç–∏–Ω–æ–≤–æ—ó –∫–∞—Ä—Ç–∫–∏,4829,4829,-25000,-25000,980,0,0,1891205,True
TGKYLFvj4iURH_ve,1627473797,–§–∞—Ä–º–∞—Ü—ñ—è,5912,5912,-1110,-1110,980,0,0,1916205,False,024E-T1XK-9BKP-P8X5
MAOiV1JWZQJDK8XE,1627471840,OK Wine,5411,5411,-26710,-26710,980,0,0,1917315,False,96H6-9EEX-8890-EKA5
j6qC599gH8kswEuM,1627471404,TITKA KLARA,5814,5814,-21600,-21600,980,0,0,1944025,False,X07A-X87E-A23X-7C4X
K9EaxD9G6wPP72eq,1627402094,MAGAZYN DAY AND DAY,5499,5499,-21500,-21500,980,0,0,1965625,False,AXB9-0638-CTE5-4BAX
Zgm4ovJsgC-Lrtsl,1627383700,MAGAZYN DAY AND DAY,5499,5499,-21300,-21300,980,0,0,1987125,False,1EE6-5P3H-T590-53C7
Jmkrz3l8kSu7Xpox,1627377585,Lesya,4829,4829,-100000,-100000,980,0,0,2008425,True,58XK-8XTP-C6XE-33K7
KoSFV0Q0E533yB-s,1627375127,–°–∫–∞—Å—É–≤–∞–Ω–Ω—è. Bolt,4121,4121,5500,5500,980,0,0,2108425,False
uFrj8bqVid4o0PuB,1627375068,Bolt,4121,4121,-5600,-5600,980,0,0,2102925,False,XAMC-HX77-H2HA-ATAC
DRHyaQddobElQSE6,1627373497,Bolt,4121,4121,-5500,-5500,980,0,0,2108525,False
bdTwWriwplH15I3-,1627320113,MAGAZYN DAY AND DAY,5499,5499,-4000,-4000,980,0,0,2114025,False,X28X-PCBM-X9HC-9CX5
fJ0DQ5C0CDOdKYAc,1627311265,WFP*AQUAMARKET.,5411,5411,-51810,-51810,980,0,0,2118025,False,TP1C-M87B-8XK5-8T0P
BR3MBemk-_VBr3M6,1627305701,Bolt,4121,4121,-7700,-7700,980,0,0,2169835,False,2E9B-3X98-BX24-X81M
Xlu_KEXFYK1Ob7fQ,1627292483,Bolt,4121,4121,-8700,-8700,980,0,0,2177535,False,153A-75H5-AH8E-H235
XLCXLzWjjE1FifAY,1627290947,Bolt,4121,4121,-7300,-7300,980,0,0,2186235,False,204B-30B5-HEEE-8E2C
0_2cr691ScYwO2Xe,1627288604,–°—ñ–ª—å–ø–æ,5411,5411,-34947,-34947,980,0,0,2193535,False,KH40-M50P-XX85-PP4B
UNFLfLuoddcyx6TfGE8v159vYg,1627256462,–°–∫–∞—Å—É–≤–∞–Ω–Ω—è. –ï–ª–µ–∫—Ç—Ä–æ—Å–∞–º–æ–∫–∞—Ç–∏ Bolt,7999,7999,7500,7500,980,0,0,2228482,False
DXRY5yniri5O14Nu15NiT-SZWQ,1627256462,–°–∫–∞—Å—É–≤–∞–Ω–Ω—è. –ï–ª–µ–∫—Ç—Ä–æ—Å–∞–º–æ–∫–∞—Ç–∏ Bolt,7999,7999,7500,7500,980,0,0,2220982,False
riTm8DlBfRdqiHLP15l91w,1627256462,–ï–ª–µ–∫—Ç—Ä–æ—Å–∞–º–æ–∫–∞—Ç–∏ Bolt,7999,7999,-2189,-2189,980,0,0,2213482,True
IOxVy_aXzAQQQIwcD3SnIA,1627256462,–ï–ª–µ–∫—Ç—Ä–æ—Å–∞–º–æ–∫–∞—Ç–∏ Bolt,7999,7999,-3910,-3910,980,0,0,2215671,True
xk31bY9j_wUMPqVk,1627235896,Lesya,4829,4829,-100000,-100000,980,0,0,2219581,True,A7KH-98CP-78A1-X61A
KVCB5bAq2Kun9F9M,1627229035,NEGRONI APERITIVOBAR,5813,5813,-20500,-20500,980,0,0,2319581,False,7PTT-AEMH-661C-C21K
Bx5BLyeen1lzsR97,1627226442,FDY*Food,5499,5499,-68700,-68700,980,0,0,2340081,False,XBTK-B0BC-6C4E-297E
QpvQkFslOchnrKEJ,1627192473,Lesya,4829,4829,-100000,-100000,980,0,0,2408781,True,0XC0-02CH-4B5M-41M7
9pw_eApkKg5eMstt,1627148821,MAGAZYN DAY AND DAY,5499,5499,-12600,-12600,980,0,0,2508781,False,2K25-T0H1-7TK0-6M4M
CWOyIsMS8cnX6MmP,1627135293,–°–∫–∞—Å—É–≤–∞–Ω–Ω—è. Bolt,4121,4121,19000,19000,980,0,0,2521381,False
fGO_DhaJzTpAEKaJ,1627135245,Bolt,4121,4121,-20000,-20000,980,0,0,2502381,False,H73B-P54X-6CPX-6H54
Dmh99oyUvP4BwA33,1627133694,Bolt,4121,4121,-19000,-19000,980,0,0,2522381,False
Y9jWWZDWpzC2AREZ,1627125990,–°–∫–∞—Å—É–≤–∞–Ω–Ω—è. Bolt,4121,4121,18200,18200,980,0,0,2541381,False
wxTlq-su8q25dM4-,1627125939,Bolt,4121,4121,-19100,-19100,980,0,0,2523181,False,3504-MP0C-P154-9HM7
818sejXP2gwdbJcz,1627123318,Bolt,4121,4121,-18200,-18200,980,0,0,2542281,False
4EaRR6zBE9Gn1UgpFj1L8V6Cfw,1627082972,–°–∫–∞—Å—É–≤–∞–Ω–Ω—è. –ï–ª–µ–∫—Ç—Ä–æ—Å–∞–º–æ–∫–∞—Ç–∏ Bolt,7999,7999,7500,7500,980,0,0,2560481,False
CYILWesk5GTvNhd-cy8VHU-0kg,1627082972,–°–∫–∞—Å—É–≤–∞–Ω–Ω—è. –ï–ª–µ–∫—Ç—Ä–æ—Å–∞–º–æ–∫–∞—Ç–∏ Bolt,7999,7999,7500,7500,980,0,0,2552981,False
u_-ZM09GUtTes_US7R573w,1627082972,–ï–ª–µ–∫—Ç—Ä–æ—Å–∞–º–æ–∫–∞—Ç–∏ Bolt,7999,7999,-2291,-2291,980,0,0,2545481,True
hU0Oxzj4V90lJuITdN6pfg,1627082972,–ï–ª–µ–∫—Ç—Ä–æ—Å–∞–º–æ–∫–∞—Ç–∏ Bolt,7999,7999,-3247,-3247,980,0,0,2547772,True
Q_Ur9QFZKAxiu_cN,1627039588,MAGAZYN DAY AND DAY,5499,5499,-25150,-25150,980,0,0,2551019,False,TTMH-2PK2-X2PT-KHT3
OCz622V1_f8Ev50M,1627036847,–ï–ª–µ–∫—Ç—Ä–æ—Å–∞–º–æ–∫–∞—Ç–∏ Bolt,7999,7999,-7500,-7500,980,0,0,2576169,False
OaddX80GSO_fzFLE,1627035390,–ü—Ä–∏–≤–∞—Ç24: Boiarchuk Oleksandr,6536,6536,6500,6500,980,0,0,2583669,False
DwPqppAKGMZWdlNT,1627034926,–í—ñ–¥: –Ñ–≤–≥–µ–Ω –ê.,4829,4829,20000,20000,980,0,0,2577169,True
zpyqpPReNzcesLot,1627028949,–ï–ª–µ–∫—Ç—Ä–æ—Å–∞–º–æ–∫–∞—Ç–∏ Bolt,7999,7999,-7500,-7500,980,0,0,2557169,False
3NoT9DQfqGYrxE7Z,1626992450,–í—ñ–¥: –ù–∞—Ç–∞–ª—ñ—è –ê.,4829,4829,8500,8500,980,0,0,2564669,True
NJmQBarDzn6ve1Ai,1626992260,–î–º–∏—Ç—Ä–æ –ö.,–î–∞–±–ª—á–∏–∑,4829,4829,-6000,-6000,980,0,0,2556169,True,69HB-2A1E-00B3-25X7
pFJvCgIVSSvPDK3l,1626976572,–í—ñ–¥: –¢–µ—Ç—è–Ω–∞ –î.,–ë—ñ–≥–º–∞–∫),4829,4829,13500,13500,980,0,0,2562169,True
vRB0mPicaH83HOcb,1626976527,–í—ñ–¥: –î–º–∏—Ç—Ä–æ –ö.,4829,4829,15000,15000,980,0,0,2548669,True
zXUe9DHH-ZTtg1g7,1626975659,Rocket,4215,4215,-2500,-2500,980,0,0,2533669,False,4251-P692-9XTC-XC32
LSH2vr_Vqa-42IFN,1626973437,Rocket,4215,4215,-94700,-94700,980,0,0,2536169,False,2683-3KPT-159A-5KTT
NIyD5qG-aDepFVLL,1626955479,–í—ñ–¥: –î–º–∏—Ç—Ä–æ –ö.,4829,4829,13000,13000,980,0,0,2630869,True
YtAPmVxilmMClBHl,1626952058,–°—Ç–µ–π–∫—Ö–∞—É—Å,5814,5814,-28000,-28000,980,0,0,2617869,False,445H-05C1-3CX7-E746
oX95BypWTnh0P8XC,1626945897,Bolt,4121,4121,-11200,-11200,980,0,0,2645869,False,5A70-XK06-AHKA-0B97
PvRe1OZQzUPJquol,1626941534,Bluecup,5814,5814,-24500,-24500,980,0,0,2657069,False,MB86-EP6C-CTX7-9C89
AQAcTku0PonogTdB,1626939933,Bolt,4121,4121,-10000,-10000,980,0,0,2681569,False,BB01-TB5C-3CC4-4AB7
AqDwM1tiOlSq8c86,1626934074,–°–∫–∞—Å—É–≤–∞–Ω–Ω—è. Bolt,4121,4121,10200,10200,980,0,0,2691569,False
omDWsSZx7Ar8xTV2,1626934031,Bolt,4121,4121,-10800,-10800,980,0,0,2681369,False,ME29-BP8A-1994-A2X6
mXH4jcCL0kht1AIP,1626931825,Bolt,4121,4121,-10200,-10200,980,0,0,2692169,False
TGGyKZmWDbQ1L49l,1626869814,–ï–ª–µ–∫—Ç—Ä–æ—Å–∞–º–æ–∫–∞—Ç–∏ Bolt,7999,7999,-7500,-7500,980,0,0,2702369,False
S8D2BpnAKijUrW3C,1626862230,Lesya,4829,4829,-500000,-500000,980,0,0,2709869,True,98TT-0BC7-8E8K-8A93
AhrAopulUwGeId1w,1626861200,–ï–ª–µ–∫—Ç—Ä–æ—Å–∞–º–æ–∫–∞—Ç–∏ Bolt,7999,7999,-7500,-7500,980,0,0,3209869,False
I1q6MXcRXjNzDYmB,1626861176,–°–∫–∞—Å—É–≤–∞–Ω–Ω—è. –ï–ª–µ–∫—Ç—Ä–æ—Å–∞–º–æ–∫–∞—Ç–∏ Bolt,7999,7999,7500,7500,980,0,0,3217369,False
IVH93K3g0iBRyfb2,1626860989,–ï–ª–µ–∫—Ç—Ä–æ—Å–∞–º–æ–∫–∞—Ç–∏ Bolt,7999,7999,-7500,-7500,980,0,0,3209869,False
3Hf_myzUK6qtoPHU,1626853080,Bolt,4121,4121,-9300,-9300,980,0,0,3217369,False,KB5T-B39B-4332-4A60
li6Z7W7bcoVziS97,1626852869,Bolt,4121,4121,-5900,-5900,980,0,0,3226669,False,0PHK-B29E-6597-1EEK
e2X_Ej2ydTPA77dW,1626851448,–°–∫–∞—Å—É–≤–∞–Ω–Ω—è. Bolt,4121,4121,12100,12100,980,0,0,3232569,False
DX3TMTGlkGugI8ll,1626851393,Bolt,4121,4121,-12500,-12500,980,0,0,3220469,False,9HP6-6A0K-43X2-3E9X
CcJCnpqtRPnS1HVi,1626848949,Bolt,4121,4121,-12100,-12100,980,0,0,3232969,False
2VXUNxMRrT6piSEVSKQQ1Lsv-A,1626825328,–°–∫–∞—Å—É–≤–∞–Ω–Ω—è. –ï–ª–µ–∫—Ç—Ä–æ—Å–∞–º–æ–∫–∞—Ç–∏ Bolt,7999,7999,7500,7500,980,0,0,3245069,False
74Ejdw9mKfzwDyS0A4orOw,1626825328,–ï–ª–µ–∫—Ç—Ä–æ—Å–∞–º–æ–∫–∞—Ç–∏ Bolt,7999,7999,-1870,-1870,980,0,0,3237569,True
VmjI4VwGvGqHLKPs,1626779711,Lesya,4829,4829,-200000,-200000,980,0,0,3239439,True,C68M-PM0H-CTT9-BM6P
ozyiNDCpvHPs5f4E,1626766681,MAGAZYN DAY AND DAY,5499,5499,-18250,-18250,980,0,0,3439439,False,E7AB-P9AK-5THB-CX6A
5KHMXTalxq4Xyx2j,1626718422,–ö–∞—Ç–µ—Ä–∏–Ω–∞ –†.,4829,4829,-65000,-65000,980,0,0,3457689,True,3HA4-5BMC-H042-M1EC
S0RvwY7ArlY-yruYet04nf5h2Q,1626652646,–°–∫–∞—Å—É–≤–∞–Ω–Ω—è. –ï–ª–µ–∫—Ç—Ä–æ—Å–∞–º–æ–∫–∞—Ç–∏ Bolt,7999,7999,7500,7500,980,0,0,3522689,False
8Ap7eK-_UYzxkVguT_DAKGryPw,1626652646,–°–∫–∞—Å—É–≤–∞–Ω–Ω—è. –ï–ª–µ–∫—Ç—Ä–æ—Å–∞–º–æ–∫–∞—Ç–∏ Bolt,7999,7999,7500,7500,980,0,0,3515189,False
OC1vGGHQEia31X49-qZvWXelzw,1626652646,–°–∫–∞—Å—É–≤–∞–Ω–Ω—è. –ï–ª–µ–∫—Ç—Ä–æ—Å–∞–º–æ–∫–∞—Ç–∏ Bolt,7999,7999,7500,7500,980,0,0,3507689,False
8xx3ZvagN8p73_roAOC-nA,1626652646,–ï–ª–µ–∫—Ç—Ä–æ—Å–∞–º–æ–∫–∞—Ç–∏ Bolt,7999,7999,-2483,-2483,980,0,0,3500189,True
rvD4ZyWQ7exv-qvSQgD_IBE,1626652646,–ï–ª–µ–∫—Ç—Ä–æ—Å–∞–º–æ–∫–∞—Ç–∏ Bolt,7999,7999,-3985,-3985,980,0,0,3502672,True
ijK7K9MefxJGAgukmLt1ufQ,1626652646,–ï–ª–µ–∫—Ç—Ä–æ—Å–∞–º–æ–∫–∞—Ç–∏ Bolt,7999,7999,-3832,-3832,980,0,0,3506657,True
cUq0OcGv61Peh-2m,1626621786,Bolt,4121,4121,-15400,-15400,980,0,0,3510489,False,XC6P-AMH4-M8P4-CPT3
3G9NKCfGRcE4JZ_j,1626603776,Lesya,4829,4829,-500000,-500000,980,0,0,3525889,True,A2PB-X797-070A-1XBX
Zxenfabo0TBoBLHy,1626597399,Lesya,4829,4829,-500000,-500000,980,0,0,4025889,True,35TB-M17X-995B-C6X8
NYWB12qpw84JVeXk,1626545326,LIQPAY*Namelaka,5812,5812,-55000,-55000,980,0,0,4525889,False,P250-3P8P-0887-4MT5
_Phkx-kzjJmY-fBF,1626526995,–ï–ª–µ–∫—Ç—Ä–æ—Å–∞–º–æ–∫–∞—Ç–∏ Bolt,7999,7999,-7500,-7500,980,0,0,4580889,False
UH7JiGdd1x7EN6Fl,1626525874,–°–∫–∞—Å—É–≤–∞–Ω–Ω—è. –ï–ª–µ–∫—Ç—Ä–æ—Å–∞–º–æ–∫–∞—Ç–∏ Bolt,7999,7999,7500,7500,980,0,0,4588389,False
T3EQRWP1QnfoD_6z,1626525756,–ï–ª–µ–∫—Ç—Ä–æ—Å–∞–º–æ–∫–∞—Ç–∏ Bolt,7999,7999,-7500,-7500,980,0,0,4580889,False
1LspvNsc99rvMzBk,1626513377,–°–∫–∞—Å—É–≤–∞–Ω–Ω—è. Bolt,4121,4121,28800,28800,980,0,0,4588389,False
FJj14zRCkxZTQYm3,1626513325,Bolt,4121,4121,-29500,-29500,980,0,0,4559589,False,00MT-976B-21P3-B5XX
3LRkpgBeE6NsSFdB,1626509514,Bolt,4121,4121,-28800,-28800,980,0,0,4589089,False
lq7wQu6InZ9XFdRA,1626499817,–°–∫–∞—Å—É–≤–∞–Ω–Ω—è. Bolt,4121,4121,21000,21000,980,0,0,4617889,False
sCxqB13C6xB7W_37,1626499765,Bolt,4121,4121,-21300,-21300,980,0,0,4596889,False,3BP0-EH73-4893-338H
c6f1Tul0BOkyrfOK,1626496528,Bolt,4121,4121,-21000,-21000,980,0,0,4618189,False
C_nxNvkgeEuytdDG,1626457576,–°—ñ–ª—å–ø–æ,5411,5411,-18900,-18900,980,0,0,4639189,False,EEC8-4272-PHX5-MP77
LNq2Zeae6b9O8XIh,1626442988,–ï–ª–µ–∫—Ç—Ä–æ—Å–∞–º–æ–∫–∞—Ç–∏ Bolt,7999,7999,-7500,-7500,980,0,0,4658089,False
GCHk2YNED0ej3Vgm,1626433402,–ï–ª–µ–∫—Ç—Ä–æ—Å–∞–º–æ–∫–∞—Ç–∏ Bolt,7999,7999,-7500,-7500,980,0,0,4665589,False
uod-pHzDApBqzadF,1626431198,–íi–¥: –ü–†–ò–•–û–î–¨–ö–û –ï.–í. –§–û–ü,4829,4829,2600000,2600000,980,0,0,4673089,True
8gAarSUiO_kdfAtp,1626429160,–ï–ª–µ–∫—Ç—Ä–æ—Å–∞–º–æ–∫–∞—Ç–∏ Bolt,7999,7999,-7500,-7500,980,0,0,2073089,False
Lw4_6nd4_I7QX-Yy,1626422339,Lesya,4829,4829,-500000,-500000,980,0,0,2080589,True,1BX3-54CX-729B-K7BM
vETELCncretM4zAg,1626284846,Prostor,5977,5977,-14624,-14624,980,0,0,2580589,False,7XB5-T1XM-MBBM-8TAK
UDANvhR9BSPhT67Z,1626193486,Bolt,4121,4121,-4400,-4400,980,0,0,2595213,False,0TH6-0B94-A6C3-60T8
0zhvee52qAg1BwnI,1626191039,Bolt,4121,4121,-10900,-10900,980,0,0,2599613,False,P9M2-K4MB-EP91-T52E
QTP9s1Uo0O4UBIFX,1626189249,Bolt,4121,4121,-33300,-33300,980,0,0,2610513,False,CKHX-CBPM-8815-T4XH
CZ0SzvuBZFMce7My,1626188891,–°–∫–∞—Å—É–≤–∞–Ω–Ω—è. Passport Control,4111,4111,100,100,980,0,0,2643813,False
3a9Jss7rQDG1f1xe,1626188884,Passport Control,4111,4111,-100,-100,980,0,0,2643713,False
c1ojxKBlLtu5J0jP,1626164587,Flower Time,5992,5992,-100000,-100000,980,0,0,2643813,False,AC58-446K-C1ME-CHA0
iact8REbJlC7fp6H,1626163561,–ê–ø—Ç–µ–∫–∞ –ê–ù–¶,5912,5912,-38400,-38400,980,0,0,2743813,False,72E6-ME5H-0X92-EX7B
Jjrm4U7KcLbAntCW,1626112411,MAGAZYN DAY AND DAY,5499,5499,-40410,-40410,980,0,0,2782213,False,PX1P-X85A-K920-4118
cp7hNgWOf3hlkdj8,1626111314,Novapay,8999,8999,-5800,-5800,980,0,0,2822623,False,8CM9-M26E-5XBT-TE63
cy7RHTpJtN6WISxb,1626111312,Novapay,6538,6538,-10000,-10000,980,0,0,2828423,False,B2EP-C3K6-0K57-PAC7
pzXwjwUOuw5J7mkQ,1626110959,Novapay,8999,8999,-4600,-4600,980,0,0,2838423,False,905C-XHT3-T6KP-3X39
wIxbEyj6X7TU6yrw,1626101641,Lesya,4829,4829,-500000,-500000,980,0,0,2843023,True,3AKP-A47X-M1X3-2999
zn_cpOabKm1N7YTV,1626016175,MAGAZYN DAY AND DAY,5499,5499,-23450,-23450,980,0,0,3343023,False,XT3K-C336-161K-987H
dZHDblLkr-MOaEBS,1625917806,OK Wine,5411,5411,-54040,-54040,980,0,0,3366473,False,HHHH-X8HP-4MB5-AKT5
8x_CQnntfOdMNt-p,1625917553,–ö–æ–ª–æ,5411,5499,-18900,-18900,980,0,0,3420513,False,M46K-5MCE-B62K-XE45
CwOlqZxHWbTV5qoD,1625907368,ZOOLYUKS,5995,5995,-114520,-114520,980,0,0,3439413,False,PCMT-8HKT-M7PP-HB44
mMwEO4DkFkQ__1ss,1625868038,–°–∫–∞—Å—É–≤–∞–Ω–Ω—è. Bolt,4121,4121,11400,11400,980,0,0,3553933,False
6m1zIw7WYHFSR_xR,1625867943,Bolt,4121,4121,-14300,-14300,980,0,0,3542533,False,T99X-P78C-6MB9-H3T6
cqmKb3fuqyLQ_C0X,1625866765,Bolt,4121,4121,-11400,-11400,980,0,0,3556833,False
y2Yd5-fF1SNvYzna,1625853958,Lesya,4829,4829,-1000000,-1000000,980,0,0,3568233,True,072K-AK98-1AM3-PC83
FSCGPkdns2H-ZeYO,1625853604,LIQPAY*ChP Bezruk P.M,5411,5411,-47200,-47200,980,0,0,4568233,False,X8TE-EM9X-H6XA-MK09
TUWpWERna52DiqbP,1625853467,foundation.com.ua1,5411,5411,-44900,-44900,980,0,0,4615433,False,827A-8BXT-M767-32XM
6-0ArGucbaF50k8r,1625831288,–íi–¥: –ü–†–ò–•–û–î–¨–ö–û –ï.–í. –§–û–ü,4829,4829,2600000,2600000,980,0,0,4660333,True
Iem3X3PwBgmo3shg,1625816296,MAGAZYN DAY AND DAY,5499,5499,-39350,-39350,980,0,0,2060333,False,69MM-7KE5-4TB2-X22P
DgNDcvsIpcJFrjq2kWhOk8m9xQ,1625789110,–°–∫–∞—Å—É–≤–∞–Ω–Ω—è. –ï–ª–µ–∫—Ç—Ä–æ—Å–∞–º–æ–∫–∞—Ç–∏ Bolt,7999,7999,7500,7500,980,0,0,2099683,False
nWBERLerMLN7-kx8pS_nV-h7eQ,1625789110,–°–∫–∞—Å—É–≤–∞–Ω–Ω—è. –ï–ª–µ–∫—Ç—Ä–æ—Å–∞–º–æ–∫–∞—Ç–∏ Bolt,7999,7999,7500,7500,980,0,0,2092183,False
yCC2q081reazFsDbWqpG,1625789110,–ï–ª–µ–∫—Ç—Ä–æ—Å–∞–º–æ–∫–∞—Ç–∏ Bolt,7999,7999,-2025,-2025,980,0,0,2084683,True
QYK2GgN_4ebb_2hjAMs,1625789110,–ï–ª–µ–∫—Ç—Ä–æ—Å–∞–º–æ–∫–∞—Ç–∏ Bolt,7999,7999,-3247,-3247,980,0,0,2086708,True
VK4qSBZgq_Yyckzw,1625757406,Lesya,4829,4829,-300000,-300000,980,0,0,2089955,True,321A-32H4-7C1B-097P
4BflF7xTGoMkZO0F,1625756120,–ö–æ–ª–æ,5411,5499,-25200,-25200,980,0,0,2389955,False,8P1A-38H2-T5K5-KC7C
pMJ1kyKtsKchViUb,1625752641,–°–∫–∞—Å—É–≤–∞–Ω–Ω—è. MasterCard Business Lounge,4111,4111,100,100,980,0,0,2415155,False
mzL8EwoRsMetlz3l,1625752633,MasterCard Business Lounge,4111,4111,-100,-100,980,0,0,2415055,False
LU6wKLkZ-9yaW84t,1625752413,–°–∫–∞—Å—É–≤–∞–Ω–Ω—è. Passport Control,4111,4111,100,100,980,0,0,2415155,False
R452mVnsRVLOA49S,1625752404,Passport Control,4111,4111,-100,-100,980,0,0,2415055,False
SVqMDQ-paXvTleX1,1625751536,–°–∫–∞—Å—É–≤–∞–Ω–Ω—è. Passport Control,4111,4111,100,100,980,0,0,2415155,False
KxJeL5g4dkcGqNL4,1625751521,Passport Control,4111,4111,-100,-100,980,0,0,2415055,False
OvXTAiKgN1ybFYbm,1625751432,–°–∫–∞—Å—É–≤–∞–Ω–Ω—è. Bolt,4121,4121,31100,31100,980,0,0,2415155,False
hitBnt28drPgNVEC,1625751374,Bolt,4121,4121,-33800,-33800,980,0,0,2384055,False,BC9P-1HB4-PT2A-6HTB
IqkaOrfBLfKM738i,1625748314,–ö–∏—ó–≤—Å—å–∫–µ –º–µ—Ç—Ä–æ,4111,4111,-800,-800,980,0,0,2417855,False,3A01-217C-48T7-0870
tVOIR-KFlAgj830b,1625748106,Roshen,5441,5441,-9976,-9976,980,0,0,2418655,False,A7PH-KCKT-X2A5-4XK7
TO40ZmUqjulLkFqa,1625747052,Bolt,4121,4121,-31100,-31100,980,0,0,2428631,False
phu3Cl_3D7hmum47,1625739592,Bolt,4121,4121,-16900,-16900,980,0,0,2459731,False,KXC3-H0MA-4AAB-81PM
W22VobIOhc8FQQRw,1625727744,"Lifecell
+380631692598",4814,4814,-14000,-14000,980,0,0,2476631,True,5B51-5PX2-4EK2-MH50
XYXhXuQhqDfxQiQCSNqMO6c-zg,1625702361,–°–∫–∞—Å—É–≤–∞–Ω–Ω—è. –ï–ª–µ–∫—Ç—Ä–æ—Å–∞–º–æ–∫–∞—Ç–∏ Bolt,7999,7999,7500,7500,980,0,0,2490631,False
Lje8Fd32LRhfz5bt60a9,1625702361,–ï–ª–µ–∫—Ç—Ä–æ—Å–∞–º–æ–∫–∞—Ç–∏ Bolt,7999,7999,-6057,-6057,980,0,0,2483131,True
uGUefiBOQDU08DNr,1625664074,Bluecup,5814,5814,-19500,-19500,980,0,0,2489188,False,T473-M2AC-5XP7-B11M
wIYin4hlTliPIqti,1625658040,Lesya,4829,4829,-500000,-500000,980,0,0,2508688,True,K0X9-41C4-KACT-428X
ZAPPaLoVW8snhugW,1625596496,–ï–ª–µ–∫—Ç—Ä–æ—Å–∞–º–æ–∫–∞—Ç–∏ Bolt,7999,7999,-7500,-7500,980,0,0,3008688,False
7a7-uyS52m0KsFco,1625577517,–ï–ª–µ–∫—Ç—Ä–æ—Å–∞–º–æ–∫–∞—Ç–∏ Bolt,7999,7999,-7500,-7500,980,0,0,3016188,False
9c5498v3Gq7bcpHz,1625511978,MAGAZYN DAY AND DAY,5499,5499,-14400,-14400,980,0,0,3023688,False,CX0H-2300-CM0K-3PA4
0l9UgEWdt3GEPoA5,1625497298,–ï–ª–µ–∫—Ç—Ä–æ—Å–∞–º–æ–∫–∞—Ç–∏ Bolt,7999,7999,-7500,-7500,980,0,0,3038088,False
fhd4DLKdKObBYcJV,1625495328,Rozetka,5722,5921,-66900,-66900,980,0,0,3045588,False,0A1T-E701-109A-M526
j59SwcPduLMBxU45,1625480684,Lesya,4829,4829,-1000000,-1000000,980,0,0,3112488,True,8149-E8C9-3143-H42T
mU2uD--0_duLvOQN,1625479630,–íi–¥: –ü–†–ò–•–û–î–¨–ö–û –ï.–í. –§–û–ü,4829,4829,2500000,2500000,980,0,0,4112488,True
kazPJb2UgV2uPKUM,1625479305,Bolt,4121,4121,-6800,-6800,980,0,0,1612488,False,458P-68T9-AP4B-KM35
Yv4-WavOV9ZdC6u3,1625471229,MAGAZYN DAY AND DAY,5499,5499,-2900,-2900,980,0,0,1619288,False,EP90-71BP-7APP-4KEP
fTFE07kNubYF6hZwD1D9j5NySA,1625440668,–°–∫–∞—Å—É–≤–∞–Ω–Ω—è. –ï–ª–µ–∫—Ç—Ä–æ—Å–∞–º–æ–∫–∞—Ç–∏ Bolt,7999,7999,7500,7500,980,0,0,1622188,False
7S1YY_eYcR3uD_P69Dc3Sw,1625440668,–ï–ª–µ–∫—Ç—Ä–æ—Å–∞–º–æ–∫–∞—Ç–∏ Bolt,7999,7999,-1612,-1612,980,0,0,1614688,True
TcQmBNAe-VhSnTH7,1625421028,MAGAZYN DAY AND DAY,5499,5499,-1800,-1800,980,0,0,1616300,False,TP00-BMC6-5K45-3X92
m_hXygojCsOA2rkW,1625420870,MAGAZYN DAY AND DAY,5499,5499,-5350,-5350,980,0,0,1618100,False,3376-PAH6-TP0E-X376
ReSgSuPiVDe9vLZp,1625400732,MAGAZYN DAY AND DAY,5499,5499,-20400,-20400,980,0,0,1623450,False,43M5-2MA0-TC8E-5HC9
svrjfUiv4CuXdLFttTaLsRmp_w,1625355608,–°–∫–∞—Å—É–≤–∞–Ω–Ω—è. –ï–ª–µ–∫—Ç—Ä–æ—Å–∞–º–æ–∫–∞—Ç–∏ Bolt,7999,7999,7500,7500,980,0,0,1643850,False
kfPXoGL4hVa11V2VRFNR7w,1625355608,–ï–ª–µ–∫—Ç—Ä–æ—Å–∞–º–æ–∫–∞—Ç–∏ Bolt,7999,7999,-3433,-3433,980,0,0,1636350,True
DbAnNEDxGn6TSGzU,1625313990,mats,5814,5814,-52000,-52000,980,0,0,1639783,False,H726-T80A-8A28-4E4K
HhRDbGJfyVdE79rm,1625310441,–°–∫–∞—Å—É–≤–∞–Ω–Ω—è. Bolt,4121,4121,7000,7000,980,0,0,1691783,False
DmcM9owZXZPuqoDF,1625310388,Bolt,4121,4121,-8800,-8800,980,0,0,1684783,False,633H-P69A-9M4E-9PA9
WsoOMNrGyl7rh-Ji,1625309137,Bolt,4121,4121,-7000,-7000,980,0,0,1693583,False
qMpSTxsezuEd4C2q,1625307622,MAGAZYN DAY AND DAY,5499,5499,-14800,-14800,980,0,0,1700583,False,77EP-E814-7K40-CMC5
Ddi4JHJ7FaYw16VS,1625296220,–°–∫–∞—Å—É–≤–∞–Ω–Ω—è. Bolt,4121,4121,6100,6100,980,0,0,1715383,False
5q7bFvRee7DYAVRE,1625296174,Bolt,4121,4121,-6500,-6500,980,0,0,1709283,False,C2HC-01CC-KB90-C2M4
5tuExHNWltQ9AVXI,1625294537,Bolt,4121,4121,-6100,-6100,980,0,0,1715783,False
8IANkRG2N8RtWraB5VwCnwECGA,1625269960,–°–∫–∞—Å—É–≤–∞–Ω–Ω—è. –ï–ª–µ–∫—Ç—Ä–æ—Å–∞–º–æ–∫–∞—Ç–∏ Bolt,7999,7999,7500,7500,980,0,0,1721883,False
RpQK5LrH9fBKI-3M248gjSirDA,1625269960,–°–∫–∞—Å—É–≤–∞–Ω–Ω—è. –ï–ª–µ–∫—Ç—Ä–æ—Å–∞–º–æ–∫–∞—Ç–∏ Bolt,7999,7999,7500,7500,980,0,0,1714383,False
-BSlBmNhyrTk20Mbj06Bpw,1625269960,–ï–ª–µ–∫—Ç—Ä–æ—Å–∞–º–æ–∫–∞—Ç–∏ Bolt,7999,7999,-2652,-2652,980,0,0,1706883,True
zQhoZ9_2Q_m0Ox2o0x_Rnw,1625269960,–ï–ª–µ–∫—Ç—Ä–æ—Å–∞–º–æ–∫–∞—Ç–∏ Bolt,7999,7999,-2668,-2668,980,0,0,1709535,True
QAc0hWxxATknLmNY,1625250623,OK Wine,5411,5411,-67690,-67690,980,0,0,1712203,False,TX5E-40X4-CK50-20T7
0iI2dSB-5AhKwZ44,1625248602,Pirogitadruzi,5814,5814,-40000,-40000,980,0,0,1779893,False,XE4P-C2TM-7102-PEEA
6HdPTE6CSoJaRyDW,1625229209,–ú—ñ—Å—å–∫–µ –∫–∞—Ñ–µ ¬´–•–∞—Ä–º—Å¬ª (–ö–Ω–∏–∂–∫–æ–≤–∞ –∫—Ä–∞–º–Ω–∏—Ü—è ¬´–•–∞—Ä–º—Å¬ª),5814,5814,-24200,-24200,980,0,0,1819893,False,38K4-B4B9-P4H9-22AA
MRP_3cM0Dg07pecV,1625227118,–°—Ç–µ–π–∫—Ö–∞—É—Å,5814,5814,-12000,-12000,980,0,0,1844093,False,ETTH-48T7-2259-BBXC
T_zkuCG5dFyhSNOP,1625217579,Bluecup,5814,5814,-15600,-15600,980,0,0,1856093,False,0B56-0T0P-H90T-9P1K
HLvTC3c3F5hmEiY7,1625214464,–ï–ª–µ–∫—Ç—Ä–æ—Å–∞–º–æ–∫–∞—Ç–∏ Bolt,7999,7999,-7500,-7500,980,0,0,1871693,False
WqPaCOiFORwqcYiQfdPrYUGJDw,1625187435,–°–∫–∞—Å—É–≤–∞–Ω–Ω—è. –ï–ª–µ–∫—Ç—Ä–æ—Å–∞–º–æ–∫–∞—Ç–∏ Bolt,7999,7999,7500,7500,980,0,0,1879193,False
WxwbmJsk9zksrc6zX5-xmA,1625187435,–ï–ª–µ–∫—Ç—Ä–æ—Å–∞–º–æ–∫–∞—Ç–∏ Bolt,7999,7999,-1355,-1355,980,0,0,1871693,True
iRxbGGN9cypEQSJ6,1625181988,–ï–ª–µ–∫—Ç—Ä–æ—Å–∞–º–æ–∫–∞—Ç–∏ Bolt,7999,7999,-7500,-7500,980,0,0,1873048,False
JUAJVwPUMp85Mjs7,1625158539,"–Ø—Ä–æ—Å–ª–∞–≤—ñ–≤ –í–∞–ª, 19",5499,5499,-12600,-12600,980,0,0,1880548,False,EM6A-2482-02C6-AH20
Bh_TNRdVKF0JaHDr,1625129145,Bolt,4121,4121,-12000,-12000,980,0,0,1893148,False,AA15-X591-HKC5-49P2
Un9zpuy85JEcZfxE,1625126086,bwtc cafe&roasters,5814,5814,-7500,-7500,980,0,0,1905148,False,TTT1-E645-2EH2-BX94
wudmMqxKrJ9281Cn,1625126034,bwtc cafe&roasters,5814,5814,-9400,-9400,980,0,0,1912648,False,1K78-74X9-04AC-X8BK
e16Leqs0pExqsJ6_,1625123094,"Lifecell
+380631692598",4814,4814,-7500,-7500,980,0,0,1922048,True,47C8-1KKE-1MCC-K3CM
Gty-zZEiGfp0nhv8,1625099773,–í—ñ–¥—Å–æ—Ç–∫–∏ –∑–∞ —á–µ—Ä–≤–µ–Ω—å,4829,4829,1076,1076,980,0,0,1929548,True
cG5pVh-hUGZu89Qh,1625091517,Portmone,4814,4814,-32990,-32990,980,0,0,1928472,False,21X9-8K60-5MA0-9137
wtO9djyi-YAJresT,1630345402,Kitaika,5812,5812,-54000,-54000,980,0,0,1674418,False,P3B8-H5EC-464M-BA33
AQj98qR4HBUX-45H,1630343994,Bolt,4121,4121,-15800,-15800,980,0,158,1728418,False,13B9-A973-B1BX-66B1
quvIbhiUuGmjIGVS,1630342304,Bolt,4121,4121,-9800,-9800,980,0,98,1744218,False,P1E9-A9TP-9TBP-117B
f_x_byteAbXBmZAK,1630318053,–ï–ª–µ–∫—Ç—Ä–æ—Å–∞–º–æ–∫–∞—Ç–∏ Bolt,7999,7999,-6067,-6067,980,0,0,1754018,False,8PT8-B299-70EX-751X
n4EUddFztnCCE1F1,1630311186,–°–∫–∞—Å—É–≤–∞–Ω–Ω—è. Bolt,4121,4121,6900,6900,980,0,-69,1760085,False
KOiFkmBDJVt9eAg8,1630311129,Bolt,4121,4121,-7200,-7200,980,0,72,1753185,False,74T2-M9HC-TKE4-9BX1
mIXVOgCkiitDopm1,1630309019,Bolt,4121,4121,-6900,-6900,980,0,69,1760385,False
1Pufr-5u0NOhAo0z,1630304756,MAGAZYN DAY AND DAY,5499,5499,-19500,-19500,980,0,0,1767285,False,8CTT-A6KE-EPB9-3801
ZxugAOoMlW2Qyjbs,1630241027,–°–∫–∞—Å—É–≤–∞–Ω–Ω—è. Glovo,4215,4215,100,100,980,0,0,1786785,False
ieo5lmHFWM9IerU3,1630239851,Bolt,4121,4121,-7600,-7600,980,0,76,1786685,False,997C-E63M-MHC6-6CTE
bmSQlWvvbOu2uml5,1630238278,–°—ñ–ª—å–ø–æ,5411,5411,-62000,-62000,980,0,0,1794285,False,KB5K-82KP-6BP7-23T6
RpasJQ0450q7NgAl,1630234647,Bolt,4121,4121,-6200,-6200,980,0,62,1856285,False,C160-6MAK-BC1X-40C3
lS2nW3jk1imcvlL2,1630230951,bwtc cafe&roasters,5814,5814,-4000,-4000,980,0,0,1862485,False,B22B-M049-AB9X-KPCC
wEF61jHpK7xDHEDn,1630230702,–ê–ø—Ç–µ–∫–∞ –ê–ù–¶,5912,5912,-33600,-33600,980,0,0,1866485,False,6488-40K8-292X-E995
FlcmW9McsG6AKKfa,1630217447,–û–±—Å–ª—É–≥–æ–≤—É–≤–∞–Ω–Ω—è –ø–ª–∞—Ç–∏–Ω–æ–≤–æ—ó –∫–∞—Ä—Ç–∫–∏,4829,4829,-25000,-25000,980,0,0,1900085,True
axlmi5NgjNrt2WtV,1630160967,–°—ñ–ª—å–ø–æ,5411,5411,-13000,-13000,980,0,0,1925085,False,2MKP-AP72-K9EE-A585
e3EQAKhus0L4vyuz,1630160832,–°—ñ–ª—å–ø–æ,5411,5411,-41161,-41161,980,0,0,1938085,False,65PB-PBEH-0015-02A2
Rdx5jL6cTozi23Kq,1630073673,–ï–ª–µ–∫—Ç—Ä–æ—Å–∞–º–æ–∫–∞—Ç–∏ Bolt,7999,7999,-2791,-2791,980,0,0,1979246,False,E933-73MC-37H4-EACE
Ti1L1cKBfinghyjj,1630067260,MAGAZYN DAY AND DAY,5499,5499,-19100,-19100,980,0,0,1982037,False,HH3E-AXC9-1P3K-4CC3
eefKQV5jcpFJEkIr,1630066384,Glovo,4215,4215,-33000,-33000,980,0,0,2001137,False,K070-X313-21H3-B6P0
tXRazt1D8RqiImtP,1630066345,Glovo,4215,4215,-100,-100,980,0,0,2034137,False
SE0BInulBR79q_sq,1630063182,–ï–ª–µ–∫—Ç—Ä–æ—Å–∞–º–æ–∫–∞—Ç–∏ Bolt,7999,7999,-11333,-11333,980,0,0,2034237,False,KHA5-1825-AE45-HB6T
hXNpJw69FC8mfmVM,1630051616,APTEKA 1 KYIV,5912,5912,-3540,-3540,980,0,0,2045570,False,A11H-49HT-60B4-HH0H
SLcjfYXUPv-vsgY1,1630051008,–ú–∏—Ä–æ–≤–∞—è –ê–ø—Ç–µ–∫–∞,5912,5912,-532810,-532810,980,0,0,2049110,False,9T9M-AMH3-3XM4-CE7E
HxlslE3mC87Y1U2t,1630048796,Bolt,4121,4121,-6000,-6000,980,0,600,2581920,False,8M3X-6AT1-KTBX-7X3T
8B1LS9ISewgzru9W,1629970592,Lesya,4829,4829,-1000000,-1000000,980,0,0,2587920,True,KEEP-2M87-B95B-MH3K
YJK0bo8hpuuWPpTp,1629970465,–íi–¥: –ü–†–ò–•–û–î–¨–ö–û –ï.–í. –§–û–ü,4829,4829,2500000,2500000,980,0,0,3587920,True
Rsp7EXJuoFOS53aR,1629959486,Produkti,5499,5499,-11000,-11000,980,0,0,1087920,False,HCT2-X6HE-M9B0-PP1X
z4Fa8dca5z_0CZ4y,1629924586,Novapay,8999,8999,-3700,-3700,980,0,0,1098920,False,MTH7-32AM-B87B-PEBH
iM8NOoXhp0bTF1Zu,1629911107,Novus,5411,5411,-76695,-76695,980,0,0,1102620,False,H05P-395A-HXKM-0P63
1uIR0IKJ_IVajtuO,1629901487,–ï–ª–µ–∫—Ç—Ä–æ—Å–∞–º–æ–∫–∞—Ç–∏ Bolt,7999,7999,-3898,-3898,980,0,0,1179315,False,PCA5-9190-36T2-3A4K
VGxgsc-VdsMCsiu5,1629887384,–ü–∏—Ä—ñ–∂–∫–æ–≤–∞ ¬´–¢—ñ—Ç–∫–∞ –ö–ª–∞—Ä–∞¬ª,5814,5814,-29000,-29000,980,0,0,1183213,False,9K8P-PAB6-K0XH-0A04
Ao1j_NfV83QVcjCw,1629880342,–ï–ª–µ–∫—Ç—Ä–æ—Å–∞–º–æ–∫–∞—Ç–∏ Bolt,7999,7999,-1969,-1969,980,0,0,1212213,False,0ME0-CTAX-BTXM-PX1C
zkIir741uJ7BMfhi,1629877233,–ú–∏—Ä–æ–≤–∞—è –ê–ø—Ç–µ–∫–∞,5912,5912,-912750,-912750,980,0,0,1214182,False,0A1A-KXT4-AE1A-21K2
2C1VfVqwTs4lkPQ9,1629874147,Bolt,4121,4121,-7500,-7500,980,0,750,2126932,False,P38B-06AP-A74K-M121
C6p6GdZVgKHsDz2v,1629872668,MAGAZYN DAY AND DAY,5499,5499,-23440,-23440,980,0,0,2134432,False,A103-KK59-C1BX-TXX1
kReRYbUyDy1TO8Vq,1629820219,Lesya,4829,4829,-100000,-100000,980,0,0,2157872,True,KCKC-MK70-BM3X-XTCE
rJhO-MOCaDEvGezJ,1629815416,Bolt,4121,4121,-8100,-8100,980,0,810,2257872,False,AA3B-6C4A-5P1P-78AA
fOLMAwGGMT-W_GKF,1629796069,–°—ñ–ª—å–ø–æ,5411,5411,-162808,-162808,980,0,0,2265972,False,H8K9-9T8E-641M-5454
ax7oOm9zmaRyiSY_,1629756129,LIQPAY*FunKeys,5045,5045,-35000,-35000,980,0,0,2428780,False,8T11-B658-P0AP-X99H
BnHP75KToe55fDoj,1629744643,–§–∞—Ä–º–∞—Ü—ñ—è,5912,5912,-7200,-7200,980,0,0,2463780,False,MC4K-HXX8-CXM2-8B7C
rCBid6F09X0AtPfI,1629724559,FORGETMENOTCOFFEE2,5814,5814,-5300,-5300,980,0,0,2470980,False,C3B2-6MXA-8BX6-H5A2
mkGJct_BAUzgMtVN,1629721210,"–ë–∞–Ω–∫–æ–º–∞—Ç DN00 st.Leontovycha,1",6011,6011,-100000,-100000,980,0,0,2476280,False,63KC-B1E0-KE56-808X
M-9GXxRAmJCu5-X5,1629721151,"–ë–∞–Ω–∫–æ–º–∞—Ç DN00 st.Leontovycha,1",6011,6011,-100000,-100000,980,0,0,2576280,False,8HBB-P2B3-2HAA-3C0M
NGByY_VjaQdnTFoy,1629720704,–ë–∞–Ω–∫–æ–º–∞—Ç –ü–∞—Ä–∫ —ñ–º. –¢–∞—Ä–∞—Å–∞ –®–µ–≤—á–µ–Ω–∫–∞ (–ü–∞—Ä–∫ —ñ–º. –¢. –ì. –®–µ–≤—á–µ–Ω–∫–∞),6011,6011,-300000,-300000,980,0,0,2676280,False,257M-TC97-C70B-A8KH
d0_iVl42Dw-eIJ_t,1629720634,–ë–∞–Ω–∫–æ–º–∞—Ç –ü–∞—Ä–∫ —ñ–º. –¢–∞—Ä–∞—Å–∞ –®–µ–≤—á–µ–Ω–∫–∞ (–ü–∞—Ä–∫ —ñ–º. –¢. –ì. –®–µ–≤—á–µ–Ω–∫–∞),6011,6011,-200000,-200000,980,0,0,2976280,False,5BEA-40C2-0453-88KB
_6jj3UEbJZ39Y8gx,1629720567,–ë–∞–Ω–∫–æ–º–∞—Ç –ü–∞—Ä–∫ —ñ–º. –¢–∞—Ä–∞—Å–∞ –®–µ–≤—á–µ–Ω–∫–∞ (–ü–∞—Ä–∫ —ñ–º. –¢. –ì. –®–µ–≤—á–µ–Ω–∫–∞),6011,6011,-20000,-20000,980,0,0,3176280,False,7120-B874-8A4B-839C
7HeLdgfLe547p5Wv,1629720467,Bolt,4121,4121,-7200,-7200,980,0,720,3196280,False,MPCX-K96H-C579-XT09
JI7tm0WVRzzPAVZ3,1629720155,–í—ñ–¥: –û–ª–µ—Å—è –°.,4829,4829,700000,700000,980,0,0,3203480,True
TLGP0y3LilDJBfyA,1629715306,–ú–∏—Ä–æ–≤–∞—è –ê–ø—Ç–µ–∫–∞,5912,5912,-3000,-3000,980,0,0,2503480,False,HX81-0EMX-5694-CK5B
ZfH_dawD8057Rlud,1629713391,–°–∫–∞—Å—É–≤–∞–Ω–Ω—è. Bolt,4121,4121,6500,6500,980,0,-650,2506480,False
cO0-cphBSPOHiiRD,1629713336,Bolt,4121,4121,-7100,-7100,980,0,710,2499980,False,B913-5121-720T-1X11
8h42-uNCzB9JTRk_,1629711615,Bolt,4121,4121,-6500,-6500,980,0,650,2507080,False
vdyoA43r1dSsZ5Mk,1629695729,Bolt,4121,4121,-9000,-9000,980,0,900,2513580,False,C75X-CMP2-HX9B-526P
i31k4Bc6mdzOw9_J,1629689634,Bolt,4121,4121,-6400,-6400,980,0,640,2522580,False,5K3C-7BB5-38AC-3E88
ttlnmQkRjBhmNp_j,1629654744,Bolt,4121,4121,-8300,-8300,980,0,830,2528980,False,TEK6-4EKC-835B-87P4
q-kbhFdHPyoeo07A,1629651069,Bolt,4121,4121,-6900,-6900,980,0,690,2537280,False,1TE8-E037-CMPE-C31M
oTw0SzCEyqsOA-7I,1629644588,–°–∫–∞—Å—É–≤–∞–Ω–Ω—è. Bolt,4121,4121,15900,15900,980,0,-1590,2544180,False
FTq1VhbnFxEzDBQ9,1629644526,Bolt,4121,4121,-17400,-17400,980,0,1740,2528280,False,2858-EPC7-979A-8PPC
Ae0fQhmjrZyC5k4T,1629642731,Bolt,4121,4121,-15900,-15900,980,0,1590,2545680,False
dG58h6R7IM0VjQXl,1629631879,–ï–ª–µ–∫—Ç—Ä–æ—Å–∞–º–æ–∫–∞—Ç–∏ Bolt,7999,7999,-1381,-1381,980,0,0,2561580,False,BHME-9602-M4CC-6AT7
Q2ymzy-_H47ejvnk,1629620538,Bolt,4121,4121,-5100,-5100,980,0,510,2562961,False,5BB5-44H5-0298-788C
0fQtePo0w24kjMOi,1629618558,Bolt,4121,4121,-5900,-5900,980,0,590,2568061,False,8T8X-E364-XXHK-67AB
JhYdi7Xq3FjIbX_r,1629617493,MagazinKaphe,5814,5814,-10000,-10000,980,0,0,2573961,False,KBE2-B8T0-5P09-H757
9iB_wHKYRCv4KNRP,1629616643,Bolt,4121,4121,-5200,-5200,980,0,520,2583961,False,27PM-M8B2-KA28-MA16
cMmrYCQOPl-fN_6J,1629611868,Bolt,4121,4121,-6100,-6100,980,0,610,2589161,False,M3P4-EX39-TT93-KTE8
sb6OcolrmorzBNq0,1629571631,MAGAZYN DAY AND DAY,5499,5499,-27550,-27550,980,0,0,2595261,False,MX22-X7B5-X750-4796
DQVIWcpevpEyssHW,1629571112,Bolt,4121,4121,-6600,-6600,980,0,660,2622811,False,2PE6-6154-984T-KHX4
j3wl6EPjkt2ztWAV,1629557263,Bolt,4121,4121,-5500,-5500,980,0,550,2629411,False,9E33-T15M-XH7H-EC5C
USJWGVbEgU34cDmy,1629551256,Lesya,4829,4829,-500000,-500000,980,0,0,2634911,True,PB51-KKA2-7AEK-7A6K
aXUoRWr7JkFQQnqB,1629544306,CEH 1,7216,7216,-45900,-45900,980,0,0,3134911,False,T75C-4C45-K2TK-6033
joBU9n4miihAc5k4,1629543943,magazin 726008,5912,5912,-42700,-42700,980,0,0,3180811,False,9K1M-AK0P-HPCC-M782
bV7tUrV7Ai31OLQX,1629541401,mats,5814,5814,-80000,-80000,980,0,0,3223511,False,H32H-1EET-158X-53PT
41Rk4uYbNR_0JNgm,1629538458,Bolt,4121,4121,-9800,-9800,980,0,980,3303511,False,T6EC-32PA-KT97-9EA2
IxzRMhHvyb3v4iJh,1629536456,–§–æ—Ä–∞,5499,5499,-7107,-7107,980,0,0,3313311,False,9HAB-K03A-CTKE-HAKM
kd2mcYZN2DOlIUfu,1629530104,makeup.com.ua,5977,5977,-95100,-95100,980,0,0,3320418,False,TCK0-C267-KTA5-MAHB
YDP0wLddB8W6Mh_N,1629460827,BURGER FARM,5814,5814,-22000,-22000,980,0,0,3415518,False,PEH0-BT4C-5X21-50T5
4JiA7jHGy8Rr2dG0,1629456445,–ú–∏—Ä–æ–≤–∞—è –ê–ø—Ç–µ–∫–∞,5912,5912,-9200,-9200,980,0,0,3437518,False,B010-E4HB-K364-PA78
oe_mdtnTHSpeqkFe,1629456231,–ú–∏—Ä–æ–≤–∞—è –ê–ø—Ç–µ–∫–∞,5912,5912,-204190,-204190,980,0,0,3446718,False,83KP-H724-0EE6-2H8H
OhGjvUYDlo4xfX4t,1629440528,MAGAZYN DAY AND DAY,5499,5499,-19500,-19500,980,0,0,3650908,False,A5CA-KMTE-X912-KK09
TlhFYZUfoSBqwPte,1629356204,Bolt,4121,4121,-10400,-10400,980,0,0,3670408,False,T2H3-T48K-P2M6-TC8P
gNUeYDyHw-M4zNy3,1629354201,–°–∫–∞—Å—É–≤–∞–Ω–Ω—è. Bolt,4121,4121,10400,10400,980,0,0,3680808,False
Lj1IzIdQR9C8Ktsb,1629354145,Bolt,4121,4121,-10700,-10700,980,0,0,3670408,False,5144-8988-C4K9-TM87
3vJADwFlVZHWF-65,1629353767,ZOOLYUKS,742,742,-45000,-45000,980,0,9000,3681108,False,B7A9-5X32-68KE-HECH
5wxFvHjiB3JznsAB,1629351229,Bolt,4121,4121,-10400,-10400,980,0,0,3726108,False
0FuWuArnTmhGqomA,1629295137,MAGAZYNShop 146,5499,5499,-13000,-13000,980,0,0,3736508,False,2796-496K-91T5-9PBP
o-Y4Jt54IrZcXopl,1629292063,BURGER FARM,5814,5814,-20000,-20000,980,0,0,3749508,False,9EM5-E7EE-BTX7-6877
XT0Id87K0gW17Qnf,1629286614,Bolt,4121,4121,-8400,-8400,980,0,0,3769508,False,2732-4E97-4XKA-7K33
dESAmZ3eDBC40M_c,1629286525,–°—ñ–ª—å–ø–æ,5411,5411,-9054,-9054,980,0,0,3777908,False,P05C-B164-CH61-XK0T
ZnuR0Kr-b89suNAz,1629232321,–°–∫–∞—Å—É–≤–∞–Ω–Ω—è. Steam,5816,5816,7900,7900,980,0,0,3786962,False
JxeXjXf1o_TindAz,1629232221,Steam,5816,5816,-1600,-1600,980,0,0,3779062,False,6X76-CCMH-A6XX-X61X
9zcJT2R5NIJ-8Exh,1629228814,Steam,5816,5816,-7900,-7900,980,0,0,3780662,False
Zt67gHi4MFuu5wtJ,1629222535,MAGAZYN DAY AND DAY,5499,5499,-30376,-30376,980,0,0,3788562,False,45X1-4XE0-67PH-8EEE
qXLZOuZanYBuzluu,1629195621,Lesya,4829,4829,-1500000,-1500000,980,0,0,3818938,True,41XH-43E6-MKP9-1K76
r5Wtl3csQckHdJQI,1629193583,–íi–¥: –ü–†–ò–•–û–î–¨–ö–û –ï.–í. –§–û–ü,4829,4829,3800000,3800000,980,0,0,5318938,True
T1jttQ3_60zHKljv,1629190323,MAGAZYN DAY AND DAY,5499,5499,-24600,-24600,980,0,0,1518938,False,7TBP-014T-0X1M-KHM0
TGbuqETya4IX-CFU,1629175544,–°–∫–∞—Å—É–≤–∞–Ω–Ω—è. Bolt,4121,4121,12500,12500,980,0,0,1543538,False
JdGXu67dIJSj6HM_,1629175491,Bolt,4121,4121,-12600,-12600,980,0,0,1531038,False,E14K-H415-4TP9-64AP
417sHKj0qEx5U6Jr,1629172596,Bolt,4121,4121,-12500,-12500,980,0,0,1543638,False
XRkdnbdR09ikfOAJ,1629145699,NEGRONI APERITIVOBAR,5813,5813,-9000,-9000,980,0,0,1556138,False,3A2H-4C91-5442-3EKM
LbMbYLRb6foQ68yE,1629144253,NEGRONI APERITIVOBAR,5813,5813,-18000,-18000,980,0,0,1565138,False,42H3-AM8K-5TE5-0CT9
QgBjJ3WNkJfNDk2T,1629105390,–°–∫–∞—Å—É–≤–∞–Ω–Ω—è. Bolt,4121,4121,7300,7300,980,0,0,1583138,False
TnacjCrlSm8ggojP,1629105338,Bolt,4121,4121,-8600,-8600,980,0,0,1575838,False,HB82-2MAE-C59X-MCM9
m2U18PWbwkgAZdmq,1629102950,Bolt,4121,4121,-7300,-7300,980,0,0,1584438,False
HfS7zxFpSkfTq6Th,1629095714,Bolt,4121,4121,-10400,-10400,980,0,0,1591738,False,MP11-792A-8KMH-3K22
ZjeOEfMdUl33skV2,1629092160,Bolt,4121,4121,-13000,-13000,980,0,0,1602138,False,P75M-B2K7-E377-3MT0
05CAfHML5SrlNnfH,1629030065,MAGAZYN DAY AND DAY,5499,5499,-53450,-53450,980,0,0,1615138,False,K840-B4K9-K52H-MK4K
riUHRZJLxtuFzlY6,1629027577,WOG,5541,5541,-13170,-13170,980,0,0,1668588,False,M5KK-AEM1-M572-PTX5
NffgID_r9fhzI3xv,1629018004,–°–∫–∞—Å—É–≤–∞–Ω–Ω—è. Bolt,4121,4121,26100,26100,980,0,0,1681758,False
xUP-iPhQSbhaVe9X,1629017945,Bolt,4121,4121,-26200,-26200,980,0,0,1655658,False,T4KP-9X51-43X5-T884
wXEe4Z__D3FSbqAf,1629014623,Bolt,4121,4121,-26100,-26100,980,0,0,1681858,False
hE7qvAeiP8jnaYZj,1628949772,Bolt,4121,4121,-8400,-8400,980,0,0,1707958,False,H13X-M5XE-0649-046A
VjUSgreU-k8dRw7L,1628944987,–ü–∏—Ä—ñ–∂–∫–æ–≤–∞ ¬´–¢—ñ—Ç–∫–∞ –ö–ª–∞—Ä–∞¬ª,5814,5814,-10900,-10900,980,0,0,1716358,False,84KH-6C1K-P95E-6XTA
wx8jO_cOXeEg8IZ-,1628944890,–ê–ø—Ç–µ–∫–∞ –ê–ù–¶,5912,5912,-18570,-18570,980,0,0,1727258,False,4C8T-54H9-B298-PKEE
qT2xLkYhZyt5yo2B,1628944644,–ù–æ–≤–∞ –ø–æ—à—Ç–∞,7399,7399,-7200,-7200,980,0,0,1745828,False,45CC-3MTE-2C87-X04K
A7TjStqH586rBZWx,1628944487,–ö–æ–ª–æ,5411,5499,-14300,-14300,980,0,0,1753028,False,6838-T54A-H0T8-H20A
_M6YzCmOj8AqDTz7,1628929980,mats,5814,5814,-36000,-36000,980,0,0,1767328,False,9P51-345P-4B38-8A3A
k3XFrpiRBKljZzeVqQ2tGpu5kQ,1628897199,–°–∫–∞—Å—É–≤–∞–Ω–Ω—è. –ï–ª–µ–∫—Ç—Ä–æ—Å–∞–º–æ–∫–∞—Ç–∏ Bolt,7999,7999,7500,7500,980,0,0,1803328,False
aLZEbLs_2KIb5CUT4krcXHb-Bw,1628897199,–°–∫–∞—Å—É–≤–∞–Ω–Ω—è. –ï–ª–µ–∫—Ç—Ä–æ—Å–∞–º–æ–∫–∞—Ç–∏ Bolt,7999,7999,7500,7500,980,0,0,1795828,False
pU6ZQ_nY12ZN2DuQMrYLkPw,1628897199,–ï–ª–µ–∫—Ç—Ä–æ—Å–∞–º–æ–∫–∞—Ç–∏ Bolt,7999,7999,-2627,-2627,980,0,0,1788328,True
uqpViTddpGRaAevKBacW9tI,1628897199,–ï–ª–µ–∫—Ç—Ä–æ—Å–∞–º–æ–∫–∞—Ç–∏ Bolt,7999,7999,-2350,-2350,980,0,0,1790955,True
4sbHUnbmV6w5DPNX,1628846622,Bolt,4121,4121,-7200,-7200,980,0,0,1793305,False,XH0C-PX62-EAE8-E443
ocrrnUTWXOZZOwEi,1628844958,–ï–ª–µ–∫—Ç—Ä–æ—Å–∞–º–æ–∫–∞—Ç–∏ Bolt,7999,7999,-1863,-1863,980,0,0,1800505,False,48T4-BMX4-589B-A2BM
DpOaYf_gTE-TbHk7,1628838798,MAGAZYN DAY AND DAY,5499,5499,-28650,-28650,980,0,0,1802368,False,BXXE-CEC9-8766-0M4H
SKwndsiUAW8exv50,1628790453,–ê–ø—Ç–µ–∫–∞ –ê–ù–¶,5912,5912,-37190,-37190,980,0,0,1831018,False,A2T7-A99E-HH1T-004X
YW-FCyS3movxt37F,1628778243,–ú—ñ—Å—å–∫–µ –∫–∞—Ñ–µ ¬´–•–∞—Ä–º—Å¬ª (–ö–Ω–∏–∂–∫–æ–≤–∞ –∫—Ä–∞–º–Ω–∏—Ü—è ¬´–•–∞—Ä–º—Å¬ª),5814,5814,-4560,-4560,980,0,0,1868208,False,124C-P69C-CCH2-33K1
-JMeD_8HGUG2ptTL,1628759788,–°–∫–∞—Å—É–≤–∞–Ω–Ω—è. Bolt,4121,4121,6200,6200,980,0,0,1872768,False
HAm-VjaiDtZXE0bv,1628759730,Bolt,4121,4121,-6400,-6400,980,0,0,1866568,False,TA91-K64A-12H0-TAPH
k-JQjEjeLZqm_nXN,1628757779,Bolt,4121,4121,-6200,-6200,980,0,0,1872968,False
AVMiABR-BVUbD9ni,1628753849,–ö–æ–ª–æ,5411,5499,-10200,-10200,980,0,0,1879168,False,17E6-0AMA-6T6P-H252
3kO0R_6AP3upJVZ8,1628752919,Bolt,4121,4121,-10000,-10000,980,0,0,1889368,False,33MH-A932-2KE1-M69A
9lNVG_3vmlZaQlnZ,1628749818,–°–∫–∞—Å—É–≤–∞–Ω–Ω—è. Bolt,4121,4121,12200,12200,980,0,0,1899368,False
fW8sN-K-Srzei4z0,1628749740,Bolt,4121,4121,-14900,-14900,980,0,0,1887168,False,K2EM-E54H-725K-5419
817wE4wwG7KFuO4r,1628746523,–°–∫–∞—Å—É–≤–∞–Ω–Ω—è. Bolt,4121,4121,12200,12200,980,0,0,1902068,False
l2jB1qrpiju8o0-X,1628746494,Bolt,4121,4121,-12200,-12200,980,0,0,1889868,False
VtVFtzeeGkq68G_q,1628746284,Bolt,4121,4121,-12200,-12200,980,0,0,1902068,False
_dKYrxpzc1uU8DJW,1628701217,MAGAZYN DAY AND DAY,5499,5499,-19300,-19300,980,0,0,1914268,False,M673-CBT1-T76B-E00T
gR4gpqJXO1F-ZrqQ,1628700627,WINETIME,5921,5921,-43170,-43170,980,0,0,1933568,False,3581-0517-323P-4849
LM_lQL9U3odB0chI,1628699677,–í—ñ–¥: –ú–∞–∫—Å–∏–º –§.,4829,4829,18000,18000,980,0,0,1976738,True
Er97W9rGtqo358C1,1628680429,–ï–ª–µ–∫—Ç—Ä–æ—Å–∞–º–æ–∫–∞—Ç–∏ Bolt,7999,7999,-7500,-7500,980,0,0,1958738,False
BG7Q2z-MktgDOK3u,1628674571,–ï–ª–µ–∫—Ç—Ä–æ—Å–∞–º–æ–∫–∞—Ç–∏ Bolt,7999,7999,-7500,-7500,980,0,0,1966238,False
XkXI3uBDP2EVk-M8pMVAxKt1Ug,1628639014,–°–∫–∞—Å—É–≤–∞–Ω–Ω—è. –ï–ª–µ–∫—Ç—Ä–æ—Å–∞–º–æ–∫–∞—Ç–∏ Bolt,7999,7999,7500,7500,980,0,0,1973738,False
45j9vJ4L4FlATCRbOXBO0VA,1628639014,–ï–ª–µ–∫—Ç—Ä–æ—Å–∞–º–æ–∫–∞—Ç–∏ Bolt,7999,7999,-5901,-5901,980,0,0,1966238,True
vuDXp_xj1lyvBWS2,1628622047,Steam,5816,5816,-27900,-27900,980,0,0,1972139,False,6ME9-P144-4936-16K4
_DxJypbGtBj-29Kb,1628609101,Lesya,4829,4829,-80000,-80000,980,0,0,2000039,True,3PK7-823E-MTTT-5K4M
9sBniL1MGa4ZYSIz,1628606889,–ï–ª–µ–∫—Ç—Ä–æ—Å–∞–º–æ–∫–∞—Ç–∏ Bolt,7999,7999,-20148,-20148,980,0,0,2080039,False,5THH-A3CK-5C21-MPC1
a3PFHptPTMUvk1SK,1628606887,–°–∫–∞—Å—É–≤–∞–Ω–Ω—è. –ï–ª–µ–∫—Ç—Ä–æ—Å–∞–º–æ–∫–∞—Ç–∏ Bolt,7999,7999,7500,7500,980,0,0,2100187,False
wcVD5QBHk9a81zIe,1628599673,–ï–ª–µ–∫—Ç—Ä–æ—Å–∞–º–æ–∫–∞—Ç–∏ Bolt,7999,7999,-7500,-7500,980,0,0,2092687,False
kEKYyM6eIvkbXiEj,1628595925,–ü–∏—Ä—ñ–∂–∫–æ–≤–∞ ¬´–¢—ñ—Ç–∫–∞ –ö–ª–∞—Ä–∞¬ª,5814,5814,-15600,-15600,980,0,0,2100187,False,7263-0696-0XA8-KT58
_KnlNYNZel5z3Vpy,1628595728,–ö–æ–ª–æ,5411,5499,-23850,-23850,980,0,0,2115787,False,TEPA-B3T7-6844-CPPT
carBZKbZ0TlgzHT-,1628584475,–°–∫–∞—Å—É–≤–∞–Ω–Ω—è. Bolt,4121,4121,6100,6100,980,0,0,2139637,False
SGZYQm0RWfajsqd6,1628584418,Bolt,4121,4121,-6500,-6500,980,0,0,2133537,False,ME28-3XE0-4TMP-4PT8
Es-emdCQJLhr3pq7,1628582281,Bolt,4121,4121,-6100,-6100,980,0,0,2140037,False
EEdrKPGDUqd5JrIG,1628533071,–õ—é–±–æ–º–∏—Ä –ú.,–ú–∏–ª–æ—Å–µ—Ä–¥—è,4829,4829,-100000,-100000,980,0,0,2146137,True,M59B-M3BK-HE8P-10X1
a6Jbe839Leg2dIhX,1628532624,MAGAZYN DAY AND DAY,5499,5499,-4800,-4800,980,0,0,2246137,False,0KT6-PT96-0MB3-4TTP
rxRkxEzIRPSKB87I,1628497205,MAGAZYN DAY AND DAY,5499,5499,-13000,-13000,980,0,0,2250937,False,EECE-H7H4-0C86-M4T8
Ml51LSol1jBZ6T7d,1628431297,–û–ª–µ—Å—è –°.,4829,4829,-300,-300,980,0,0,2263937,True,9940-9KBH-E17M-878P
k2yaQlwFcmBulTUw,1628430844,–í—ñ–¥: –û–ª–µ—Å—è –°.,4829,4829,300,300,980,0,0,2264237,True
XPz4SutpWVFtp284,1628430835,–í—ñ–¥: –û–ª–µ—Å—è –°.,4829,4829,200,200,980,0,0,2263937,True
H4z7rqdC7QQDK7Yu,1628430825,–í—ñ–¥: –û–ª–µ—Å—è –°.,4829,4829,100,100,980,0,0,2263737,True
cA0iU5Bv9X9CuGvq,1628422898,Yaroslaviv Val 37-1,5499,5499,-48080,-48080,980,0,0,2263637,False,M0AX-1594-M2MT-33B6
fEXvsZXvD9uJfBiu,1628419877,Averkant,5814,5814,-5040,-5040,980,0,0,2311717,False,7TCT-0KKT-553B-H876
8mHycSg_I-AxgaZt,1628419254,CAFE COFFEERELIGIA,5812,5812,-5000,-5000,980,0,0,2316757,False,P031-CH7E-T8M0-43E8
YwyRzrItNRfqpcXf,1628415368,bwtc cafe&roasters,5814,5814,-16500,-16500,980,0,0,2321757,False,63AE-2864-ACC0-5KEB
TlbsWTJepzOetByr,1628357207,MAGAZYN DAY AND DAY,5499,5499,-23150,-23150,980,0,0,2338257,False,BE0M-KX7T-M61M-37TB
bA0Ghc9UJpZw2D7T,1628348109,PORTER PAB,5814,5814,-5000,-5000,980,0,0,2361407,False,6M4C-M24M-8173-C7K2
UmFKauyFhI7fFHo6,1628329563,–ï–ª–µ–∫—Ç—Ä–æ—Å–∞–º–æ–∫–∞—Ç–∏ Bolt,7999,7999,-7500,-7500,980,0,0,2366407,False
-ToWBYEiSF86_Tx1,1628328075,–ú–µ–≥–∞–º–∞—Ä–∫–µ—Ç,5399,5411,-10600,-10600,980,0,0,2373907,False,KE5E-XB9T-HHHX-B80X
bvGpuWbxMFQRVxwF,1628326587,Bolt,4121,4121,-10700,-10700,980,0,0,2384507,False,A09M-2586-P290-B9H0
4ZtWZT9CF4fv50Mv,1628267111,Novus,5411,5411,-28689,-28689,980,0,0,2395207,False,CA7K-5HXM-EX51-7HA0
0RrxxNLSv2-8Oj79,1628265072,bwtc cafe&roasters,5814,5814,-3000,-3000,980,0,0,2423896,False,X9X2-6ECB-352B-B246
XDkZJVcFgvUU8bas,1628251927,–°–∫–∞—Å—É–≤–∞–Ω–Ω—è. Bolt,4121,4121,7600,7600,980,0,0,2426896,False
E5MiiaUHS4H8schc,1628251828,Bolt,4121,4121,-8000,-8000,980,0,0,2419296,False,X99M-2MXT-TMT9-0A5C
DWGud3jCZB5ygk0z,1628251037,TITKA KLARA,5814,5814,-42500,-42500,980,0,0,2427296,False,75CT-7825-20B4-6PB6
sLtoaOR4JsSPlv5A,1628250899,TITKA KLARA,5814,5814,-20300,-20300,980,0,0,2469796,False,C5EK-631P-TT3K-766P
yBd2jrMuYFxo0Tm2,1628250727,Bolt,4121,4121,-7600,-7600,980,0,0,2490096,False
fWSwvjefPvjufUSu,1628250693,–ê–ø—Ç–µ–∫–∞ –ê–ù–¶,5912,5912,-18570,-18570,980,0,0,2497696,False,TTB9-3H62-E1P2-CX46
q44CpMUy6drSzj5Z,1628250456,MAGAZYN DAY AND DAY,5499,5499,-27100,-27100,980,0,0,2516266,False,1T8H-5A0P-1837-X2HC
_X2QWxcsZfACTFN9,1628247958,–û–ª–µ—Å—è –°.,4829,4829,-300000,-300000,980,0,0,2543366,True,H451-CB3X-T80K-4EMP
a8VyJMM444UHVf4M,1628235487,–û–ª–µ—Å—è –°.,4829,4829,-1000000,-1000000,980,0,0,2843366,True,6794-50MM-45EP-KH2P
zdwRV_Hg3-pl8nb7,1628233857,–°–∫–∞—Å—É–≤–∞–Ω–Ω—è. Bolt,4121,4121,6100,6100,980,0,0,3843366,False
A8zBEhdTIihZp-h7,1628233806,Bolt,4121,4121,-6200,-6200,980,0,0,3837266,False,PH8M-BK81-TM3H-106X
8qQYmeHPFe8e0tLA,1628231931,Bolt,4121,4121,-6100,-6100,980,0,0,3843466,False
54y1d8bEhEyminUW,1628146743,"Lifecell
+380631692598",4814,4814,-13000,-13000,980,0,0,3849566,True,X6BA-2477-82MH-9BTA
6qzWxx34cjNXKWjB,1628096459,MAGAZYN DAY AND DAY,5499,5499,-7100,-7100,980,0,0,3862566,False,C0P2-40AA-X353-B4XK
KXZhs21lOH0VZxZK,1628081030,Bolt,4121,4121,-7800,-7800,980,0,0,3869666,False,H93K-P28M-1TCC-4375
p5rVfH3NN9ePmFKH,1628065496,–°–∫–∞—Å—É–≤–∞–Ω–Ω—è. Bolt,4121,4121,6100,6100,980,0,0,3877466,False
Bj2G5Nx6YgJGTdza,1628065402,Bolt,4121,4121,-7400,-7400,980,0,0,3871366,False,BKTX-5015-H674-694X
-IFyDVIUQbnPLbZP,1628064453,Bolt,4121,4121,-6100,-6100,980,0,0,3878766,False
RqDnYAWV3U3vgFf7,1628014981,–í—ñ–¥: –î–∞—Ä'—è –ö.,–°–≤–∞–¥–µ–±–Ω—ã–π –∫–µ—à–±–µ–∫,4829,4829,10000,10000,980,0,0,3884866,True
o0bcFQC7pVPSQHay,1627994137,Pirogitadruzi,5814,5814,-23500,-23500,980,0,0,3874866,False,M03E-0623-A7BK-56KP
nLX6wwR9SbOxkZ2l,1627986719,MAGAZYN DAY AND DAY,5499,5499,-13000,-13000,980,0,0,3898366,False,257E-PHTM-7XH1-3EK1
PaPYVyco3g4h_0bM,1627986587,Bolt,4121,4121,-6900,-6900,980,0,0,3911366,False,72BM-KH23-7BTX-A1TM
-Offa7k760skrujF,1627980782,Bolt,4121,4121,-6100,-6100,980,0,0,3918266,False,B432-86K8-74MH-5HC1
GeKu-U0b2GAAGIJx,1627917322,Dini,2842,2842,-7900,-7900,980,0,0,3924366,False,7MM8-AC5H-3164-CK53
GV2CjAvo0fw5bupf,1627915960,–î–∞—Ä'—è –ö.,–ë–æ–≥–¥–∞–Ω—É –Ω–∞ —Å–≤–∞–¥—å–±—É üéâ,4829,4829,-20000,-20000,980,0,0,3932266,True,KKAX-9EEE-00C7-3P6A
CnLKE87mAKx0HIEC,1627914821,Uklon,4121,4121,-19800,-19800,980,0,0,3952266,False,2H6H-X633-62EH-MC2M
6cYefBaT-zlJEggb,1627890176,MAGAZYN DAY AND DAY,5499,5499,-7600,-7600,980,0,0,3972066,False,K162-43MT-PB25-PT6T
9oGykAIXtgKDDTGA28pnc5pntA,1627863939,–°–∫–∞—Å—É–≤–∞–Ω–Ω—è. –ï–ª–µ–∫—Ç—Ä–æ—Å–∞–º–æ–∫–∞—Ç–∏ Bolt,7999,7999,7500,7500,980,0,0,3979666,False
nJlFK2gcj9CCkh3Cjpy7VQ,1627863939,–ï–ª–µ–∫—Ç—Ä–æ—Å–∞–º–æ–∫–∞—Ç–∏ Bolt,7999,7999,-1810,-1810,980,0,0,3972166,True
0xBnnUMwXG3BiRc7,1627856420,Bolt,4121,4121,-17400,-17400,980,0,0,3973976,False,AHX6-1T02-758H-P9TM
IUhalboRULR7G_-G,1627847402,–°—ñ–ª—å–ø–æ,5411,5411,-13000,-13000,980,0,0,3991376,False,5196-KE2K-EE41-B405
n-KzfHRKDKtz2ZW6,1627843284,–°–∫–∞—Å—É–≤–∞–Ω–Ω—è. Bolt,4121,4121,17000,17000,980,0,0,4004376,False
nJoclrbEMDYswvcu,1627843084,Bolt,4121,4121,-20000,-20000,980,0,0,3987376,False,4670-2H2H-H394-MCBK
AbszzWl7XEABYUaz,1627841775,Bolt,4121,4121,-17000,-17000,980,0,0,4007376,False
-54nqGSIb96bkptN,1627841282,–Ü—Ä–∏–Ω–∞ –ú.,4829,4829,-45000,-45000,980,0,0,4024376,True,62KA-1777-PT5M-KB16
1uDhKbT4LcT72zPG,1627841118,Varvar Bar,5812,5812,-30800,-30800,980,0,0,4069376,False,P4K1-00H2-KXB6-H6A2
FAdi4KgNZvHD9B0X,1627829551,Bolt,4121,4121,-14000,-14000,980,0,0,4100176,False,PMXT-M8C5-KAT8-6AAH
r7sm-oo2T2XJc9xy,1627794031,–°–∫–∞—Å—É–≤–∞–Ω–Ω—è. Bolt,4121,4121,11000,11000,980,0,0,4114176,False
Oew7gXChsIx8jRnx,1627791936,–ê—Ä—Ç–µ–º –ü.,4829,4829,-7500,-7500,980,0,0,4103176,True,BTAA-P9X0-5BX5-4MHC
s2-ocFnaBm-NYvom,1627790334,Bolt,4121,4121,-11000,-11000,980,0,0,4110676,False
erxbDvbsUU9mqokD,1627776999,–í—ñ–¥—Å–æ—Ç–∫–∏ –∑–∞ –ª–∏–ø–µ–Ω—å,4829,4829,2289,2289,980,0,0,4121676,True
EPbmE7q413KlLsoz,1632922838,Bolt,4121,4121,-11900,-11900,980,0,0,2322853,False,H95T-6BP7-MXHP-49E4
QUBVKRLw0m2ttWt2,1632918189,–°–∫–∞—Å—É–≤–∞–Ω–Ω—è. Bolt,4121,4121,7700,7700,980,0,0,2334753,False
8U4BRVC5MauJt2hO,1632918012,Bolt,4121,4121,-9000,-9000,980,0,0,2327053,False,CTXB-E61E-X312-M5KP
VydgUZJExENVQGRS,1632915363,Bolt,4121,4121,-7700,-7700,980,0,0,2336053,False
EXBPAa-KNktQRkH0,1632910253,–°–∫–∞—Å—É–≤–∞–Ω–Ω—è. Bolt,4121,4121,3100,10000,980,0,0,2343753,False
dJTSFwcQwWYrITuh,1632908915,–°–∫–∞—Å—É–≤–∞–Ω–Ω—è. Bolt,4121,4121,6700,6700,980,0,0,2340653,False
SOM8772Zr9UF93fj,1632908823,Bolt,4121,4121,-8000,-8000,980,0,0,2333953,False,P7PX-TMTT-TE35-X2CB
diVQgMtyUVE9vHn1,1632908153,Bolt,4121,4121,-10000,-10000,980,0,0,2341953,False
7fdc-Gz0fTi1x4Qb,1632906703,Bolt,4121,4121,-6700,-6700,980,0,0,2351953,False
7AE0yrie-7RgQd4i,1632903034,–°–∫–∞—Å—É–≤–∞–Ω–Ω—è. Bolt,4121,4121,11900,11900,980,0,0,2358653,False
70Db2iU-1O1tUeCS,1632902984,Bolt,4121,4121,-12200,-12200,980,0,0,2346753,False,10BC-2X95-2K43-86TH
XQ216fJdU16tJ5Um,1632900483,Bolt,4121,4121,-11900,-11900,980,0,0,2358953,False
gZIi_FaPSB7CuPdb,1632895856,–û–±—Å–ª—É–≥–æ–≤—É–≤–∞–Ω–Ω—è –ø–ª–∞—Ç–∏–Ω–æ–≤–æ—ó –∫–∞—Ä—Ç–∫–∏,4829,4829,-25000,-25000,980,0,0,2370853,True
KZ2bz76QaDeWkwcM,1632860240,Glovo,4215,4215,-37200,-37200,980,0,0,2395853,False,M8P6-XE3M-5X9M-3121
hlfbzLTZMwo2c2K-,1632859119,MAGAZYN DAY AND DAY,5499,5499,-14600,-14600,980,0,292,2433053,False,HAH7-EX60-53PC-3K25
rM55q8r5s_wp4lKk,1632855202,Bolt,4121,4121,-6300,-6300,980,0,0,2447653,False,6H7A-XBP6-8EPT-6HX2
zPQ2YLAYRHmoTrUo,1632853457,Bolt,4121,4121,-9200,-9200,980,0,0,2453953,False,4TE1-9KAC-PH9E-TEHA
ZD9dPE4RIS-_Q6DG,1632851573,–°–∫–∞—Å—É–≤–∞–Ω–Ω—è. Passport Control,4111,4111,100,100,980,0,0,2463153,False
hjp4Cu9pQaRNw81h,1632851565,Passport Control,4111,4111,-100,-100,980,0,0,2463053,False
R2e8miFGdCMTE5rj,1632836631,TouchcardGP,4816,4816,-24720,-24720,980,0,0,2463153,False,M824-041E-5TM7-E41B
dwValrx8jE2gby8z,1632813062,Flowerbox,5992,5992,-57000,-57000,980,0,0,2487873,False,4TX4-0MTK-0A77-5B43
p3fZtNWEsuR8BiHa,1632812168,–ö–æ–ª–æ,5411,5499,-25700,-25700,980,0,514,2544873,False,9CHE-BPB9-8M08-X586
X8SZQEvrr_jiRnVf,1632811962,–ù–æ–≤–∞ –ø–æ—à—Ç–∞,7399,7399,-10400,-10400,980,0,0,2570573,False,X602-7XCM-AKXH-6E8B
qfuFdozcOm7Mz6GZ,1632811634,–ê–ø—Ç–µ–∫–∞ –ê–ù–¶,5912,5912,-25290,-25290,980,0,0,2580973,False,E994-CTE9-7BC4-TX57
pfzCGwTe9PRvZwyi,1632769356,–§—É–Ω—Ç –ö–∞–≤–∏,5411,5411,-52500,-52500,980,0,1050,2606263,False,3M4T-AP8T-4ABA-1H69
4ULphrFyVAydRoIX,1632671991,FDY*Food,5499,5499,-4000,-4000,980,0,80,2658763,False,4X43-XA9X-0P21-TK8X
im-GaFyGRQIuWEt5,1632671495,FDY*Food,5499,5499,-19900,-19900,980,0,398,2662763,False,6CMC-4T8H-298T-74B9
CIb1FdJapn9lOBaf,1632650901,OK Wine,5411,5411,-23370,-23370,980,0,467,2682663,False,A08H-25HM-K193-1H4T
jEY52gXWJmmy3DCO,1632649972,ZOOLYUKS,5995,5995,-47000,-47000,980,0,0,2706033,False,TH22-4773-CH74-3B7P
lq1_USZu_mVTjAq5,1632649197,Zootovari,5995,5995,-10300,-10300,980,0,0,2753033,False,25AM-C9CE-P1BH-21XP
Wg4ogcJ-3vctRAbi,1632648885,–ö–æ–ª–æ,5411,5499,-7350,-7350,980,0,147,2763333,False,H362-X203-PET0-CH8C
hTCEp-vtiJgF4PxL,1632587563,"Lifecell
+380631692598",4814,4814,-15000,-15000,980,0,0,2770683,True,CKC1-B0CM-X87K-PA61
jAzds5kMJmz95yPH,1632567211,MAGAZYN DAY AND DAY,5499,5499,-20400,-20400,980,0,408,2785683,False,E559-AEEE-11KX-M0AX
vaszJNKxyBh1jlWy,1632561638,Novus,5411,5411,-26272,-26272,980,0,525,2806083,False,62TH-K8E0-MEA6-4X61
nwVuO-xsGfQdil7c,1632561159,–ê–ø—Ç–µ–∫–∞ –î–æ–±—Ä–æ–≥–æ –î–Ω—è,5912,5912,-27260,-27260,980,0,0,2832355,False,5MPE-C6AX-XHXE-297B
TAWT9vtINjR8bhXW,1632561045,516798****7465,4829,4829,-29100,-29100,980,0,0,2859615,True,CATE-AHPP-6TKX-CHAX
TwU2Mg7ncgA3-YyB,1632413881,MAGAZYN DAY AND DAY,5499,5499,-33400,-33400,980,0,668,2888715,False,CC9X-63A8-KK6T-A509
aCqp-jMddDb5ORzK,1632334694,Steam,5816,5816,-5000,-5000,980,0,0,2922115,False,TMMC-5K97-B0M5-C83H
VnDcCdDeY6ZRKgUN,1632218635,–°–∫–∞—Å—É–≤–∞–Ω–Ω—è. –ú–µ–∂–¥—É–Ω–∞—Ä–æ–¥–Ω—ã–π –∞—ç—Ä–æ–ø–æ—Ä—Ç ¬´–ë–æ—Ä–∏—Å–ø–æ–ª—å¬ª (KBP) (–ú—ñ–∂–Ω–∞—Ä–æ–¥–Ω–∏–π –∞–µ—Ä–æ–ø–æ—Ä—Ç ¬´–ë–æ—Ä–∏—Å–ø—ñ–ª—å¬ª),4111,4111,100,100,980,0,0,2927115,False
h7Ewvza1IZIVG4VP,1632218628,–ú–µ–∂–¥—É–Ω–∞—Ä–æ–¥–Ω—ã–π –∞—ç—Ä–æ–ø–æ—Ä—Ç ¬´–ë–æ—Ä–∏—Å–ø–æ–ª—å¬ª (KBP) (–ú—ñ–∂–Ω–∞—Ä–æ–¥–Ω–∏–π –∞–µ—Ä–æ–ø–æ—Ä—Ç ¬´–ë–æ—Ä–∏—Å–ø—ñ–ª—å¬ª),4111,4111,-100,-100,980,0,0,2927015,False
gIvqqSfkhBgvgnia,1632218081,–°–∫–∞—Å—É–≤–∞–Ω–Ω—è. Passport Control,4111,4111,100,100,980,0,0,2927115,False
qaiPRyZAwwPZKQWg,1632218071,Passport Control,4111,4111,-100,-100,980,0,0,2927015,False
qqvP6n6_6yuakuio,1632217748,–°–∫–∞—Å—É–≤–∞–Ω–Ω—è. Passport Control,4111,4111,100,100,980,0,0,2927115,False
BLxWioGgqaetR7io,1632217741,Passport Control,4111,4111,-100,-100,980,0,0,2927015,False
AEhAUcFiuil8Eplg,1632212555,MAGAZYN DAY AND DAY,5499,5499,-39450,-39450,980,0,789,2927115,False,P839-2ETP-M72C-7C89
o-pDqvVv4gwmSjOs,1632211556,Bolt,4121,4121,-3500,-3500,980,0,0,2966565,False,KEH9-XXP9-51A7-6X5M
moXbCNFNeP4-jSMK,1632211118,Lesya,4829,4829,-1000000,-1000000,980,0,0,2970065,True,2BB6-CBKP-H35A-H023
l3o52ozdwcd4imKb,1632157397,MAGAZYN DAY AND DAY,5499,5499,-5450,-5450,980,0,109,3970065,False,69BP-44ET-58EM-8CCC
egKNw5ibJvN6LGDP,1632156476,Bolt,4121,4121,-9600,-9600,980,0,0,3975515,False,280E-1851-M2KA-BTHH
5csjqqwzmVDR2ctY,1632147133,SQ *HOUSECAT PRODUCTIO,7922,7922,-26770,-1000,840,0,0,3985115,False,E9BT-83B9-2K5M-EKT9
RUHPEOixfi37CK-g,1632128562,Bolt,4121,4121,-8400,-8400,980,0,0,4011885,False,MEB3-2CX6-3K59-KB81
pge8i4j6onpEbrH-,1632122829,MAGAZYN DAY AND DAY,5499,5499,-20400,-20400,980,0,408,4020285,False,C4X0-H1M1-X0BM-MKA9
oAYWNXxQaMHvJVxD,1632121634,Bolt,4121,4121,-7600,-7600,980,0,0,4040685,False,7EM5-B9M2-1CK2-MCC4
cqtCMXAHCDmfK10w,1632121486,Lesya,4829,4829,-200000,-200000,980,0,0,4048285,True,M044-8C9A-M6M1-A1BX
OP0YbLoHt4t6pVMD,1632044263,Bolt,4121,4121,-8000,-8000,980,0,0,4248285,False,HCPB-MPT1-AH2E-HKBE
6IMbJtlsA4gAwhFn,1631981674,MAGAZYN DAY AND DAY,5499,5499,-13600,-13600,980,0,272,4256285,False,PAH1-7809-7749-1E00
Xhq7S1HI-11w5iVD,1631980502,Bolt,4121,4121,-8000,-8000,980,0,0,4269885,False,HKB8-P7HT-HBE0-AEE8
1nnr7DdJsZ2qVBNY,1631973575,–°–∫–∞—Å—É–≤–∞–Ω–Ω—è. Bolt,4121,4121,7800,7800,980,0,0,4277885,False
RWwVuPxtnkMObBXv,1631973505,Bolt,4121,4121,-8100,-8100,980,0,0,4270085,False,6X5B-893X-X1TP-85A6
ng5SGIzf2VRm-H_w,1631971402,Bolt,4121,4121,-7800,-7800,980,0,0,4278185,False
QRnPb37gnNuOeWAD,1631968662,Bolt,4121,4121,-9500,-9500,980,0,0,4285985,False,EHT1-XX9H-B21A-7CHK
OWh6hFEFB6Y5ONFB,1631968546,Octo Tower,5812,5812,-95500,-95500,980,0,2865,4295485,False,T7TA-1HH2-52TB-BAHB
Lgvwuq1UVDcWIJgB,1631954132,Bolt,4121,4121,-8200,-8200,980,0,0,4390985,False,65MM-44K6-5CTA-448K
34UQLsdIcjIDY0Wz,1631949763,–°–∫–∞—Å—É–≤–∞–Ω–Ω—è. Bolt,4121,4121,7600,7600,980,0,0,4399185,False
jrEJ2MjyxFtFiKd3,1631949699,Bolt,4121,4121,-10600,-10600,980,0,0,4391585,False,KKB1-AACP-5E3P-E21E
K7GkFNb7b-3BHUc-,1631948656,Bolt,4121,4121,-7600,-7600,980,0,0,4402185,False
jNXTYJ7AwDj03QlP,1631904983,–§–∞—Ä–º–∞—Ü—ñ—è,5912,5912,-46900,-46900,980,0,0,4409785,False,E537-2H8K-C4HM-KK00
noih7EIDUEOqO0sm,1631898927,Novus,5411,5411,-39285,-39285,980,0,785,4456685,False,7PH6-H6KA-ET7B-0X89
GgsvtOub583Ltp22,1631883495,Bolt,4121,4121,-9900,-9900,980,0,0,4495970,False,P929-T51T-KBP8-7KC2
QCSgbuboJK4Ae5Nm,1631877350,–ü–∏—Ä—ñ–∂–∫–æ–≤–∞ ¬´–¢—ñ—Ç–∫–∞ –ö–ª–∞—Ä–∞¬ª,5814,5814,-23600,-23600,980,0,708,4505870,False,9885-0E1M-4AE8-E075
ILlNzJ7l2vQSgAKF,1631877137,–ö–æ–ª–æ,5411,5499,-16200,-16200,980,0,324,4529470,False,42T5-182T-0HET-5M8H
HN9_u83JMXB-FBNy,1631867899,Bolt,4121,4121,-6900,-6900,980,0,0,4545670,False,K225-T6X8-B762-5M52
a2YTV6XJjTfpKHdI,1631809211,Beer Market,5921,5921,-36047,-36047,980,0,720,4552570,False,9MCB-4PKT-25XP-67H9
v7E_TsrW3ubJABhg,1631807594,Bolt,4121,4121,-11200,-11200,980,0,0,4588617,False,44BM-BM90-8HTA-78EP
7hmDlC2zN_Lla_fN,1631802612,–°–∫–∞—Å—É–≤–∞–Ω–Ω—è. Bolt,4121,4121,10600,10600,980,0,0,4599817,False
vmhfIfEJbhqF5s8m,1631802551,Bolt,4121,4121,-11600,-11600,980,0,0,4589217,False,8EE9-H605-87E5-3B78
OQh-yCmw5B1msk77,1631801089,Bolt,4121,4121,-10600,-10600,980,0,0,4600817,False
-YiM_ScZu5d3S2ty,1631796968,Bolt,4121,4121,-8500,-8500,980,0,0,4611417,False,3KBH-CKH4-0KEE-56EA
2TgX5ZQUbHpVJb8p,1631791913,Bolt,4121,4121,-8200,-8200,980,0,0,4619917,False,36HT-CX2M-114E-E0PH
Lz9nsDpUPCjyXzyi,1631789338,MAGAZYNShop 146,5499,5499,-6800,-6800,980,0,136,4628117,False,90CB-6PB9-38E7-H4P0
gmD9UeoVcIu1s3Wy,1631789183,mats,5814,5814,-10000,-10000,980,0,300,4634917,False,BET1-9K30-AH03-MP99
fm-lST-1xpyj8yES,1631728477,Novus,5411,5411,-13600,-13600,980,0,272,4644917,False,7PA2-CHM0-0PKM-B07K
tah8VnwP_yViHsw_,1631728425,Novus,5411,5411,-100142,-100142,980,0,2002,4658517,False,E187-X51K-X1E3-BB60
n98HHKy_3WEGu3pV,1631714736,Bolt,4121,4121,-10500,-10500,980,0,0,4758659,False,12X5-KM96-7H5A-4T1T
CirjKCMcUtvwU0id,1631706751,Bolt,4121,4121,-12600,-12600,980,0,0,4769159,False,71BE-0ETB-B206-2BE5
Pzzg73NwN30CqvWT,1631706568,Lesya,4829,4829,-2000000,-2000000,980,0,0,4781759,True,CP75-XXKM-T54A-T5KX
Ts7jBP8XJJ46FBOj,1631706537,–íi–¥: –ü–†–ò–•–û–î–¨–ö–û –ï.–í. –§–û–ü,4829,4829,5000000,5000000,980,0,0,6781759,True
S2_jT0d038TU0TDV,1631633835,–ï–ª–µ–∫—Ç—Ä–æ—Å–∞–º–æ–∫–∞—Ç–∏ Bolt,7999,7999,-2590,-2590,980,0,0,1781759,False,TKM9-H891-KMA0-XH51
CdO_Udl2TrRCXIzc,1631624708,–ï–ª–µ–∫—Ç—Ä–æ—Å–∞–º–æ–∫–∞—Ç–∏ Bolt,7999,7999,-4463,-4463,980,0,0,1784349,False,TH2A-1MAK-1EM6-XTB8
G--11ieSwhRIYzZu,1631616944,MAGAZYN DAY AND DAY,5499,5499,-5700,-5700,980,0,57,1788812,False,AMP8-500H-M288-K600
PQtjA1SkMc6cKtEy,1631555111,Novus,5411,5411,-10906,-10906,980,0,109,1794512,False,TAAH-1CTX-4123-6HPA
uIgEcJxFzrc6vwTf,1631553310,MAGAZYN DAY AND DAY,5499,5499,-18850,-18850,980,0,188,1805418,False,765C-7463-9CAM-HBXP
0hSrUE3cv36-XFM1,1631468319,Novus,5411,5411,-11727,-11727,980,0,117,1824268,False,5CCK-6CT9-KB1X-2BBH
0QTtkC-8kxIYccLw,1631433877,mats,5814,5814,-15000,-15000,980,0,150,1835995,False,ECT3-M565-X967-CM0X
MPOn4G8mSfLhVP4E,1631381801,OK Wine,5411,5411,-84570,-84570,980,0,845,1850995,False,03TP-0C91-BM23-E3K6
RvrlWMnYcU44YvwE,1631381357,MAGAZYN DAY AND DAY,5499,5499,-24071,-24071,980,0,240,1935565,False,21K9-2P8C-MX2A-4CMB
IX_P6V-sKrPKTpgv,1631378059,Bolt,4121,4121,-9500,-9500,980,0,0,1959636,False,1032-0K92-ME7E-MKP0
g8AZo44plATPblBe,1631368248,BistroBistro,5814,5814,-34000,-34000,980,0,402,1969136,False,0CP4-2C44-B535-4E29
QR3w8wxMxn77JyVd,1631363401,–Ñ–ª–∏–∑–∞–≤–µ—Ç–∞ –Ü.,4829,4829,-5000,-5000,980,0,0,2003136,True,HX32-17A0-MK31-04MK
yXyWO-lvyTO54ncR,1631358301,–ê–Ω–∞—Å—Ç–∞—Å—ñ—è –õ.,4829,4829,-20000,-20000,980,0,0,2008136,True,X5TC-0M2X-7625-TEE3
OPAYPawRVRHU57ck,1631358260,–ö–∞—Ç–µ—Ä–∏–Ω–∞ –î.,4829,4829,-27500,-27500,980,0,0,2028136,True,8BX0-9E7A-8194-B2A1
ibw4PKjYkq15IYyw,1631356684,–ê–ø—Ç–µ–∫–∞ –ê–ù–¶,5912,5912,-1100,-1100,980,0,0,2055636,False,MHM5-44ET-XMK7-HABK
gzrzv_xZNw501S_K,1631346214,–í–∏–≤–µ–¥–µ–Ω–Ω—è –∫–µ—à–±–µ–∫—É 834.18‚Ç¥,4829,4829,67150,67150,980,0,0,2056736,True
aAm7eNbUCd0tRIbU,1631288827,Novus,5411,5411,-13600,-13600,980,0,167,1989586,False,A7C6-CB95-PHBH-10MA
2bIJKJ2mTKLivhIh,1631288708,Novus,5411,5411,-104686,-104686,980,0,2093,2003186,False,AEK3-1HHH-H844-TPA5
habHyBdF1WNjqkhE,1631256728,–ù–æ–≤–∞ –ø–æ—à—Ç–∞,4214,4214,-4300,-4300,980,0,0,2107872,False,B1EX-P881-3BBA-3BX1
E2fjG9_90QwK3ZTd,1631216100,–í—ñ–¥: –ë–æ–≥–¥–∞–Ω –ë—ñ–ª–æ—à–∏—Ü—å–∫–∏–π,4829,4829,19200,19200,980,0,0,2112172,True
DErfiI5ul-4d1VYG,1631215807,THIS IS PIVBAR,5812,5812,-90000,-90000,980,0,2700,2092972,False,AB1C-M93K-T732-375K
J-bOJVqrO14dwHVa,1631215624,THIS IS PIVBAR,5812,5812,-11822,-11822,980,0,354,2182972,False,0C0A-H711-3PC4-CT4B
7rhoSekotuSqLgU3,1631206194,MAGAZYN DAY AND DAY,5499,5499,-13000,-13000,980,0,260,2194794,False,T942-T337-9X74-0T62
CwTymsrYy9E9TtR8,1631205977,Bolt,4121,4121,-8000,-8000,980,0,0,2207794,False,445C-14C7-MHH1-59X7
KUj2f6dFsh1vD6J-,1631196440,–¢–∞—ó—Å—ñ—è –ß.,4829,4829,-42000,-42000,980,0,0,2215794,True,90B0-56CH-2P4K-T91K
5bxoBoC6t_PxU9rY,1631191225,Lesya,4829,4829,-800000,-800000,980,0,0,2257794,True,T870-X6M0-4KPX-5HH2
CI3AQYQlwgkTF5-q,1631189908,LIQPAY*Vidavnictvo Art,5942,5942,-68000,-68000,980,0,0,3057794,False,AX0P-6T7M-6XXT-A9TA
OqTt1Eg0fC5GpThp,1631111789,–ê–ø—Ç–µ–∫–∞ –ê–ù–¶,5912,5912,-24500,-24500,980,0,0,3125794,False,E6X3-CT64-ACAE-AA5K
mA4FHjUZQkE-WEf1,1631100889,–ï–ª–µ–∫—Ç—Ä–æ—Å–∞–º–æ–∫–∞—Ç–∏ Bolt,7999,7999,-1538,-1538,980,0,0,3150294,False,74HM-MTAA-0B3A-K550
dMvw19iKvH4k7FyD,1631091790,–íi–¥: –ü–†–ò–•–û–î–¨–ö–û –ï.–í. –§–û–ü,4829,4829,1200000,1200000,980,0,0,3151832,True
lwjThclj6Wy5zmD3,1631043609,–°–∫–∞—Å—É–≤–∞–Ω–Ω—è. Bolt,4121,4121,18500,18500,980,0,0,1951832,False
IoSL59mYsiR_eMCm,1631042392,Bolt,4121,4121,-19600,-19600,980,0,0,1933332,False,5X70-XBHA-TK98-P4HT
gnzWCjOypPL5qP0R,1631040059,Bolt,4121,4121,-18500,-18500,980,0,0,1952932,False
4CachSIXVPVDRC3s,1631034032,MAGAZYN DAY AND DAY,5499,5499,-41200,-41200,980,0,538,1971432,False,TX7B-39XH-C741-6878
QaMDqtYN91_DSEPp,1631024280,Bolt,4121,4121,-9100,-9100,980,0,0,2012632,False,A679-905X-THH0-44B7
RRK64LtZAW7Vymfs,1631010419,Bolt,4121,4121,-10300,-10300,980,0,0,2021732,False,HT22-E523-MBC7-1TBT
OlAA85_YqOxJE7B5,1631002829,–°–∫–∞—Å—É–≤–∞–Ω–Ω—è. Bolt,4121,4121,7700,7700,980,0,0,2032032,False
JD6pbkRVM5h74CU5,1631002764,Bolt,4121,4121,-8100,-8100,980,0,0,2024332,False,9BC6-08K1-09TB-AH1T
uows2ttvG6c-hGL7,1631000273,Bolt,4121,4121,-7700,-7700,980,0,0,2032432,False
hB8b2l3z9owCGlHE,1630997670,–ê–ø—Ç–µ–∫–∞ –ê–ù–¶,5912,5912,-11800,-11800,980,0,0,2040132,False,E806-PC9A-1MP3-10HK
EJPqqq603pGeP5at,1630995569,Lesya,4829,4829,-100000,-100000,980,0,0,2051932,True,6BMC-721B-KXM1-KAAT
rGVQByVN2Jiz-YE3,1630949683,MagazinProdukti,5499,5499,-18350,-18350,980,0,367,2151932,False,2839-2EBA-P795-3800
uk6g21vgUIhi1TOv,1630948804,McDonald‚Äôs,5814,5814,-16700,-16700,980,0,501,2170282,False,BA8C-27E2-87C0-H97A
OgRXRXQu7bgcQp-O,1630934883,Novus,5411,5411,-6499,-6499,980,0,129,2186982,False,55MA-TP91-ABBE-5PMA
DN571o1ZDZ05zMXE,1630926636,–°–∫–∞—Å—É–≤–∞–Ω–Ω—è. Bolt,4121,4121,8700,8700,980,0,0,2193481,False
J0LHijM8TzKsWT2b,1630926579,Bolt,4121,4121,-10100,-10100,980,0,0,2184781,False,5M28-M46T-X7MX-E814
C5nqfXGkoifuJrzb,1630924179,–î–º–∏—Ç—Ä–æ –ö.,–°—Ç—Ä–∞—Ö–æ–≤–∫–∞ –ø–∞—Ä—Ç–Ω—ë—Ä–∞,4829,4829,-771500,-771500,980,0,0,2194881,True,9EM0-ME9M-5M6P-736B
sdbj1BlTwIh5F80v,1630923608,Bolt,4121,4121,-8700,-8700,980,0,0,2966381,False
C53GufD4nCcCh6CG,1630860455,Lesya,4829,4829,-638000,-638000,980,0,0,2975081,True,0HE2-AC18-EKPX-PK89
BURm_sSIYzJx-7yn,1630842830,FDY*Food,5499,5499,-4000,-4000,980,0,0,3613081,False,A2B8-BBKA-57XT-TPC9
lhjHR3eX2IN1Eq2U,1630841336,FDY*Food,5499,5499,-9500,-9500,980,0,0,3617081,False,8B5K-2PK4-MM80-4XH9
ATdgDbEZsUy75ZO9,1630834282,–ï–ª–µ–∫—Ç—Ä–æ—Å–∞–º–æ–∫–∞—Ç–∏ Bolt,7999,7999,-2274,-2274,980,0,0,3626581,False,H43H-KB0C-EA86-P6M7
J5lMvkoUeazxfFur,1630828011,Bolt,4121,4121,-7600,-7600,980,0,0,3628855,False,05P3-P835-820K-67K4
uhWbZBeg5m0Bclcb,1630827635,Right Coffee Bar,5814,5814,-12500,-12500,980,0,0,3636455,False,E053-HC4K-2H85-0APC
nki1-JS6n1dgYHaC,1630827298,Novus,5411,5411,-12999,-12999,980,0,0,3648955,False,674T-E373-CEH4-4430
HK7BuEfUcb0ZCNaw,1630827239,Novus,5411,5411,-3299,-3299,980,0,0,3661954,False,0H45-B795-1KB2-HK72
BETm-N-5ldqTlFS3,1630826979,–ú–æ–ª–æ–∫–æ –≤—ñ–¥ –§–µ—Ä–º–µ—Ä–∞,5411,5451,-13566,-13566,980,0,0,3665253,False,M921-58C5-1035-A72C
v0ygCxOWHMUEyERV,1630826404,–ê–ø—Ç–µ–∫–∞ –ê–ù–¶,5912,5912,-68420,-68420,980,0,0,3678819,False,EP55-22K2-T04C-40AC
yNygqCRg55d1G0iwEQIYePKsJQ,1630798241,–°–∫–∞—Å—É–≤–∞–Ω–Ω—è. –ï–ª–µ–∫—Ç—Ä–æ—Å–∞–º–æ–∫–∞—Ç–∏ Bolt,7999,7999,5000,5000,980,0,0,3747239,False
SQ2tKqNjdv5Y0-cLgUoe1zIOjg,1630798241,–°–∫–∞—Å—É–≤–∞–Ω–Ω—è. –ï–ª–µ–∫—Ç—Ä–æ—Å–∞–º–æ–∫–∞—Ç–∏ Bolt,7999,7999,5000,5000,980,0,0,3742239,False
YDcFBD5Isbz0pwwbcxbolg,1630798241,–ï–ª–µ–∫—Ç—Ä–æ—Å–∞–º–æ–∫–∞—Ç–∏ Bolt,7999,7999,-1729,-1729,980,0,0,3737239,True
pja0aDfNgQyG8gaYfspTcw,1630798241,–ï–ª–µ–∫—Ç—Ä–æ—Å–∞–º–æ–∫–∞—Ç–∏ Bolt,7999,7999,-1663,-1663,980,0,0,3738968,True
M8uGTeI_RYoOD5dL,1630783286,Uklon,4121,4121,-9600,-9600,980,0,0,3740631,False,3TXH-H48M-1KE4-45MT
M8zjjr6-PLW_lm0X,1630780595,KapheNAUSHI1,5814,5814,-8500,-8500,980,0,0,3750231,False,TA8T-HP9X-K4AP-1E96
biiiPovlVGJElD5P,1630780565,KapheNAUSHI,5814,5814,-69400,-69400,980,0,0,3758731,False,4788-P30T-9AE4-37B7
w5PTyX4bJvbc0Xhj,1630775563,Bolt,4121,4121,-8500,-8500,980,0,0,3828131,False,51PX-7H6T-K60K-MT72
GHc9qHK5Ji4UT39r,1630772902,ZOOLYUKS,5995,5995,-45500,-45500,980,0,0,3836631,False,HMTB-PC06-MP02-8K52
ecSxGenR1PzdFOTJ,1630754197,Bolt,4121,4121,-11500,-11500,980,0,0,3882131,False,903X-862C-1ME8-C22E
jS7Rh8fJdu1TLKQH,1630736529,Bolt,4121,4121,-6100,-6100,980,0,0,3893631,False,C6K4-13CE-8KPK-PX8K
9j8cE_cezfiG8Gio,1630689012,Pirogitadruzi,5814,5814,-20000,-20000,980,0,0,3899731,False,PECH-35MP-9175-A532
ti5KOXXxxNshl03m,1630654449,–ï–∫–æ-–õ–∞–≤–∫–∞,5411,5499,-14100,-14100,980,0,0,3919731,False,X046-CMC1-5335-ATA2
-XHuPzKMfq39gq6m,1630653325,bwtc cafe&roasters,5814,5814,-3000,-3000,980,0,0,3933831,False,01E3-795M-C71H-CXC3
Zm4_4FX_aFzU6-9w,1630651068,Novapay,8999,8999,-4900,-4900,980,0,0,3936831,False,9M23-T068-AC9H-492P
25aJaKsN-lGjpDbN,1630622597,–ï–ª–µ–∫—Ç—Ä–æ—Å–∞–º–æ–∫–∞—Ç–∏ Bolt,7999,7999,-5000,-5000,980,0,0,3941731,False
bPxs23DYkOKf9O0a,1630622283,–ï–ª–µ–∫—Ç—Ä–æ—Å–∞–º–æ–∫–∞—Ç–∏ Bolt,7999,7999,-5000,-5000,980,0,0,3946731,False
kfx03svFMvineyzq,1630610570,–ê–Ω–¥—Ä—ñ–π –ö.,4829,4829,-6000,-6000,980,0,0,3951731,True,XE50-HM31-H906-PX5E
sCKg4kWS9qe29sMU,1630607798,BOLT.EU O 2109022136,4121,4121,-10100,-10100,980,0,0,3957731,False,M693-P1E1-807H-949C
uCLd3XP_iW0k_WEW,1630602900,FORGETMENOTCOFFEE2,5814,5814,-6000,-6000,980,0,0,3967831,False,M191-7480-12BE-M0P9
awEXZOryhMdR4nyq,1630602157,–°–∫–∞—Å—É–≤–∞–Ω–Ω—è. BOLT.EU O 2109021937,4121,4121,4200,9700,980,0,0,3973831,False
ACx5H990VX7moti_,1630601267,–§–∞—Ä–º–∞—Ü—ñ—è,5912,5912,-36680,-36680,980,0,0,3969631,False,B8C9-1T2E-HP53-3CTE
ofOVED5KwmZuLW_L,1630601090,WFP.UKLON.UA_,4121,4121,-7800,-7800,980,0,0,4006311,False,0X5P-H4K6-50CK-EP41
CM5HhHCZRMuyZ7Jz,1630600628,BOLT.EU O 2109021937,4121,4121,-9700,-9700,980,0,0,4014111,False
-DJgqsXZcBWMQXJm,1630600405,TITKA KLARA,5814,5814,-9500,-9500,980,0,0,4023811,False,K405-A1TH-758E-1TT6
7wzbd3L29Tc_KGnE,1630599301,MAGAZYN DAY AND DAY,5499,5499,-8770,-8770,980,0,0,4033311,False,PKMT-B7E6-B42E-BAAX
PeDUhf8y9trfMIQz,1630590675,Bolt,4121,4121,-13700,-13700,980,0,0,4042081,False,KT1E-H1X6-H05C-CM02
zmdNXObyDGWXpdE-,1630590541,Lesya,4829,4829,-2000000,-2000000,980,0,0,4055781,True,AC6E-334X-MP84-78CX
AlR6aKeqznZbHFYQ,1630587847,Bolt,4121,4121,-5600,-5600,980,0,0,6055781,False,HPE8-MB4K-8X31-MAA9
HOPrOfI6qzOhqsGw,1630586045,–°–∫–∞—Å—É–≤–∞–Ω–Ω—è. Bolt,4121,4121,8400,8400,980,0,0,6061381,False
p_WVuWKjUWhcRyAl,1630585983,Bolt,4121,4121,-9100,-9100,980,0,0,6052981,False,B324-CKM7-E20A-M2P4
k1jsfI09d4yY6NKE,1630583523,Bolt,4121,4121,-8400,-8400,980,0,0,6062081,False
r1evjm6h8Xc08Ya7,1630580563,Flowerbox,5992,5992,-16500,-16500,980,0,0,6070481,False,EX48-T66C-X6XB-A2X7
eH1pUT5l8f6Jd5q0,1630576089,–íi–¥: –ü–†–ò–•–û–î–¨–ö–û –ï.–í. –§–û–ü,4829,4829,4500000,4500000,980,0,0,6086981,True
CgCv85ZFzONypJ-U,1630566164,"Lifecell
+380631692598",4814,4814,-13000,-13000,980,0,0,1586981,True,56M2-582T-1575-A99H
fklBmfn_8JSRJZrT,1630518279,bwtc cafe&roasters,5814,5814,-30500,-30500,980,0,0,1599981,False,246T-7CX9-CC0M-T98K
kGVOD6hiFWLyMhHz,1630498237,–ï–ª–µ–∫—Ç—Ä–æ—Å–∞–º–æ–∫–∞—Ç–∏ Bolt,7999,7999,-1206,-1206,980,0,0,1630481,False,X50K-82AH-HABE-1A0P
QpWu8WT8XkeiJpQY,1630481656,–ï–ª–µ–∫—Ç—Ä–æ—Å–∞–º–æ–∫–∞—Ç–∏ Bolt,7999,7999,-1995,-1995,980,0,0,1631687,False,E4C9-1559-75K5-162P
q0GaD_oWLl0jZ6FL,1630453979,–í—ñ–¥—Å–æ—Ç–∫–∏ –∑–∞ —Å–µ—Ä–ø–µ–Ω—å,4829,4829,1897,1897,980,0,0,1633682,True
hq1izeCMJUjxAHpq,1635608344,Bolt,4121,4121,-6500,-6500,980,0,650,2510266,False,47E3-M9T1-X2C8-5X54
2iVF19zgImPSYUlY,1635607168,Bolt,4121,4121,-7800,-7800,980,0,780,2516766,False,34EM-7E77-2KE2-TP27
GNDGXvU3jIzXAocg,1635606600,KAFE NA UShi,5814,5814,-148900,-148900,980,0,0,2524566,False,K6TT-8C9H-TMP2-8470
T4uAQCxb4rAWKzjF,1635600774,–ï–ª–µ–∫—Ç—Ä–æ—Å–∞–º–æ–∫–∞—Ç–∏ Bolt,7999,7999,-1492,-1492,980,0,0,2673466,False,9MK6-5M6B-K7BP-4K22
Bcf9HlwzUaKqJYs1,1635527507,OK Wine,5411,5411,-129370,-129370,980,0,0,2674958,False,352X-BXPX-049M-HAMX
ALIDRSjI_Q2rwUsS,1635513260,–ü–∏—Ä—ñ–∂–∫–æ–≤–∞ ¬´–¢—ñ—Ç–∫–∞ –ö–ª–∞—Ä–∞¬ª,5814,5814,-8300,-8300,980,0,0,2804328,False,0095-533H-BPXC-5XB1
YHlDLr7An9WQomDO,1635513038,–ö–æ–ª–æ,5411,5499,-18150,-18150,980,0,0,2812628,False,61TK-B5H9-66AT-76TM
Dq22g6XjezR75rhv,1635505865,536354****0567,4829,4829,-800000,-800000,980,0,0,2830778,True,792H-PC68-3MBH-5303
_4ROP-dBiaEGsNrn,1635498619,Right Coffee Bar,5814,5814,-5500,-5500,980,0,0,3630778,False,X80B-56X7-50A8-T1XX
diO8olnyQgmDnM34,1635498130,Lesya,4829,4829,-500000,-500000,980,0,0,3636278,True,44C0-KP82-6HEC-3C15
la9staZihhHnROaQ,1635487853,–û–±—Å–ª—É–≥–æ–≤—É–≤–∞–Ω–Ω—è –ø–ª–∞—Ç–∏–Ω–æ–≤–æ—ó –∫–∞—Ä—Ç–∫–∏,4829,4829,-25000,-25000,980,0,0,4136278,True
0mX0T-UZmcu8Lsyo,1635454801,FDY*Food,5499,5499,-10000,-10000,980,0,0,4161278,False,7MBK-XTE7-PCPK-6142
ltJFAMrPsk1bvDel,1635454645,Who&Why. Drinkery,5814,5814,-100000,-100000,980,0,0,4171278,False,0HH0-EC9B-78A4-1EK3
OhoTfYikHKvbG-7O,1635442083,–°–∫–∞—Å—É–≤–∞–Ω–Ω—è. Bolt,4121,4121,500,7700,980,0,-50,4271278,False
lAdP2EC451lzHFZt,1635439544,Bolt,4121,4121,-7700,-7700,980,0,770,4270778,False
GOZRJT8SewrUAP74,1635437837,–°–∫–∞—Å—É–≤–∞–Ω–Ω—è. Bolt,4121,4121,500,10700,980,0,-50,4278478,False
f_FU9EpTJOQ03XMg,1635434824,Bolt,4121,4121,-10700,-10700,980,0,1070,4277978,False
LQW8AyIz2UKxNk34,1635428774,Bolt,4121,4121,-8800,-8800,980,0,880,4288678,False,TXT5-ME9K-6E57-E698
xxfvqBKI13iKddMi,1635423179,–°–∫–∞—Å—É–≤–∞–Ω–Ω—è. Bolt,4121,4121,8100,8100,980,0,-810,4297478,False
CPknxWAcnmoDHEHz,1635423036,Bolt,4121,4121,-8300,-8300,980,0,830,4289378,False,CBM0-A26H-TTHX-T738
INWA-PHf8OTAroM4,1635420784,Bolt,4121,4121,-8100,-8100,980,0,810,4297678,False
b5AGb-a61E0zEv9k,1635412787,–íi–¥: –ü–†–ò–•–û–î–¨–ö–û –ï.–í. –§–û–ü,4829,4829,2600000,2600000,980,0,0,4305778,True
jOAVurjtbKYMJBnj,1635404144,Bolt,4121,4121,-6300,-6300,980,0,63,1705778,False,8735-T854-4H08-KB77
v6XboRVOGR7gwDoP,1635395104,Bolt,4121,4121,-6900,-6900,980,0,69,1712078,False,EK87-7XK5-E8KB-9AP2
tg4M3VHljvsAwTCM,1635359663,MAGAZYN DAY AND DAY,5499,5499,-6200,-6200,980,0,0,1718978,False,2AC2-MM7B-0HAH-K700
5ylyUHmgCy2ckk3h,1635332922,–ï–ª–µ–∫—Ç—Ä–æ—Å–∞–º–æ–∫–∞—Ç–∏ Bolt,7999,7999,-1879,-1879,980,0,0,1725178,False,5A6A-7ECT-B14B-70PC
VNEpOY9xRWRriNeS,1635324875,MAGAZYNShop 146,5499,5499,-8250,-8250,980,0,0,1727057,False,A56B-K7A0-BB50-A1X4
DZ3aRREZdk58jUGJ,1635321134,"Lifecell
+380631692598",4814,4814,-15000,-15000,980,0,0,1735307,True,CBBE-7E50-A7M7-8K5K
hLneRNhvyD76LSfJ,1635319115,–°–∫–∞—Å—É–≤–∞–Ω–Ω—è. Bolt,4121,4121,4700,4700,980,0,-47,1750307,False
mu34Elt-DRRAUVgF,1635319061,Bolt,4121,4121,-6000,-6000,980,0,60,1745607,False,B4A3-81K8-4414-4H24
RNdVp7-ARpmTBwPX,1635318462,Bolt,4121,4121,-4700,-4700,980,0,47,1751607,False
AW_Nc5_MNnz24KoL,1635261432,–°–∫–∞—Å—É–≤–∞–Ω–Ω—è. Bolt,4121,4121,8200,8200,980,0,-82,1756307,False
1Dn4ImkpDzSWLYZ2,1635261374,Bolt,4121,4121,-8300,-8300,980,0,83,1748107,False,K7CM-X583-AX0A-24P4
UQGxGbdtrx_bJ-SS,1635259307,Bolt,4121,4121,-8200,-8200,980,0,82,1756407,False
my71xDkop8athRwd,1635248186,Bolt,4121,4121,-6300,-6300,980,0,63,1764607,False,H8H9-84K0-933X-76X0
a5h95cbglLjJvGQL,1635235563,–ê–ø—Ç–µ–∫–∞ –ê–ù–¶,5912,5912,-45690,-45690,980,0,0,1770907,False,309K-3TKT-801X-T5H2
5Fg5V4oDNRgVynj7,1635234448,bwtc cafe&roasters,5814,5814,-2700,-2700,980,0,0,1816597,False,PX7B-50BM-HTE6-69E8
lRLZw2b4f_MnlU0s,1635180790,Novus,5411,5411,-136112,-136112,980,0,0,1819297,False,C486-C711-AH9C-8XPM
5dD2ZvR3n5iNspCW,1635177446,MC UNIVER KLINIK,8062,8062,-110000,-110000,980,0,0,1955409,False,3A20-66P9-CTAK-B04X
e91RR9m5dFa-AS9s,1635172207,Novapay,8999,8999,-5300,-5300,980,0,0,2065409,False,34T2-6AP5-681P-KM7B
fyDefua2d9wJzaSj,1635171445,Bolt,4121,4121,-11900,-11900,980,0,1190,2070709,False,807E-P226-47BH-AX8X
q3lkXJG4kzy-Ecda,1635166456,Bolt,4121,4121,-5800,-5800,980,0,580,2082609,False,T2MX-8X91-7PB0-PAAM
I7BfSQNjd3mhvd9k,1635162715,Bolt,4121,4121,-6700,-6700,980,0,670,2088409,False,8TA6-3HB1-K4KB-8CHM
PSbrOSbGVO97nsm1,1635161957,Novapay,8999,8999,-4800,-4800,980,0,0,2095109,False,T9CB-8B36-BPA6-7A89
ULXAEuCwJvjhq3NE,1635159092,–°–∫–∞—Å—É–≤–∞–Ω–Ω—è. Bolt,4121,4121,5500,5500,980,0,-550,2099909,False
r7d21FSOcd98v0N3,1635159060,Bolt,4121,4121,-5500,-5500,980,0,550,2094409,False,BCC9-X4B5-KHBE-A89A
eATmkjVWIvTW96H3,1635158870,Bolt,4121,4121,-5500,-5500,980,0,550,2099909,False
8sm3xlEVydYNL665,1635151821,–°–∫–∞—Å—É–≤–∞–Ω–Ω—è. Bolt,4121,4121,5500,5500,980,0,-550,2105409,False
d0dImpxBNACtxMoj,1635151687,Bolt,4121,4121,-5900,-5900,980,0,590,2099909,False,T003-2X0T-4013-EPC3
0s3TBCvulv4MG8lQ,1635149965,Bolt,4121,4121,-5500,-5500,980,0,550,2105809,False
meu-1zTxOutxFgwV,1635097384,Bolt,4121,4121,-6200,-6200,980,0,620,2111309,False,9A69-5K59-18CH-59CB
3mmIL1fibe48gM7B,1635078874,Bolt,4121,4121,-12600,-12600,980,0,1260,2117509,False,005M-KKX1-9M08-722E
Mz7QHqhRZPJ9RBz_,1635076638,–°–∫–∞—Å—É–≤–∞–Ω–Ω—è. Bolt,4121,4121,10500,10500,980,0,-1050,2130109,False
elvhmep8YN3AhCgR,1635076583,Bolt,4121,4121,-10800,-10800,980,0,1080,2119609,False,8281-87B9-X8PA-8TMC
8Hl9qmO5QA5EUeNQ,1635073844,Bolt,4121,4121,-10500,-10500,980,0,1050,2130409,False
ubduXR5dfV71iE4_,1635072679,–õ—ñ–ª—ñ—è –ì.,–¢—Ä–µ–Ω—á –∫–∞–∫–∞–æ,4829,4829,-249000,-249000,980,0,0,2140909,True,KX7C-K97K-4C07-PMKE
LuobxSzcuod5wWhx,1635070950,–ú–æ–ª–æ–∫–æ –≤—ñ–¥ –§–µ—Ä–º–µ—Ä–∞,5451,5451,-14328,-14328,980,0,0,2389909,False,4M1M-AC9A-68AM-3EA1
4EMTKzU9aW5viR78,1635070056,Simona,5814,5814,-59000,-59000,980,0,0,2404237,False,B7M9-6744-2E7K-XXM9
D8uNq25HLrPHqhPm,1635026681,prom.ua,6012,6012,-57785,-57785,980,0,0,2463237,False,HP8K-4EM6-559H-AX1P
HA56QmUMMvHoaFmo,1635015797,–°–∫–∞—Å—É–≤–∞–Ω–Ω—è. Portmone,7399,7399,100,100,980,0,0,2521022,False
KXUPVTlNn3K9Jw8n,1635014235,Portmone,7399,7399,-100,-100,980,0,0,2520922,False
uDGbsaDsrcti0CZ4,1635011717,–ê–ø—Ç–µ–∫–∞ –ê–ù–¶,5912,5912,-17520,-17520,980,0,0,2521022,False,54PX-3HMC-MT9P-5109
Z7ER-BdfYilX1cxu,1635002549,MAMA-MANANA,5812,5812,-66000,-66000,980,0,0,2538542,False,KCB2-M949-61BM-TA2E
hBheBaw1GfvjNnz0,1635001100,–ï–∫–æ-–õ–∞–≤–∫–∞,5411,5499,-7540,-7540,980,0,0,2604542,False,AKXT-HC7E-KH7M-KXPM
xsUAL-gB1mUEA_jj,1635000841,OK Wine,5411,5411,-29200,-29200,980,0,0,2612082,False,94A1-KB68-7B7P-73T1
vkl1OqPZAO22riMC,1634991760,LIQPAY*FunKeys,5045,5045,-163000,-163000,980,0,0,2641282,False,AH21-290P-H7E0-1BXT
E5QEcbOb0j650YDe,1634986864,MAGAZYN DAY AND DAY,5499,5499,-25200,-25200,980,0,0,2804282,False,KXXX-38CM-4H20-0EB0
boQrBjktfwYph9K5,1634905313,Lesya,–§–æ—Ä –∫–ª–∞–≤–∏–∞—Ç—É—Ä–∫–∞ ‚å®Ô∏è,4829,4829,-400000,-400000,980,0,0,2829482,True,8028-0AE7-C698-8EHC
kFsdwDm9O9IY2KhV,1634897336,–ï–ª–µ–∫—Ç—Ä–æ—Å–∞–º–æ–∫–∞—Ç–∏ Bolt,7999,7999,-2208,-2208,980,0,0,3229482,False,T9T4-9E8M-B3XC-360E
DR8JO3mPmmiIpbqTnWE,1634856609,"–°–∫–∞—Å—É–≤–∞–Ω–Ω—è. MECHANICAL KEYBOARDS, 6152661420, US",5732,5732,308121,11729,840,0,0,3231690,False
jpdSE4W_6xH30k9a,1634855955,INDIEGOGO* PSYCHOLOG,5734,5734,-66174,-2500,840,0,0,2923569,False,K06A-1911-PE5K-9915
5ylyUHWsBiyakU3h,1634836609,MAGAZYN DAY AND DAY,5499,5499,-19800,-19800,980,0,0,2989743,False,MH1K-045K-AE0T-KPMX
62ADDZjw93bYOpUt,1634810774,–°–∫–∞—Å—É–≤–∞–Ω–Ω—è. Bolt,4121,4121,9300,9300,980,0,-930,3009543,False
iKLrH-1s74Kt_Q6u,1634810720,Bolt,4121,4121,-11500,-11500,980,0,1150,3000243,False,BKM8-BHKT-2XTC-CP3A
yJYO8i0KCeeCTHRu,1634808220,Bolt,4121,4121,-9300,-9300,980,0,930,3011743,False
xNrgxQ9m-o1LWnAb,1634803842,–°–∫–∞—Å—É–≤–∞–Ω–Ω—è. Bolt,4121,4121,8700,8700,980,0,-870,3021043,False
Prspxb_xqFW009Zg,1634803798,Bolt,4121,4121,-8800,-8800,980,0,880,3012343,False,345X-2700-19PM-AP20
8IHkchtmA_QtcCTe,1634801435,Bolt,4121,4121,-8700,-8700,980,0,870,3021143,False
jxAHGl3VA4WR9KsN,1634763743,–û–ª–µ–∫—Å–∞–Ω–¥—Ä–∞ –ë.,–ù–∞—Å—Ç–æ–π–∫–∏ üç∑,4829,4829,-34500,-34500,980,0,0,3029843,True,10XB-0134-B01X-KP1X
JdUnf1cmeot1OriS,1634728973,Bolt,4121,4121,-5200,-5200,980,0,520,3064343,False,54K5-T5E1-3PHE-5XM7
OT8aVkRoYyF0jGrc,1634727328,Kashtan,5814,5814,-30500,-30500,980,0,0,3069543,False,8MB5-P3AH-MAKB-9TE6
P_nBZ9hH_Cka9u5z,1634726912,KapheKometa,5814,5814,-32100,-32100,980,0,0,3100043,False,C3XB-EEM7-007C-BXH6
uoiYrr8At7LOmR4D,1634726906,KapheKometa,5814,5814,-15000,-15000,980,0,0,3132143,False,3PMK-093T-7TC2-20A9
4FqnvffSPZBpWSQk,1634721290,–°–∫–∞—Å—É–≤–∞–Ω–Ω—è. Bolt,4121,4121,5900,5900,980,0,-590,3147143,False
qSOl2-1-6eYi2ce4,1634721237,Bolt,4121,4121,-6500,-6500,980,0,650,3141243,False,KT6B-0AM1-1146-HCB8
EyDCBfWAWWr3zomn,1634719473,Bolt,4121,4121,-5900,-5900,980,0,590,3147743,False
lsGrXbbsu-YssqeX,1634715973,"–Ø—Ä–æ—Å–ª–∞–≤—ñ–≤ –í–∞–ª, 19",5499,5499,-20400,-20400,980,0,0,3153643,False,B08K-EK3P-X458-1TA6
dUzqAMIg7lMtKOfd,1634669805,SP * DROP.COM,5732,5732,-184930,-6997,840,0,0,3174043,False,KMTX-013T-KC65-T887
elxKhECxGPsMQxeb,1634669528,MECHANICAL KEYBOARDS,5732,5732,-309996,-11729,840,0,0,3358973,False
NvnrUGoG-J6lnTjw,1634649447,Bolt,4121,4121,-5700,-5700,980,0,570,3668969,False,3300-99B8-C78B-E2EK
-Jgka7Mx7sQ8QwX3,1634635806,–°–∫–∞—Å—É–≤–∞–Ω–Ω—è. Bolt,4121,4121,4700,4700,980,0,-470,3674669,False
ek3EiQQnxVsUzIsk,1634635750,Bolt,4121,4121,-5100,-5100,980,0,510,3669969,False,1H15-3TMX-XP80-PP27
zmnz1LhqTt8Bb4u3,1634634053,Bolt,4121,4121,-4700,-4700,980,0,470,3675069,False
UheVHgh2UX6HPimN,1634633953,Lesya,4829,4829,-1000000,-1000000,980,0,0,3679769,True,M7H4-BKP0-6TK5-C395
syqdMNA4YilsuKXN,1634632711,–ú—ñ—Å—å–∫–µ –∫–∞—Ñ–µ ¬´–•–∞—Ä–º—Å¬ª (–ö–Ω–∏–∂–∫–æ–≤–∞ –∫—Ä–∞–º–Ω–∏—Ü—è ¬´–•–∞—Ä–º—Å¬ª),5814,5814,-4560,-4560,980,0,0,4679769,False,2905-6T2B-KM7B-HC27
B5o5PXIFYMbQlIbg,1634576184,Lesya,4829,4829,-1000000,-1000000,980,0,0,4684329,True,78H6-4MCB-T02X-15C2
weIVw1otHT53eXSX,1634573915,536354****0567,4829,4829,-1000000,-1000000,980,0,0,5684329,True,EHA8-47P3-1720-89ET
XKfC4jYJ8m9HG1Wl,1634551591,–íi–¥: –ü–†–ò–•–û–î–¨–ö–û –ï.–í. –§–û–ü,4829,4829,5100000,5100000,980,0,0,6684329,True
zNYlqLtKzu4UdNs0,1634491234,Produkti,5499,5499,-10500,-10500,980,0,0,1584329,False,A2BB-7AXK-46CH-B188
ctsqbIE4rQbXo1Zq,1634488405,Bolt,4121,4121,-6800,-6800,980,0,68,1594829,False,44M7-0H2X-T3CB-62CT
LE3sBURzlKNqOTDF,1634476599,Bolt,4121,4121,-7500,-7500,980,0,75,1601629,False,P2TB-69KC-07E5-2K1X
abz0ViWSTss_vZsH,1634472264,–ê–ø—Ç–µ–∫–∞ ¬´–ë—ñ–ª–∞ –†–û–ú–ê–®–ö–ê¬ª,5912,5912,-18435,-18435,980,0,0,1609129,False,MK7P-PT72-9AXP-0E0X
a5BC0raZ4hGIyW8F,1634471978,–ú–µ–≥–∞–º–∞—Ä–∫–µ—Ç,5399,5411,-34000,-34000,980,0,0,1627564,False,ACC7-1938-TT70-XPT0
uN4ewcr2Ma4vLsw7,1634471794,–ú–µ–≥–∞–º–∞—Ä–∫–µ—Ç,5399,5411,-135600,-135600,980,0,0,1661564,False,A746-B1K4-9M2M-B4KB
JkQnlFuyI7AIemlB,1634470950,Bolt,4121,4121,-7600,-7600,980,0,76,1797164,False,8E6P-695B-AT54-7AA5
egD1OcOqMJBH6DD1,1634468949,Bolt,4121,4121,-6100,-6100,980,0,61,1804764,False,77H9-3TH9-C956-KB8M
dghDLvUsKb9LL2WV,1634468853,mats,5814,5814,-14600,-14600,980,0,0,1810864,False,8EE1-X909-P7AA-HH8H
QajPil_O41K-yvrN,1634460065,–ó–æ–æ–ª—é–∫—Å –≤–µ—Ç. –∫–ª–∏–Ω–∏–∫–∞,742,742,-22000,-22000,980,0,220,1825464,False,75AM-T71P-XM3K-4124
JuIFC_NJH1GEH17x,1634407534,magazin 726008,5912,5912,-60430,-60430,980,0,0,1847464,False,3710-0AX7-KEKT-PKX8
dsSdj8x93Sf77mK_,1634407244,–°—ñ–ª—å–ø–æ,5411,5411,-27398,-27398,980,0,0,1907894,False,A3BM-TPTC-0B56-1T0K
O8hQdX1YMHyuiOiu,1634394720,Yaroslaviv Val 37-1,5499,5499,-17600,-17600,980,0,0,1935292,False,AT94-5P53-9TCK-KHXA
O5KdEJad_w7wtRIO,1634393742,KAFE KONDiTERSKA KhANI,5814,5814,-44600,-44600,980,0,0,1952892,False,A0KA-9P97-78X9-6880
zGAYmdTFn4BBiCJn,1634387016,MAGAZYN DAY AND DAY,5499,5499,-13600,-13600,980,0,0,1997492,False,P2PB-9EH7-TB2H-35B8
AM-9ZEwG1tOfvtI8,1634386443,Bolt,4121,4121,-8300,-8300,980,0,830,2011092,False,9KHA-278M-TE03-K5HB
TdBQP8XpA41Sl4ek,1634379838,Bolt,4121,4121,-6600,-6600,980,0,660,2019392,False,0MX2-MA0K-0418-TCCC
be7Ofoa0bzVON5VQ,1634299200,–û–ª–µ—Å—è –°.,4829,4829,-450000,-450000,980,0,0,2025992,True,9HXB-341C-879P-B12C
pCIj7gCA9SSp-3y8,1634296109,–ï–ª–µ–∫—Ç—Ä–æ—Å–∞–º–æ–∫–∞—Ç–∏ Bolt,7999,7999,-1658,-1658,980,0,0,2475992,False,2X8X-629C-BP6M-A6H0
I9QzzBBgz0NPluj6,1634228813,–°—ñ–ª—å–ø–æ,5411,5411,-116221,-116221,980,0,0,2477650,False,H83T-3M52-20T2-979C
XfdJ7PLHoVl5o5T0,1634227000,–ê–ø—Ç–µ–∫–∞ –ê–ù–¶,5912,5912,-10110,-10110,980,0,0,2593871,False,C6B3-8CE0-BMTE-78MX
MC0mcccQllHPRMru,1634206405,Bolt,4121,4121,-7700,-7700,980,0,770,2603981,False,7XK6-64C9-KX0B-TMP5
Qt9gT4rVTWBhgByQ,1634143483,MAGAZYN DAY AND DAY,5499,5499,-32100,-32100,980,0,0,2611681,False,1996-BB6P-K121-C3H3
NytoKNBIc_ZDAk2H,1634139874,Prostor,5977,5977,-4776,-4776,980,0,0,2643781,False,P42H-86M7-2726-C72P
OltfYdXGADFW5X99,1634130610,–í—ñ–¥: –ú–∞–∫—Å–∏–º –§–µ—â–µ–Ω–∫–æ,4829,4829,22000,22000,980,0,0,2648557,True
v4kw88tCxDwnr89i,1634130594,–•–º—ñ–ª—å–Ω–∏–π –ö–Ω—è–∑—å,5812,5812,-28000,-28000,980,0,0,2626557,False,6848-C488-MKPT-C8TK
Xl7EbiWa90Ro664r,1634130572,–•–º—ñ–ª—å–Ω–∏–π –ö–Ω—è–∑—å,5812,5812,-16000,-16000,980,0,0,2654557,False,7MK9-35KK-4988-MA1C
r2L8yAXNJfnceduQ,1634123664,Bolt,4121,4121,-7900,-7900,980,0,790,2670557,False,541X-HHB7-T05C-TB85
4AGFdPe6CF1kmT0v,1634121329,Lesya,4829,4829,-1600000,-1600000,980,0,0,2678457,True,78PM-E29X-6979-7T85
eSwDAcuZdHqOJTrL,1634121264,–íi–¥: –ü–†–ò–•–û–î–¨–ö–û –ï.–í. –§–û–ü,4829,4829,2100000,2100000,980,0,0,4278457,True
LjofUbiFr3M7qUs9,1634117080,"–Ø—Ä–æ—Å–ª–∞–≤—ñ–≤ –í–∞–ª, 19",5499,5499,-20400,-20400,980,0,0,2178457,False,9659-CM74-AX4X-XX14
v4QKzJwgR7dftZoZ,1634052189,Bolt,4121,4121,-9900,-9900,980,0,990,2198857,False,0X71-T53B-2X2H-T331
L3LuWR2Ocxzsz3Tp,1634038443,Bolt,4121,4121,-9700,-9700,980,0,970,2208757,False,3100-4340-XHCE-A684
FAtVHJsOHu6Zut3H,1634028298,Bolt,4121,4121,-9800,-9800,980,0,980,2218457,False,4032-53BK-C73T-MA9A
i3nsfoQqggh9BqB8,1634023308,Bolt,4121,4121,-7400,-7400,980,0,740,2228257,False,KP31-0741-21A7-4HH3
NSCwRahwsM7n5JMx,1634021303,–ö–æ–ª–æ,5411,5499,-6800,-6800,980,0,0,2235657,False,8XHH-14HP-HM2T-1MEM
VlnmPdbbyNlskI0j,1633979859,Steam,5816,5816,-18100,-18100,980,0,0,2242457,False,K83X-MM2M-BKXB-AX25
-l1yCARTPjwEliZk,1633942003,Bolt,4121,4121,-7600,-7600,980,0,0,2260557,False,15H9-XAM2-BP80-E29H
dnBw41svktGUwN67,1633936496,–°–∫–∞—Å—É–≤–∞–Ω–Ω—è. Bolt,4121,4121,11000,11000,980,0,0,2268157,False
bP5P4MD7Fv5qy_hX,1633936433,Bolt,4121,4121,-11300,-11300,980,0,0,2257157,False,E011-4KA8-56AA-1T95
FGDtmbgDVw_w03Nd,1633934471,Bolt,4121,4121,-11000,-11000,980,0,0,2268457,False
xn5GsO56J9kIEpjQ,1633885290,bwtc cafe&roasters,5814,5814,-4000,-4000,980,0,0,2279457,False,EC07-EKP7-P6E1-M509
WaXicVd1--WQF2Bl,1633883139,mats,5814,5814,-46800,-46800,980,0,0,2283457,False,0XBT-17BB-HB88-K013
zREsuhhNTeWz5boI,1633861375,Kitaika,5812,5812,-59000,-59000,980,0,0,2330257,False,PM8M-MA60-5480-K33K
p8eCp3SB1RzuchwV,1633858410,Bolt,4121,4121,-9800,-9800,980,0,0,2389257,False,7MP1-8BMA-B4E0-HCK7
0nBKbITEmxGT7F9P,1633851230,Bolt,4121,4121,-9800,-9800,980,0,0,2399057,False,5CP3-0APH-B85P-5P06
MRyHyLriPA6MHV1-,1633793375,Bolt,4121,4121,-8400,-8400,980,0,0,2408857,False,9X3M-0197-PT07-P90B
nPvtQWASilq8Ul5t,1633792941,OK Wine,5411,5411,-84710,-84710,980,0,0,2417257,False,P899-1A48-1B7P-8KMX
M7zAcb8bBiWXpi6_,1633792240,Yaroslaviv Val 37-1,5499,5499,-31900,-31900,980,0,0,2501967,False,BCX8-CXK3-A2EE-07TX
2mEqEFzr_gBZcAKH,1633791793,Novus,5411,5411,-20399,-20399,980,0,0,2533867,False,X6T5-8T2M-2B2M-K366
htjKiPpsy_IjIoE1,1633791664,Novus,5411,5411,-8360,-8360,980,0,0,2554266,False,P9B0-PT1M-B613-CA6H
DI-IO6HITrRgKcSG,1633779419,Bolt,4121,4121,-7900,-7900,980,0,0,2562626,False,XX5M-XECC-5H43-64HM
ehJxvFcd_aDn66OB,1633768834,Bolt,4121,4121,-7900,-7900,980,0,0,2570526,False,7713-3P2B-AP4B-6BM5
G7T6MaEtuFgxCwX5,1633766377,bwtc cafe&roasters,5814,5814,-11900,-11900,980,0,0,2578426,False,P775-XHK4-E30P-3241
aH2t71eZarBGCCOw,1633763114,Bolt,4121,4121,-7600,-7600,980,0,0,2590326,False,AM55-7BME-35AE-8MEA
cn5HafFfGxt_3eWX,1633715857,Konteyer,5814,5814,-20000,-20000,980,0,0,2597926,False,KX2X-E8PX-HCC9-3625
g2KErnEpuaicytCS,1633692868,Bolt,4121,4121,-8100,-8100,980,0,0,2617926,False,732C-AM39-3621-KH1K
hiS3UE2CwOvqBM-N,1633692120,Ramen Vs Marketing,5812,5812,-20000,-20000,980,0,0,2626026,False,AB82-PBE0-61M3-7BH9
naRpiRs644eFdw2g,1633689941,–°–∫–∞—Å—É–≤–∞–Ω–Ω—è. Bolt,4121,4121,6700,6700,980,0,0,2646026,False
QSvALI7ESgBpl0qx,1633689889,Bolt,4121,4121,-6800,-6800,980,0,0,2639326,False,2H7P-6MC9-A742-5MX6
DjsMf0q09uCsKtX7,1633687677,Bolt,4121,4121,-6700,-6700,980,0,0,2646126,False
51ujEJmpgPMqPJtM,1633687650,–°–∫–∞—Å—É–≤–∞–Ω–Ω—è. Bolt,4121,4121,6700,6700,980,0,0,2652826,False
ehGzcZqFMCRNJmWC,1633687568,Bolt,4121,4121,-6700,-6700,980,0,0,2646126,False
C-Rhlm3IfgMEWIBs,1633669232,Bolt,4121,4121,-6100,-6100,980,0,0,2652826,False,MM74-CX8B-88CK-BE7A
DoXfotSzwfMx1QdK,1633622544,Beer Market,5921,5921,-25949,-25949,980,0,0,2658926,False,M32M-KC08-T97T-9EBE
Um5ySnWwewHZY5cz,1633611556,Lesya,4829,4829,-500000,-500000,980,0,0,2684875,True,M16P-MMC7-KP3A-88PP
5EW1BfoT0GTFBjSf,1633604606,–°—Ç–µ–π–∫—Ö–∞—É—Å,5814,5814,-15500,-15500,980,0,0,3184875,False,T5P4-T3BC-5700-9HTX
L4KPkHHrG0l-qwfz,1633603742,–°–∫–∞—Å—É–≤–∞–Ω–Ω—è. Bolt,4121,4121,9100,9100,980,0,0,3200375,False
pzrXHZc8HHXJWBg9,1633603652,Bolt,4121,4121,-9300,-9300,980,0,0,3191275,False,PT7P-9AXC-860X-80H5
ac8-rhGFblK290OY,1633600849,Bolt,4121,4121,-9100,-9100,980,0,0,3200575,False
A3FLmY3iZzzRAVlY,1633598239,Bolt,4121,4121,-6900,-6900,980,0,0,3209675,False,B075-KH9X-48P0-134K
h_HoIHn-noKPt-qp,1633590127,MAGAZYN DAY AND DAY,5499,5499,-7350,-7350,980,0,0,3216575,False,CKK8-H0BH-BK6T-3EAP
3bfVkkzH-EqDm-ai,1633531328,bwtc cafe&roasters,5814,5814,-10000,-10000,980,0,0,3223925,False,B125-514C-9AXM-A7B6
-L9W-dXx0HdjDZUt,1633530841,MAGAZYN DAY AND DAY,5499,5499,-20400,-20400,980,0,0,3233925,False,3KX7-85CC-M446-TT29
3zm4rD_FrbX8laog,1633510748,Bolt,4121,4121,-10900,-10900,980,0,0,3254325,False,3AXP-278H-KEKA-CKX4
9HKeiXuEGwdRlnhj,1633505517,–°–∫–∞—Å—É–≤–∞–Ω–Ω—è. Bolt,4121,4121,11000,11000,980,0,0,3265225,False
bD6Ouw1txiOid--7,1633505448,Bolt,4121,4121,-11500,-11500,980,0,0,3254225,False,17KE-6T86-E1KH-3HM3
EPQsN6KZOq-FN-lF,1633503077,Bolt,4121,4121,-11000,-11000,980,0,0,3265725,False
Fn4DRC-Ntxi9emXp,1633502407,MAGAZYN DAY AND DAY,5499,5499,-18000,-18000,980,0,0,3276725,False,673C-594X-4TC3-33KM
VeNNwnBhbDn799DA,1633447801,Lesya,4829,4829,-500000,-500000,980,0,0,3294725,True,X88C-46M8-KT6B-A579
cTCr2p0FC6F4z0Kg,1633433731,Bolt,4121,4121,-8600,-8600,980,0,0,3794725,False,AT6K-52XM-321B-BXBB
Tgp7BY84YWxn6Yf2,1633422823,–íi–¥: –ü–†–ò–•–û–î–¨–ö–û –ï.–í. –§–û–ü,4829,4829,1800000,1800000,980,0,0,3803325,True
EtAmyO2UvtU0i27f,1633420178,Lesya,4829,4829,-400000,-400000,980,0,0,2003325,True,XM87-2098-994A-86X1
cVZnJQaD-61yO8hi,1633363570,Bolt,4121,4121,-11400,-11400,980,0,0,2403325,False,9A65-KMM7-A78A-93HB
9JrBWsagnsbBrCkb,1633357601,Lesya,4829,4829,-1700000,-1700000,980,0,0,2414725,True,TK8H-HK98-KXCT-TE5X
lgAgvUjmO19JhY3h,1633335945,Lesya,4829,4829,-3000000,-3000000,980,0,0,4114725,True,HX43-6HE7-7691-2BKM
IWBYWorvfJYuHe9G,1633335905,–íi–¥: –ü–†–ò–•–û–î–¨–ö–û –ï.–í. –§–û–ü,4829,4829,5300000,5300000,980,0,0,7114725,True
pHUL4jLtazSuxzhU,1633285448,MAGAZYN DAY AND DAY,5499,5499,-34350,-34350,980,0,0,1814725,False,XB18-9461-9B82-EAAM
JNQDmBJ0NRfzxemJ,1633239913,–°–∫–∞—Å—É–≤–∞–Ω–Ω—è. Bolt,4121,4121,6100,6100,980,0,0,1849075,False
G-cfSfV9zCkhalK2,1633239849,Bolt,4121,4121,-6600,-6600,980,0,0,1842975,False,0P1B-0A40-PX7C-74KB
nWQiNVZR6CHw1yQ5,1633238218,Bolt,4121,4121,-6100,-6100,980,0,0,1849575,False
HUuopmiaCosgOmf0,1633200169,–ê–ø—Ç–µ–∫–∞ –î–æ–±—Ä–æ–≥–æ –î–Ω—è,5912,5912,-95130,-95130,980,0,0,1855675,False,CB1C-2X0T-3597-H48H
p2QwOPzm4TtPoAqF,1633198910,OldBricks,5814,5814,-45400,-45400,980,0,0,1950805,False,3T98-30PK-A9C5-B72X
C-hGhJZEziWzYt5t,1633184974,DelviMag146,5499,5499,-20400,-20400,980,0,0,1996205,False,3835-TEBM-6X9T-K83E
1Vm8i2DWMK-BrdDU,1633177755,–í–æ–ª–æ–¥–∏–º–∏—Ä –û.,4829,4829,-120000,-120000,980,0,0,2016605,True,EK44-9KAM-6T98-7T2P
HLTaj20m8RMynojC,1633151187,Bolt,4121,4121,-5500,-5500,980,0,0,2136605,False,XMH3-6HCE-054E-5908
s7JytZmbMXL_TpXe,1633095017,MAGAZYN DAY AND DAY,5499,5499,-12700,-12700,980,0,0,2142105,False,XCKC-C8A5-KTBT-XPPK
5CEReQfrZyANhYVV,1633086573,MAGAZYN DAY AND DAY,5499,5499,-7900,-7900,980,0,0,2154805,False,B922-593A-CX1H-EEH8
lFJXpEqL_loSD-VY,1633077845,–ï–ª–µ–∫—Ç—Ä–æ—Å–∞–º–æ–∫–∞—Ç–∏ Bolt,7999,7999,-6650,-6650,980,0,0,2162705,False,BTHC-K4EX-BEEA-H97H
eLrijA0we70Lynx3,1633072730,MAGAZYNShop 146,5499,5499,-8220,-8220,980,0,0,2169355,False,2MPP-H4A1-C449-13T5
Nev2Ssc8KXtiQWV9,1633070037,–û–ª—å–≥–∞ –ë.,4829,4829,-31500,-31500,980,0,0,2177575,True,27CA-0XT9-H57M-CPA9
E_T6szFyLCgc2bon,1633048422,–í—ñ–¥—Å–æ—Ç–∫–∏ –∑–∞ –≤–µ—Ä–µ—Å–µ–Ω—å,4829,4829,2522,2522,980,0,0,2209075,True
ZOd4OO6rULRDqUvw,1638204888,Bolt,4121,4121,-8900,-8900,980,0,0,1276787,False,C001-5P9P-A5P3-A544
1TW-A5MPiWIAcP4A,1638196078,MAGAZYN DAY AND DAY,5499,5499,-16800,-16800,980,0,168,1285687,False,A2K7-430C-HHE0-3MAB
mOzcgA5oFhRbTIPf,1638195525,MONOPITSA,5814,5814,-17900,-17900,980,0,179,1302487,False,7415-7BE2-6803-513E
EzzuVnYpxCZIax-3,1638194857,–°–∫–∞—Å—É–≤–∞–Ω–Ω—è. Bolt,4121,4121,10500,10500,980,0,0,1320387,False
jibY5lyoldJAzK-N,1638194757,Bolt,4121,4121,-10600,-10600,980,0,0,1309887,False,P118-K1CP-1APA-MMA6
QhitsCEallzP_t-a,1638192930,Bolt,4121,4121,-10500,-10500,980,0,0,1320487,False
HanjTyWspAH2yNfY,1638192317,Uklon,4121,4121,-9000,-9000,980,0,0,1330987,False,2ATC-3A7P-481K-A1KM
5VwWFQFXdEOXdcsR,1638192244,Uklon,4121,4121,-1100,-1100,980,0,0,1339987,False,9XAX-PPEP-HA0M-028K
_jHWiHa_pM2PtV3z,1638189959,Uklon,4121,4121,-7800,-7800,980,0,0,1341087,False,T657-55ME-T347-E9E2
DTZPcAZJ95zJ9C0v,1638186987,–ö–∏—ó–≤—Å—å–∫–µ –º–µ—Ç—Ä–æ,4111,4111,-800,-800,980,0,0,1348887,False,1110-C319-ET4B-51M4
GXV435V9JMB76SwN,1638183939,Bolt,4121,4121,-7700,-7700,980,0,0,1349687,False,463P-EC0B-20K5-EAK0
QSCPEq19spyYRMdx,1638183857,MAGAZYN DAY AND DAY,5499,5499,-13600,-13600,980,0,136,1357387,False,2TKM-C211-K2XC-3662
HW_IKYd_txmeuYnm,1638169899,–û–±—Å–ª—É–≥–æ–≤—É–≤–∞–Ω–Ω—è –ø–ª–∞—Ç–∏–Ω–æ–≤–æ—ó –∫–∞—Ä—Ç–∫–∏,4829,4829,-25000,-25000,980,0,0,1370987,True
RCqZq77KzN8BvNed,1638135024,Bolt,4121,4121,-7900,-7900,980,0,0,1395987,False,TM02-CKXP-M70X-9PA4
DESdtC0xbZfCZ0et,1638118348,Bolt,4121,4121,-5200,-5200,980,0,0,1403887,False,T66T-8M94-3AC7-3042
phl4BL4yXGlXivOr,1638028313,Bolt,4121,4121,-15500,-15500,980,0,0,1409087,False,MCM8-A1T2-8MX6-E7EA
v4Hyz2uBQ2Jw8CJg,1638027821,MAGAZYN LIBRARIUM,5943,5943,-14630,-14630,980,0,0,1424587,False,1H0A-7CET-KAP7-B2EK
hu6SuRRRGGSygPen,1638026907,IKEA,5200,5200,-37600,-37600,980,0,0,1439217,False,9HKM-74AM-58C2-AXA2
GJO-OSIrHxbV4je8,1638023053,–°–∫–∞—Å—É–≤–∞–Ω–Ω—è. Bolt,4121,4121,14000,14000,980,0,0,1476817,False
nKFW6pPaPXTOph2k,1638022828,Bolt,4121,4121,-18700,-18700,980,0,0,1462817,False,2BT8-XTPP-561T-16KP
K0oyt8S4EAZuHNDj,1638020558,Bolt,4121,4121,-14000,-14000,980,0,0,1481517,False
7JM9SK6G-BLipM74,1638004820,Liki24,5912,5912,-134865,-134865,980,0,0,1495517,False,69P5-9995-0AM7-H671
koECbRWCcqgDRMMQ,1637945526,Bolt Food,4215,4215,-38000,-38000,980,0,0,1630382,False,9BBP-TX27-B65A-TBH2
KsqN3KgvpIYl-4w-,1637945089,Beer Market,5921,5921,-18600,-18600,980,0,186,1668382,False,P53T-6T26-27TX-MMTT
BCE25nMfrzcXJenZ,1637944425,IDEALIST COFFEE CO,5814,5814,-8900,-8900,980,0,89,1686982,False,HX43-A7AX-2HEH-T079
LbZSZRoo4ps7tS99,1637944298,IDEALIST COFFEE CO,5814,5814,-21200,-21200,980,0,212,1695882,False,591C-9K24-6HAA-3AE5
SdYu2I9fVMXOJuzp,1637920119,Ponchyk Boy,5812,5812,-16301,-16301,980,0,163,1717082,True,CCE4-7802-HC65-7T3P
20r74NGH3LkqVL8U,1637917147,MAGAZYN DAY AND DAY,5499,5499,-15800,-15800,980,0,158,1733383,False,5T39-K6TB-EBE6-217A
jRyHHPn3uZTDDRUh,1637875505,Steam,5816,5816,-5900,-5900,980,0,0,1749183,False,XETX-813P-A0PM-K69M
DWZhbbcFH44O7Agu,1637865656,Simona,5814,5814,-10500,-10500,980,0,105,1755083,False,AA9M-K6EP-0093-8BAK
UC0wBWqil8JoEPiR,1637865590,–ü–∏—Ä—ñ–∂–∫–æ–≤–∞ ¬´–¢—ñ—Ç–∫–∞ –ö–ª–∞—Ä–∞¬ª,5814,5814,-12200,-12200,980,0,122,1765583,False,X6H7-6H5C-X24T-100P
NUbWijD34rrZXLNR,1637848831,–ü–∏—Ä—ñ–∂–∫–æ–≤–∞ ¬´–¢—ñ—Ç–∫–∞ –ö–ª–∞—Ä–∞¬ª,5814,5814,-15700,-15700,980,0,157,1777783,False,KAMH-H37C-C315-A04B
rds_3nU_w55AA_oU,1637848591,–ê–ø—Ç–µ–∫–∞ –ê–ù–¶,5912,5912,-22690,-22690,980,0,0,1793483,False,9158-388T-0AAB-1M49
_HyEdhChyIX2odkI,1637848375,–ö–æ–ª–æ,5411,5499,-19900,-19900,980,0,199,1816173,False,7T6K-0H0X-2E27-T878
ZHGIC-YrmeicTRy2,1637839894,Bolt,4121,4121,-9900,-9900,980,0,0,1836073,False,H61H-91XK-2EBM-H878
EnmjfH-IsUa6nlyY,1637836789,Bolt,4121,4121,-10000,-10000,980,0,0,1845973,False,BBP2-94M9-385B-53A9
Mmj9qmnOnuMs0-vq,1637744792,"Lifecell
+380631692598",4814,4814,-15000,-15000,980,0,0,1855973,True,HBHX-X684-E73M-733K
uabmGqbs2eaFIO5F,1637688837,Beer Market,5921,5921,-31799,-31799,980,0,317,1870973,False,11K6-299K-9B9B-0E22
_9VidMiBix2oN4ud,1637688476,Right Coffee Bar,5814,5814,-16200,-16200,980,0,162,1902772,False,M8E2-8698-H548-01M4
oKTJF0KgGYKDK_ex,1637656050,–ö–æ–ª–æ,5411,5499,-45450,-45450,980,0,454,1918972,False,MPME-P248-A050-HBE5
z0aevDOemJlfrcul,1637584971,–ö–æ–ª–æ,5411,5499,-23700,-23700,980,0,237,1964422,False,97K3-2XK4-4359-2TPE
6N266GrAcOarzAwK,1637496965,–°—ñ–ª—å–ø–æ,5411,5411,-98616,-98616,980,0,1853,1988122,False,79P0-AM14-1T6M-X1HB
gv62J4WiobIzTeyl,1637495481,magazin 726008,5912,5912,-20220,-20220,980,0,0,2086738,False,P8M0-064K-C731-M540
u2W3BY4xv5KDjCmQ,1637440351,–ö–æ–ª–æ,5411,5499,-3300,-3300,980,0,66,2106958,False,A705-H3TB-0B52-BBKE
aNv0hIr-InAaCh4x,1637440099,MAGAZYN DAY AND DAY,5499,5499,-23200,-23200,980,0,464,2110258,False,1AHE-2B18-1HB0-277C
zuFNMbetxBRb9udc,1637428661,–°–∫–∞—Å—É–≤–∞–Ω–Ω—è. Bolt,4121,4121,23700,23700,980,0,0,2133458,False
DIShmhpPLB8EU-Rv,1637428595,Bolt,4121,4121,-26200,-26200,980,0,0,2109758,False,X6CB-1P6K-5HX9-C7TP
sX2Aq7V4EIJogHc_,1637424687,Bolt,4121,4121,-23700,-23700,980,0,0,2135958,False
SMj7wjRg-zua2C7u,1637402297,Bolt,4121,4121,-12600,-12600,980,0,0,2159658,False,1T79-A27M-H880-864K
w7YkbCokN12hwieB,1637399828,Lesya,4829,4829,-400000,-400000,980,0,0,2172258,True,C74A-8TB6-4597-A5AA
miJuQ-RCZYNECfhF,1637398702,Bolt,4121,4121,-10500,-10500,980,0,0,2572258,False,P001-T9PX-1662-86E4
wp94AYx1O6je_tkU,1637336271,Bolt,4121,4121,-15000,-15000,980,0,0,2582758,False,H710-C7XP-7X1A-P669
p5zdA15MlV92QQmb,1637329836,Bolt,4121,4121,-10200,-10200,980,0,0,2597758,False,30B2-8815-825C-96P9
nRHXLl7SMGX443Dw,1637323175,MAGAZYN DAY AND DAY,5499,5499,-20400,-20400,980,0,408,2607958,False,1MKB-KKE5-A4A5-96AT
IminYdO14VI_NBoK,1637235053,Lesya,4829,4829,-700000,-700000,980,0,0,2628358,True,19X5-63EB-82X8-E3TT
5ewMVKoDVQXvjjNI,1637228905,–íi–¥: –ü–†–ò–•–û–î–¨–ö–û –ï.–í. –§–û–ü,4829,4829,1300000,1300000,980,0,0,3328358,True
GwoSd2z-BGFxXbHY,1637158444,MAGAZYN DAY AND DAY,5499,5499,-20400,-20400,980,0,408,2028358,False,89ME-MC11-E009-MKH9
1m-3J5kAkJnMfmfp,1637158038,Bolt,4121,4121,-8500,-8500,980,0,0,2048758,False,7H5K-H93C-2E36-AK3K
d-L0sACZL51UKPSy,1637155694,–ï–ª–µ–∫—Ç—Ä–æ—Å–∞–º–æ–∫–∞—Ç–∏ Bolt,7999,7999,-1546,-1546,980,0,0,2057258,False,A4KA-7859-AT3A-ME0E
WewT5anOmgRBItqp,1637150403,Bolt,4121,4121,-5500,-5500,980,0,0,2058804,False,BH67-A38C-CXKK-KAPA
OKwM_9ALirbAE0sv,1637150055,–°–∫–∞—Å—É–≤–∞–Ω–Ω—è. Bolt,4121,4121,8100,8100,980,0,0,2064304,False
HGLM-RYnYbdwBDv7,1637149969,Bolt,4121,4121,-8300,-8300,980,0,0,2056204,False,54AM-31X0-34EM-ETK3
BTd_eYoaG3F9sgFL,1637147322,Bolt,4121,4121,-8100,-8100,980,0,0,2064504,False
dyZ0PQB86SEBROuW,1637144589,–°–∫–∞—Å—É–≤–∞–Ω–Ω—è. Bolt,4121,4121,8700,8700,980,0,0,2072604,False
bnpBQT-xU71Ev-5r,1637144500,Bolt,4121,4121,-9500,-9500,980,0,0,2063904,False,2M6E-9BHE-868X-H5K2
2vLvnAUVh_0Tk0s6,1637141783,Bolt,4121,4121,-8700,-8700,980,0,0,2073404,False
x2VCUmGC8hgwTN7o,1637073581,Bolt,4121,4121,-9500,-9500,980,0,0,2082104,False,8P06-EXB0-XE82-24TM
ToGUtOi9SuwIFsBV,1637066366,Bolt,4121,4121,-7200,-7200,980,0,0,2091604,False,M3P3-80H7-X8BA-P6X3
SG81ls3ul09Viqyr,1637013875,Bolt,4121,4121,-13300,-13300,980,0,0,2098804,False,7E59-H4PA-6392-PPKX
MCDILx4yrZkh8hBK,1637006137,–ö—ñ–Ω–æ–º–∞—Ä–∫–µ—Ç –ü–ª–∞–Ω–µ—Ç–∞ –ö—ñ–Ω–æ,5812,5812,-29600,-29600,980,0,888,2112104,False,410P-9H8E-1MH4-6XCX
Ja8KuweD_gi4oxaG,1637003720,Bolt,4121,4121,-23000,-23000,980,0,0,2141704,False,A9KM-2MB7-5590-94AX
uiaNCUuapvEqo3gn,1636999628,MAGAZYN DAY AND DAY,5499,5499,-26450,-26450,980,0,529,2164704,False,M0CB-A064-TKCA-71CK
pLMyr2G-nA3JEC8a,1636993039,–°–∫–∞—Å—É–≤–∞–Ω–Ω—è. Bolt,4121,4121,7700,7700,980,0,0,2191154,False
jCUz6P56HlqaDBLX,1636992568,Bolt,4121,4121,-8700,-8700,980,0,0,2183454,False,95MX-KEEC-06A5-EP23
OfVqL8af03MkiaKz,1636992009,–°–∫–∞—Å—É–≤–∞–Ω–Ω—è. Bolt,4121,4121,8300,8300,980,0,0,2192154,False
w2IzNDjkzZ9V5yx4,1636991981,Bolt,4121,4121,-7700,-7700,980,0,0,2183854,False
vfvCcoqS30ivL_CJ,1636991956,Bolt,4121,4121,-9100,-9100,980,0,0,2191554,False,4E3H-BPE5-6MAT-E393
8OznmPxw3j5779ct,1636990155,Bolt,4121,4121,-8300,-8300,980,0,0,2200654,False
35eX5jkaYdRpe-N6,1636978925,Bolt,4121,4121,-5500,-5500,980,0,0,2208954,False,CXAK-8832-9060-A349
omginPfvOHZYMy8X,1636975775,Bolt,4121,4121,-7300,-7300,980,0,0,2214454,False,P8XB-X6TA-C62C-BX1C
JDHf_6fp0SRzLQth,1636965969,Bolt,4121,4121,-6900,-6900,980,0,0,2221754,False,48EC-B468-1280-7EKM
7xrjVKmUULK4uBoD,1636925851,–ü–ª–∞–Ω–µ—Ç–∞ –ö—ñ–Ω–æ,7832,7832,-36000,-36000,980,0,0,2228654,False,1C75-0HHB-H2CM-M7ET
7k-nQIEPOeikIcwl,1636906189,–ú–æ–ª–æ–∫–æ –≤—ñ–¥ –§–µ—Ä–º–µ—Ä–∞,5451,5451,-17419,-17419,980,0,348,2264654,False,7M17-B3CX-PAM8-3E3T
xfTehL9C2ZAVMi1q,1636906001,Beer Market,5921,5921,-33800,-33800,980,0,676,2282073,False,4MX8-C0T0-C661-4AEA
juEJ-JhuVdI40fCv,1636905780,–ê–ø—Ç–µ–∫–∞ –ê–ù–¶,5912,5912,-5920,-5920,980,0,0,2315873,False,HEBE-X5KE-MTBT-6AE2
INq4mSKT-EKvFz-C,1636905269,Bolt,4121,4121,-12100,-12100,980,0,0,2321793,False,HK1C-CPPC-B9EK-23EA
-namQxfsMjm7w21I,1636892668,Bolt,4121,4121,-8500,-8500,980,0,0,2333893,False,056A-H624-MA57-53M7
0H-RHcHI5vvODJO-,1636891502,Lesya,4829,4829,-500000,-500000,980,0,0,2342393,True,KB71-9A1E-A182-E5CB
0HbuWG54OSXzWAJg,1636890253,Bolt,4121,4121,-9400,-9400,980,0,0,2842393,False,02E3-C3P7-7X74-579H
_bGtG3eiEEy70R9m,1636794830,bwtc cafe&roasters,5814,5814,-16500,-16500,980,0,495,2851793,False,173P-KM59-4AA2-1XT1
v-s5BCrIzjB0RpGo,1636746152,OK Wine,5411,5411,-116000,-116000,980,0,2320,2868293,False,CHTE-MMM1-6T5K-E4X5
84Mx-gXRJe7GWLRe,1636745176,IDEALIST COFFEE CO,5814,5814,-8300,-8300,980,0,249,2984293,False,7A24-X311-5C76-663H
PtVhlIV1bDXS5lUh,1636733514,–°–∫–∞—Å—É–≤–∞–Ω–Ω—è. Bolt,4121,4121,14400,14400,980,0,0,2992593,False
APFzutM1KRtnM00V,1636733140,Bolt,4121,4121,-16500,-16500,980,0,0,2978193,False,M1MX-577X-1AKM-CP01
_GnAz49pV5Pgwb66,1636729356,Bolt,4121,4121,-14400,-14400,980,0,0,2994693,False
9kfTBlGxCreqQyfl,1636722252,Lesya,4829,4829,-700000,-700000,980,0,0,3009093,True,2MCK-6H8E-9HMH-B3X0
j9aU--P564TFCZu_,1636721962,Lesya,4829,4829,-2000000,-2000000,980,0,0,3709093,True,9C4C-HM76-3CMK-MP65
57CcjhvmDULZ3g8r,1636710519,–íi–¥: –ü–†–ò–•–û–î–¨–ö–û –ï.–í. –§–û–ü,4829,4829,5000000,5000000,980,0,0,5709093,True
ZxR77ySZ_4ZPHHcx,1636706358,MAGAZYN DAY AND DAY,5499,5499,-30450,-30450,980,0,304,709093,False,1MX6-A7C0-B91E-TC1K
KY-G1UOYmpo9NlOh,1636662225,IDEALIST COFFEE CO,5814,5814,-14800,-14800,980,0,148,739543,False,X727-M64A-B4A5-T976
FelXdhUBdoPEiff2,1636660535,Kometa,5814,5814,-3000,-3000,980,0,30,754343,False,5540-1X8K-8B92-TXE2
KinZ2egFFEPO6M8q,1636660508,Kometa,5814,5814,-28500,-28500,980,0,285,757343,False,751X-0E45-1P22-CPK0
c8_bGvATHlFRA0AY,1636657855,–¶–∏–ø–∞ Craft Pub,5814,5814,-15400,-15400,980,0,154,785843,False,80TP-M6CP-C217-X36E
D2hZRJKXVLEHn-jH,1636630564,Bolt,4121,4121,-8600,-8600,980,0,0,801243,False,TMX2-TMA3-1H8X-347P
GodY25bybYzTTCv8,1636630505,–°–∫–∞—Å—É–≤–∞–Ω–Ω—è. Bolt,4121,4121,8800,8800,980,0,0,809843,False
FUZ721CVXsqOOp4g,1636630225,Bolt,4121,4121,-8800,-8800,980,0,0,801043,False
9kSs256hDgyS0YQ1,1636619804,Bolt,4121,4121,-7600,-7600,980,0,0,809843,False,K900-20AM-8926-K7P1
4CJOLH9WH5XRYOjp,1636585081,–°–∫–∞—Å—É–≤–∞–Ω–Ω—è. Bolt,4121,4121,12000,12000,980,0,0,817443,False
73PMkZMhaALSs_hE,1636585029,Bolt,4121,4121,-13400,-13400,980,0,0,805443,False,3A51-9HPX-AMXH-926C
RnqrcJim6Lcg9Zt7,1636581978,Bolt,4121,4121,-12000,-12000,980,0,0,818843,False
U_06GYcGvWphi8yR,1636570828,–°–∫–∞—Å—É–≤–∞–Ω–Ω—è. Bolt,4121,4121,25300,25300,980,0,0,830843,False
2zw465xmsqYE_qc2,1636569941,Bolt,4121,4121,-25500,-25500,980,0,0,805543,False,HHA6-HEEH-4XT5-436E
GdXgY1M-o4rswQSz,1636565713,Bolt,4121,4121,-25300,-25300,980,0,0,831043,False
YoYj92s5THYhiaK_,1636558453,Bolt,4121,4121,-5400,-5400,980,0,0,856343,False,9M6H-48H7-XC11-X72H
JMfjlopwETXMDQUM,1636555308,Bolt,4121,4121,-5000,-5000,980,0,0,861743,False,20PE-MM39-CM1A-TE54
EDzFhfYVDCoZNjMf,1636480771,FDY*Food,5499,5499,-64000,-64000,980,0,640,866743,False,55AX-XTP3-86E4-KX97
DWJwhUmTQntfhbrf,1636477426,Bolt,4121,4121,-7700,-7700,980,0,0,930743,False,74E3-T4CP-C369-475C
9FldYqvQP8XkErEZ,1636476838,–°–∫–∞—Å—É–≤–∞–Ω–Ω—è. Passport Control,4111,4111,100,100,980,0,0,938443,False
CrTn8hV1ogpR8nFF,1636476830,Passport Control,4111,4111,-100,-100,980,0,0,938343,False
8JFApYWn-BG6B30c,1636464451,R100 RELAY,5309,5309,-22845,-750,978,0,0,938443,False,1PHM-4HMB-TPKM-M36E
tpvehNGvzALlk8fE,1636455977,FARINI VENEZIA,5812,5812,-30460,-1000,978,0,304,961288,False,8C6M-5M14-HTEB-P468
0iqG5jHnfLjfPHMi,1636395511,HOTEL AI REALI,7011,7011,-82214,-2700,978,0,0,991748,False,3BC7-B16K-8X7P-90KT
FxEeMEykePkM_4bY,1636381896,AMICI SAS DI ABDALLA .,5814,5814,-18270,-600,978,0,182,1073962,False,7C9T-K223-6H6E-15H7
vhmH3tIlTmCyoaXa,1636367410,OSTERIA DAL RICCIO PEO,5812,5812,-47197,-1550,978,0,471,1092232,False,4K17-8C40-7XT9-7225
a2GHXKv-aNDOtIep,1636321845,OSTERIA ALLA BOTTE RIS,5812,5812,-252571,-8300,978,0,2525,1139429,False,T54C-5BET-KA27-0872
lUOfSSBqYHJRUNqW,1636301638,I TRE MERCANTI SRL,5499,5499,-12172,-400,978,0,121,1392000,False,8B83-E241-B2X9-AT88
GCpxsErzdz1D5khH,1636287796,FONDAZIONE GUGGENHEIM,7999,7999,-91291,-3000,978,0,0,1404172,False,B4X7-CE0P-TE2X-H02K
a8NUwuDpGBFLY_Cf,1636219470,OSTERIA DAL RICCIO PEO,5812,5812,-28909,-950,978,0,289,1495463,False,EHK9-9AMP-CB61-554A
SRaeqP4XroSO9Wx7,1636217347,AE SCONTE RISTORANTE O,5812,5812,-197797,-6500,978,0,1977,1524372,False,62A2-PA8X-T387-30CT
Vwzl7Mfnioc8Lqxd,1636203910,ANTICO GATOETO,5812,5812,-136936,-4500,978,0,1369,1722169,False,MP1H-HM4C-9CH7-EBX5
vKBsBygQ_CwgkP7_,1636192644,OSTERIA DAL RICCIO PEO,5812,5812,-15215,-500,978,0,152,1859105,False,KB20-2A9C-7XAX-E5B2
ojRQoVUeONMwRDNj,1636140186,FARINI,5462,5462,-39255,-1290,978,0,392,1874320,False,9AE8-8H6H-AE9T-A92K
vK9t0icinzKfAEIU,1636139477,SUPERMERCATO COOP VE S,5411,5411,-16980,-558,978,0,169,1913575,False,H2K3-MEM4-H507-624C
XRYT74fg2AWbRroa,1636138452,OSTERIA LA PATATINA SA,5812,5812,-130850,-4300,978,0,2536,1930555,False,2K53-HB59-PKXX-C145
err6R8R0PhN9uM5H,1636133268,OSTERIA BANCOGIRO SRL,5812,5812,-33473,-1100,978,0,1004,2061405,False,104P-M110-4B42-2B38
YZzbdf1I7-TgxYQ-,1636128372,TaDa,5812,5812,-72120,-2370,978,0,2163,2094878,False,0633-KM26-P78C-438C
zu0vcyGrKWEF9pqk,1636102734,–°–∫–∞—Å—É–≤–∞–Ω–Ω—è. –ú–µ–∂–¥—É–Ω–∞—Ä–æ–¥–Ω—ã–π –∞—ç—Ä–æ–ø–æ—Ä—Ç ¬´–ë–æ—Ä–∏—Å–ø–æ–ª—å¬ª (KBP) (–ú—ñ–∂–Ω–∞—Ä–æ–¥–Ω–∏–π –∞–µ—Ä–æ–ø–æ—Ä—Ç ¬´–ë–æ—Ä–∏—Å–ø—ñ–ª—å¬ª),4111,4111,100,100,980,0,0,2166998,False
0WyjfMi1hq9vynwZ,1636102719,–ú–µ–∂–¥—É–Ω–∞—Ä–æ–¥–Ω—ã–π –∞—ç—Ä–æ–ø–æ—Ä—Ç ¬´–ë–æ—Ä–∏—Å–ø–æ–ª—å¬ª (KBP) (–ú—ñ–∂–Ω–∞—Ä–æ–¥–Ω–∏–π –∞–µ—Ä–æ–ø–æ—Ä—Ç ¬´–ë–æ—Ä–∏—Å–ø—ñ–ª—å¬ª),4111,4111,-100,-100,980,0,0,2166898,False
RogrBFB3aDbfdCYH,1636102144,–°–∫–∞—Å—É–≤–∞–Ω–Ω—è. Passport Control,4111,4111,100,100,980,0,0,2166998,False
5n2qJpNFPWfdQXvu,1636102139,Passport Control,4111,4111,-100,-100,980,0,0,2166898,False
TBo3w29Rd4lP4Y_q,1636097772,–°–∫–∞—Å—É–≤–∞–Ω–Ω—è. Bolt,4121,4121,3400,3400,980,0,0,2166998,False
n6JFalVGy5688ygL,1636097725,Bolt,4121,4121,-4100,-4100,980,0,0,2163598,False,1232-E6H6-B3XK-B8P6
B35f3fallz3ZahZ7,1636095040,Bolt,4121,4121,-3400,-3400,980,0,0,2167698,False
wly52r3OkIYwHs8p,1636055947,–ö–æ–ª–æ,5411,5499,-16750,-16750,980,0,335,2171098,False,37T5-7B66-H9E1-2P0A
pfWIqpX-YX9AU896,1636041472,–ö–æ–ª–æ,5411,5499,-34000,-34000,980,0,680,2187848,False,6E2T-2HMK-22H8-411C
QKejIoQlf6b70R-E,1636041442,–ö–æ–ª–æ,5411,5499,-34000,-34000,980,0,680,2221848,False,B81B-ETTE-4T7C-T8T2
hzoSegY0zJF3wgXs,1636022572,–°–∫–∞—Å—É–≤–∞–Ω–Ω—è. Bolt,4121,4121,9100,9100,980,0,0,2255848,False
cBN3PBnEtvei-xoo,1636022503,Bolt,4121,4121,-9200,-9200,980,0,0,2246748,False,EAX0-A7B9-1H0B-47KK
HlwRfgiMGKs3NhSx,1636020193,Bolt,4121,4121,-9100,-9100,980,0,0,2255948,False
GqSyrUfWom0541Gu,1635946334,"–Ø—Ä–æ—Å–ª–∞–≤—ñ–≤ –í–∞–ª, 19",5499,5499,-16400,-16400,980,0,328,2265048,False,74A2-A520-55H7-3EHA
zPAWcLcgQ3eCjgFX,1635937592,–ù–æ–≤–∞ –ø–æ—à—Ç–∞,7399,7399,-26300,-26300,980,0,0,2281448,False,0XX0-7447-9TMH-3464
IYWZ2ONPGesE4Yov,1635863777,Bolt,4121,4121,-9000,-9000,980,0,0,2307748,False,6996-8251-ATHP-1X15
UODeqNIlxGDgW-pn,1635856736,Bolt,4121,4121,-9300,-9300,980,0,0,2316748,False,3X6T-H321-M2PH-49PA
jJr5ff8IHsBiEg-C,1635851544,–ï–ª–µ–∫—Ç—Ä–æ—Å–∞–º–æ–∫–∞—Ç–∏ Bolt,7999,7999,-1859,-1859,980,0,0,2326048,False,13CE-C775-18X4-CHT0
LbZSZx0h4Zw8siN8,1635851320,–°–∫–∞—Å—É–≤–∞–Ω–Ω—è. Bolt,4121,4121,5000,5000,980,0,0,2327907,False
4z8mYyltuLyu5ROP,1635851258,Bolt,4121,4121,-6200,-6200,980,0,0,2322907,False,8CA8-64H9-79B0-31H8
FTGXe3KLDZy-zmkl,1635848706,Bolt,4121,4121,-5000,-5000,980,0,0,2329107,False
eY5NZ20J_sSFl2iM,1635843688,MAGAZYN DAY AND DAY,5499,5499,-21550,-21550,980,0,0,2334107,False,7K8H-5853-K21C-XCP3
0KmkIH_B-9zxCbRu,1635836023,–°–∫–∞—Å—É–≤–∞–Ω–Ω—è. Bolt,4121,4121,4700,4700,980,0,0,2355657,False
Vq_wpg_jfUh7fPLZ,1635835967,Bolt,4121,4121,-5300,-5300,980,0,0,2350957,False,97A7-19H5-M8M5-A246
RX4MPf75nyIh8cui,1635833891,Bolt,4121,4121,-4700,-4700,980,0,0,2356257,False
EyJjFfRZRXUWfpLd,1635764085,516933****7163,4829,4829,-100000,-100000,980,0,0,2360957,True,21PM-2AX3-E5EH-EH13
WJdNr-OTcoBBxt5B,1635761274,Bolt,4121,4121,-9900,-9900,980,0,0,2460957,False,T2HB-M59P-CEXA-27EB
fjkzpOdO-heQ3mZb,1635755904,Bolt,4121,4121,-7400,-7400,980,0,0,2470857,False,XX7K-5P60-5ATX-B6C9
VHNlzM4vWDTL6wRS,1635735424,–°–∫–∞—Å—É–≤–∞–Ω–Ω—è. Bolt,4121,4121,8100,8100,980,0,0,2478257,False
m4_oirSrz5Wvpyd_,1635735376,Bolt,4121,4121,-8200,-8200,980,0,0,2470157,False,T78M-40H4-C42A-KHCE
93G9xbrt92p9q_6X,1635733149,Bolt,4121,4121,-8100,-8100,980,0,0,2478357,False
NAMBiGneNhPUHMtd,1635727878,–í—ñ–¥—Å–æ—Ç–∫–∏ –∑–∞ –∂–æ–≤—Ç–µ–Ω—å,4829,4829,1191,1191,980,0,0,2486457,True
LIvec5shpcw6vBqk,1635723401,Portmone,7399,7399,-25000,-25000,980,0,0,2485266,False,AK62-5P1A-E36K-733H
cbDBlSiM-LT9BLUs,1640869464,MAGAZYN DAY AND DAY,5499,5499,-23400,-23400,980,0,0,2927066,False,7B60-036H-P97T-XHB0
2V7xG_tYBasPNAAE,1640865114,Lesya,4829,4829,-3000000,-3000000,980,0,0,2950466,True,H8MA-BK64-ET85-PT9X
3ZZdVpazlzTSqMu_,1640864945,–î–º–∏—Ç—Ä–æ –†.,–°–≤–µ—Ç.,4829,4829,-40000,-40000,980,0,0,5950466,True,EH1X-ACAX-0HM8-H12A
JFWYZe2WmoXz9Pgw,1640859688,–íi–¥: –ü–†–ò–•–û–î–¨–ö–û –ï.–í. –§–û–ü,4829,4829,4900000,4900000,980,0,0,5990466,True
LR7FE9Cobq7UODvX,1640857245,Bolt,4121,4121,-11900,-11900,980,0,89,1090466,False,65X5-AC21-64PC-4H58
Z0z-Xmy14d0bQM6t,1640845793,Bolt,4121,4121,-10100,-10100,980,0,75,1102366,False,9B77-94MX-0A15-9X06
FpLnyL9mv3TRktJ5,1640802165,Bolt,4121,4121,-7600,-7600,980,0,57,1112466,False,6986-2H73-5TC6-A083
sNNDY2_TpEOTA834,1640793717,WFP.AQUAMARKET_,5411,5411,-65740,-65740,980,0,0,1120066,False,9XB3-3TA6-4E7K-298X
-_--qMEbYIytwiDv,1640783415,–ù–æ–≤–∞ –ø–æ—à—Ç–∞,7399,7399,-27200,-27200,980,0,0,1185806,False,2M04-PC82-MAT6-8PA9
Xafwe76F7yx6tjR1,1640782490,–ö–æ–ª–æ,5411,5499,-15450,-15450,980,0,0,1213006,False,EHHA-2296-8XB2-9C16
Tvm16Ppq6C8bNyaG,1640761866,–û–±—Å–ª—É–≥–æ–≤—É–≤–∞–Ω–Ω—è –ø–ª–∞—Ç–∏–Ω–æ–≤–æ—ó –∫–∞—Ä—Ç–∫–∏,4829,4829,-25000,-25000,980,0,0,1228456,True
gvu8aNLh4JYfoLAG,1640698391,–°–∫–∞—Å—É–≤–∞–Ω–Ω—è. Bolt,4121,4121,600,10800,980,0,-4,1253456,False
ZcbLRdFxZmFlLCA8,1640694548,Bolt,4121,4121,-10800,-10800,980,0,81,1252856,False
FT2YrEXhwrpu0AMW,1640627759,Bolt,4121,4121,-10300,-10300,980,0,77,1263656,False,9TXC-40BE-BHC1-0X7X
_B_nAKIXpjTqqtLy,1640627506,Epik Retrovile,5945,5945,-49986,-49986,980,0,0,1273956,False,6E98-B505-142C-89TC
40inZT_zwtCO8wOh,1640626359,–°–∫–∞—Å—É–≤–∞–Ω–Ω—è. Bolt,4121,4121,10900,10900,980,0,-81,1323942,False
O7T7Ui5boo-g3q7U,1640625871,Bolt,4121,4121,-11000,-11000,980,0,82,1313042,False,H699-1X54-PKA2-KC61
vvCxEPZP41e7kkGq,1640625314,TehnoEzh,4812,4812,-132500,-132500,980,0,0,1324042,False,85AK-6C9E-9354-9TKA
pyBTT-F1tnmjEf9L,1640623332,Bolt,4121,4121,-10900,-10900,980,0,81,1456542,False
s457KxxIdgzIbkMH,1640528190,MAGAZYN DAY AND DAY,5499,5499,-5579,-5579,980,0,0,1467442,False,2646-K0X4-19CM-EXE7
tmHfKBqWEKrwqcRX,1640518112,bwtc cafe&roasters,5814,5814,-9000,-9000,980,0,0,1473021,False,E6T5-EP8T-91HA-9M5M
-uxxoxVaZnrnHWg4,1640516080,bwtc cafe&roasters,5814,5814,-11500,-11500,980,0,0,1482021,False,3K4A-2489-H504-T8TM
yZNmLkrYw7bLUSRj,1640514733,–°—ñ–ª—å–ø–æ,5411,5411,-236596,-236596,980,0,0,1493521,False,P868-4PEB-KAKP-K3H3
ldlS8pTmiAyUcOQy,1640514569,–°—ñ–ª—å–ø–æ,5411,5411,-18900,-18900,980,0,0,1730117,False,2K7P-M8EP-9TT7-BAX0
OvrMm_5q7inCxFY4,1640452823,Bolt,4121,4121,-9300,-9300,980,0,69,1749017,False,0K97-4MTH-X44A-P7T0
OfVqK8CZ03MigKyz,1640450462,Diletant,5814,5814,-11000,-11000,980,0,0,1758317,False,BB5P-BB2X-0PC9-AE4E
sA9VpP7RYvJWER2q,1640440786,–°–∫–∞—Å—É–≤–∞–Ω–Ω—è. Bolt,4121,4121,4400,4400,980,0,-33,1769317,False
vtHZrJqwtUQd7ivK,1640440727,Bolt,4121,4121,-4500,-4500,980,0,33,1764917,False,063T-89PM-CEK3-TCAB
zqS9hIa8EcCcyWFI,1640438747,Bolt,4121,4121,-4400,-4400,980,0,33,1769417,False
QkL7BqgOzEG9M9VS,1640428845,OK Wine,5411,5411,-55970,-55970,980,0,0,1773817,False,2581-MH65-4HE0-4108
O1EpYp5Gedya3cyi,1640428215,Bolt Food,4215,4215,-45500,-45500,980,0,0,1829787,False,7158-4KTP-5T5B-P3AX
_xSimbrCCXZQhVkz,1640341782,"–Ø—Ä–æ—Å–ª–∞–≤—ñ–≤ –í–∞–ª, 19",5499,5499,-20400,-20400,980,0,0,1875287,False,2XBB-9K38-1MT7-H0A3
8yAHbP3lxIcL-1rO,1640341039,Produkti,5499,5499,-14700,-14700,980,0,0,1895687,False,E5M7-C2K3-EA61-35A1
1-_ZL1YAUlO7khUH,1640337832,Internetmagazin,5399,5399,-32100,-32100,980,0,0,1910387,False,4781-0A61-PA7C-2KA2
0qwL00lVUakOuRCO,1640255527,–°–∫–∞—Å—É–≤–∞–Ω–Ω—è. Bolt,4121,4121,5500,5500,980,0,-41,1942487,False
43FKe_m84Otl1AbH,1640255469,Bolt,4121,4121,-5600,-5600,980,0,42,1936987,False,B981-ET1A-70BC-03HB
A00Ku_PJKvNLQsL9,1640253875,Bolt,4121,4121,-5500,-5500,980,0,41,1942587,False
E3vIm5yb16b2j5XK,1640245539,Bolt,4121,4121,-20900,-20900,980,0,156,1948087,False,56BT-02KP-HMX6-9CTA
Ps6QieNbJ-QXACGp,1640243913,–°–∫–∞—Å—É–≤–∞–Ω–Ω—è. Bolt,4121,4121,17900,17900,980,0,-134,1968987,False
Qz33c0EvX08hL7-G,1640243855,Bolt,4121,4121,-19200,-19200,980,0,144,1951087,False,XKEK-MH9P-X790-14B1
6K-5WrdxMRptFvoX,1640240815,Bolt,4121,4121,-17900,-17900,980,0,134,1970287,False
hJ0yVPuuG5Akj4ox,1640172252,MAGAZYN DAY AND DAY,5499,5499,-23850,-23850,980,0,0,1988187,False,56AH-XHH9-0X6B-X337
yikThcIDYYx3mkJA,1640102870,Lesya,4829,4829,-350000,-350000,980,0,0,2012037,True,KB1K-CHM2-PMTP-5H2C
8vOU2T3UfXFAmtHT,1640095042,Kitaika,5812,5812,-57000,-57000,980,0,0,2362037,False,0BM3-CPBC-K0K8-PAP1
LYInjr9GFLxu9tJy,1640094065,MAGAZYN DAY AND DAY,5499,5499,-2050,-2050,980,0,0,2419037,False,EK3T-M79E-MXT1-8MTX
F1XFUmbNfIFLrcK1,1640073148,–ê–ø—Ç–µ–∫–∞ –ê–ù–¶,5912,5912,-11870,-11870,980,0,0,2421087,False,M8TT-36XP-HPCB-4XC4
yu0vaXMdYIS0S50X,1640026660,MAGAZYN DAY AND DAY,5499,5499,-13600,-13600,980,0,0,2432957,False,33P2-HBM5-73BK-T1HE
5Y6EJk1TbGKPbj1a,1640002868,Lesya,4829,4829,-1000000,-1000000,980,0,0,2446557,True,4CB1-EXC6-KH06-5ETP
ue5aRaVrg_6K7SpY,1640002053,–íi–¥: –ü–†–ò–•–û–î–¨–ö–û –ï.–í. –§–û–ü,4829,4829,1500000,1500000,980,0,0,3446557,True
HsrRd-naLvNPIFqd,1639993112,"Lifecell
+380631692598",4814,4814,-15000,-15000,980,0,0,1946557,True,A4X2-HB95-62T0-PX92
4b-aT8Gyf9OzUZSu,1639909781,MAGAZYN DAY AND DAY,5499,5499,-28600,-28600,980,0,0,1961557,False,T06M-44XT-EMX3-7025
ft96TH2JmrsDwEt7,1639909372,–ï–∫–æ-–õ–∞–≤–∫–∞,5411,5499,-76550,-76550,980,0,0,1990157,False,4K7X-40H4-2X6P-MA0E
gdRjAzRFj28eDNCC,1639886801,–°–∫–∞—Å—É–≤–∞–Ω–Ω—è. Bolt,4121,4121,15600,15600,980,0,-1170,2066707,False
iBVofJ3YvBSyM3Vx,1639886739,Bolt,4121,4121,-15800,-15800,980,0,1185,2051107,False,75H6-E1CK-H2HM-AK1C
oWy2xOYMcHMP-8Tl,1639863177,Bolt,4121,4121,-15600,-15600,980,0,1170,2066907,False
xm01fEqH65m9IxiQ,1639842225,Master Zoo,5995,5995,-59300,-59300,980,0,8895,2082507,False,P2HE-X14B-5X9K-M264
Kei5M8lsU-lBRB0f,1639841470,Bolt,4121,4121,-15000,-15000,980,0,1125,2141807,False,90BK-H942-B320-K57X
QYCnNQd19wwAvgJT,1639841074,Novapay,8999,8999,-4600,-4600,980,0,0,2156807,False,0EM3-TXB3-2T40-8538
N7rRlwBcNkK-ExRz,1639840996,Novapay,8999,8999,-4100,-4100,980,0,0,2161407,False,PC8H-0832-A20P-87HP
_kwkKpAsvNziz9L0,1639840763,Lesya,4829,4829,-500000,-500000,980,0,0,2165507,True,ETHT-H772-HEH3-85PH
oeK5-NiRaPQFs-Hp,1639831917,Bolt Food,4215,4215,-554,-554,980,0,0,2665507,False,9940-MK32-47C9-2545
J_xBoLsFnzsTfXiP,1639831769,Novus,5411,5411,-16400,-16400,980,0,0,2666061,False,ACP8-2HE5-PTP4-56M2
Sktxv7udls2OKTpO,1639827409,–°–∫–∞—Å—É–≤–∞–Ω–Ω—è. Bolt,4121,4121,7200,7200,980,0,-540,2682461,False
hOyYgon_YhwFKUq4,1639827337,Bolt,4121,4121,-7200,-7200,980,0,540,2675261,False
a8NUxuPpHBFLZPWe,1639821276,MC UNIVER KLINIK,8062,8062,-210000,-210000,980,0,0,2682461,False,E7P5-1HEX-PBAT-587X
V9Yv-Sc9Oic7pKmB,1639779014,–ú–∞–∫—Å–∏–º –ú.,üçï,4829,4829,-10000,-10000,980,0,0,2892461,True,TAKM-KC92-032C-E9K5
xq9RldQht_4TBIUw,1639765785,Novus,5411,5411,-38283,-38283,980,0,0,2902461,False,T5T5-M7PX-P22H-44H6
CjZIkHyKDCZj4Qnn,1639744428,OTHER SHOPS,5999,5999,-44700,-44700,980,0,0,2940744,False,8TX9-2K9A-9C61-E775
Hbu3N4KNJO2uTbOP,1639725840,–ö–æ–ª–æ,5411,5499,-27150,-27150,980,0,0,2985444,False,PKB2-3X48-E028-A42K
GPgPCcK1naj4kOf9,1639659144,–°–∫–∞—Å—É–≤–∞–Ω–Ω—è. Bolt,4121,4121,8100,8100,980,0,-607,3012594,False
chbx7MJNcn4gmPGv,1639659078,Bolt,4121,4121,-10100,-10100,980,0,757,3004494,False,188M-35CT-M18P-1807
gxD9xMzz5gUiGfeQ,1639656874,–°–∫–∞—Å—É–≤–∞–Ω–Ω—è. Bolt,4121,4121,14300,14300,980,0,-1072,3014594,False
VDVzzyk31hJjmp4J,1639656720,Bolt,4121,4121,-15000,-15000,980,0,1125,3000294,False,50HP-H645-TPM5-A46P
UYxQyDMDPhz11-iR,1639653930,Bolt,4121,4121,-8100,-8100,980,0,607,3015294,False
amAf30UyBblnMEZb,1639651343,Bolt,4121,4121,-14300,-14300,980,0,1072,3023394,False
QSCPFKl8vJGeScx7,1639639522,–°–∫–∞—Å—É–≤–∞–Ω–Ω—è. Bolt,4121,4121,11500,11500,980,0,-862,3037694,False
x0OnIRuCa11OLVmw,1639639459,Bolt,4121,4121,-11600,-11600,980,0,870,3026194,False,ABA6-BTMP-2P0M-8CKK
uk2GyC55LmuL40FZ,1639637423,–ö–æ–ª–æ,5411,5499,-16950,-16950,980,0,0,3037794,False,HM4A-5XCK-CH9A-AKTH
2vaMaUaV4WZAMzdT,1639636647,Bolt,4121,4121,-11500,-11500,980,0,862,3054744,False
axpHq5EhrIY1hO6c,1639589564,–°–∫–∞—Å—É–≤–∞–Ω–Ω—è. Bolt,4121,4121,12800,12800,980,0,-960,3066244,False
oO2uIbUDLjCuNZCT,1639589031,Bolt,4121,4121,-10600,-10600,980,0,795,3053444,False,HC4H-6M45-490T-5EH9
635VcXbo-2n1H6fw,1639588748,Bolt,4121,4121,-13100,-13100,980,0,982,3064044,False,T1CM-THK0-K571-3MK3
8buaw9vAoprEBDra,1639586015,Bolt,4121,4121,-12800,-12800,980,0,960,3077144,False
ABiIQ-9sd0Sx4bdu,1639574146,Bolt,4121,4121,-6700,-6700,980,0,502,3089944,False,X806-B93E-TTCX-239E
DMpzZjVgg5z_N7dt,1639566784,Lesya,4829,4829,-700000,-700000,980,0,0,3096644,True,X4H0-T49X-CP27-TP7H
BjMH_t3kb1v4cSYR,1639510167,–°—ñ–ª—å–ø–æ,5411,5411,-126835,-126835,980,0,0,3796644,False,P17H-59TB-0032-T995
VI5bXgi1F0uSv-57,1639493278,LIQPAY*iWorld,5732,5732,-83200,-83200,980,0,0,3923479,False,603C-C2X4-0AT0-4C18
p9HzgeWGonGVpIK9,1639491462,–°–∫–∞—Å—É–≤–∞–Ω–Ω—è. Bolt,4121,4121,7700,7700,980,0,-577,4006679,False
uhzVklh39gU5EsW9,1639491403,Bolt,4121,4121,-8700,-8700,980,0,652,3998979,False,T9TT-209A-3CME-84PE
54c2H2lOhXqLtDpI,1639489569,Bolt,4121,4121,-7700,-7700,980,0,577,4007679,False
42prWvik0KnZqu1t,1639488820,JetBrains,5817,5817,-143577,-5300,840,0,0,4015379,False,36C5-AHX8-00EH-81MA
E2fkGd731AsN2p3U,1639481632,–ö–æ–ª–æ,5411,5499,-22200,-22200,980,0,0,4158956,False,35P7-XKM3-9B4C-KAH2
mj_IU3-n8HeUzdLE,1639421301,Lesya,4829,4829,-1000000,-1000000,980,0,0,4181156,True,C479-6B4E-9H18-A3MT
KinZ2-AFGkHI4s0t,1639417689,Lesya,4829,4829,-20000,-20000,980,0,0,5181156,True,9486-X6H3-7BM7-M8TX
7aqKaHISVDC-IbSQ,1639393090,–Ø–Ω–∞ –ù.,4829,4829,-1600000,-1600000,980,0,0,5201156,True,E5XH-7C82-BP1B-6120
FMucBNznd-mppCHw,1639392847,–íi–¥: –ü–†–ò–•–û–î–¨–ö–û –ï.–í. –§–û–ü,4829,4829,5000000,5000000,980,0,0,6801156,True
kzWrUPetHSF3lnnD,1639307030,Flower Time,5193,4215,-100000,-100000,980,0,0,1801156,False,EAXC-0012-PKPC-92HP
JYe48-0deT_pfN4m,1639305288,AVANGARDENGaleryandwi1,5814,5814,-45500,-45500,980,0,0,1901156,False,769H-1XMX-EHEP-2437
1azSfAdQ2GOj-79u,1639227445,MagazinBergophph,5719,5719,-199900,-199900,980,0,0,1946656,False,H2BA-TH97-76H2-7HTK
1ha4vp3ZBCqyjg_xjmYQfw,1639182418,"–°–∫–∞—Å—É–≤–∞–Ω–Ω—è. SP * AFEW STORE,Oststr. 36,DUSSELDORF,DE",5691,5691,398882,12995,978,0,0,2146556,False
7gZI3NG8uXlzpYch,1639160439,OK Wine,5411,5411,-35780,-35780,980,0,0,1747674,False,A051-3A70-4C30-9175
-WyZ2dxZHgtQfQSx,1639157724,FDY*Programming,7372,7372,-60500,-60500,980,0,0,1783454,False,8XPM-3XCT-536A-CP21
BTqxKb1mtkZaH1sz,1639127999,–ö–æ–ª–æ,5411,5499,-23700,-23700,980,0,0,1843954,False,XKTA-8CP2-CPA0-A93C
OMdxQOJ3CT9V-5HJ,1639127847,–ù–æ–≤–∞ –ø–æ—à—Ç–∞,7399,7399,-4400,-4400,980,0,0,1867654,False,4XB8-MCT7-XC59-5444
kL3t54oUh7QQLcIG,1639127113,Ponchyk Boy,5812,5812,-22501,-22501,980,0,0,1872054,True,1XAB-H03H-XBT0-07C6
jFb4ql6a_M-mqexn,1639079284,MONOPITSA,5814,5814,-27800,-27800,980,0,0,1894555,False,6APX-24K8-7P64-HA51
dxo6Ou_7mqslnTnI,1639079221,MAGAZYN DAY AND DAY,5499,5499,-2700,-2700,980,0,0,1922355,False,XC85-7MK1-PT1B-1P44
39GiT5nTAWzw-yoP,1639044936,PIECEWORK PUZZLES,5945,5945,-165961,-6077,840,0,0,1925055,False,3CKC-1P4A-BMPT-8X2T
dhnHdHCpEeKOk8oE,1638958814,Portmone,5977,5977,-88500,-88500,980,0,0,2091016,False,KCH7-A73M-51AK-K2K5
IUFakEZqyUZb5UPY,1638958338,SP * AFEW STORE,5691,5691,-402061,-12995,978,0,0,2179516,False
lCgZzdGsoi-mBLBc,1638954972,BWTC,5814,5814,-23200,-23200,980,0,0,2581577,False,1101-EC32-TCEC-9H20
amojXEnx0dX8_FiX,1638954937,bwtc cafe&roasters,5814,5814,-3500,-3500,980,0,0,2604777,False,70P7-761B-K2E8-5CK7
TL2cOOgPx-mW_ckT,1638811326,Bolt Food,4215,4215,-59500,-59500,980,0,0,2608277,False,954K-84B9-0TE6-3752
QngajyUngIcGEsdE,1638811195,OK Wine,5411,5411,-14800,-14800,980,0,0,2667777,False,7X6X-35AM-AX53-T541
73ot0DgRXy3qz4Qx,1638793970,–íi–¥: –ü–†–ò–•–û–î–¨–ö–û –ï.–í. –§–û–ü,4829,4829,2100000,2100000,980,0,0,2682577,True
Zeli36AN_lMq_eVh,1638790188,Comfy,5722,5722,-165000,-165000,980,0,0,582577,False,8P60-7MT0-672A-A4HM
5dZflJSua2TvBlGJ,1638789443,Rozetka,5722,5399,-110400,-110400,980,0,0,747577,False,58P7-K871-84E2-P03X
FXBQUbAgFw6GUKL5,1638782619,–ú—ñ—Å—å–∫–µ –∫–∞—Ñ–µ ¬´–•–∞—Ä–º—Å¬ª (–ö–Ω–∏–∂–∫–æ–≤–∞ –∫—Ä–∞–º–Ω–∏—Ü—è ¬´–•–∞—Ä–º—Å¬ª),5814,5814,-4560,-4560,980,0,0,857977,False,CE16-245P-3P71-569K
SXymk6YnBk8dgK7I,1638781628,–°–æ–∫—Ä–∞—Ç,5943,5943,-3980,-3980,980,0,0,862537,False,0K56-XB52-C99K-878X
HqwpJ8Jth-80pT1b,1638781203,Fotovramke,5946,5946,-72000,-72000,980,0,0,866517,False,EH78-5TE8-274H-2K4K
fNPgO2T2wP1GIHBH,1638780039,MAGAZYN DAY AND DAY,5499,5499,-20400,-20400,980,0,0,938517,False,TC78-M07P-P7KB-1K61
2frXp9rkhvqIwDj9,1638710704,–°–∫–∞—Å—É–≤–∞–Ω–Ω—è. Bolt,4121,4121,10700,10700,980,0,-80,958917,False
j8ZrX7c7H2l0x770,1638710643,Bolt,4121,4121,-11700,-11700,980,0,87,948217,False,M387-TX8A-KPBT-8752
h3XA0VMaPpv5ppp2,1638709142,Bolt,4121,4121,-10700,-10700,980,0,80,959917,False
zISNbEjL89pLV-e2,1638708876,–°—ñ–ª—å–ø–æ,5411,5411,-54314,-54314,980,0,0,970617,False,X94M-3A1C-P57H-TAPM
IkaUp4fA1LVIqdee,1638707225,Cropp Blockbuster,5651,5651,-161700,-161700,980,0,0,1024931,False,0E8P-MP1H-X4P0-MHH2
6K-5Xb9zOxZgE_MX,1638701966,Bolt,4121,4121,-10900,-10900,980,0,81,1186631,False,PXTK-M7CH-86BC-536X
7t8gTWySGBA1Ge2T,1638620858,MAGAZYN DAY AND DAY,5499,5499,-2500,-2500,980,0,0,1197531,False,A9BX-4583-3A1X-466P
LSUicSTbi1wK_J1_,1638619165,Bolt,4121,4121,-8200,-8200,980,0,61,1200031,False,A7BT-572X-3X31-T81A
EFoYxvSvWo-vvVvr,1638618907,–Ü–Ω—Ç–µ—Ä—Ç–æ–ø,5699,5661,-579900,-579900,980,0,0,1208231,False,794E-67AP-8C34-K2C8
8rLVcn6c0_WL4oOy,1638616345,Bolt,4121,4121,-5400,-5400,980,0,40,1788131,False,M902-8699-76A9-TP8P
fnlwyR8zjftCsC2s,1638616202,Mates,5814,5814,-64500,-64500,980,0,0,1793531,False,P7KM-XC96-8B0T-M64H
rQDI8y6yFCMN7-ho,1638570509,Pethouse,5995,5995,-75100,-75100,980,0,563,1858031,False,8EMP-A970-86BT-5K9M
et562307vgN8HpLx,1638564027,–ö–æ–ª–æ,5411,5499,-31050,-31050,980,0,0,1933131,False,E523-H4X0-7E53-5KEE
GO03_WF2BptzIFH_,1638563110,Bolt,4121,4121,-12300,-12300,980,0,92,1964181,False,HB4M-T1H7-8TAC-EMEA
2V-LWy1z_1U5mYjD,1638562722,–ú–∏–∫–∏—Ç–∞ –Ü.,4829,4829,-10350,-10350,980,350,0,1976481,True,38CH-E1MC-85BB-A238
0-lMH7fOu7_fucn8,1638562675,PanCraft,5814,5814,-19500,-19500,980,0,0,1986831,False,6HM6-22H3-72C1-HP7A
tSt6ILGvpP-ZZ-RC,1638562670,Punkraft,5812,5812,-76000,-76000,980,0,0,2006331,False,PX61-4X0A-27CA-7T79
TVA7mxHejKc4bzEc,1638552152,COFFEERECORDS,5814,5814,-14000,-14000,980,0,0,2082331,False,KA71-BTM6-6KMC-67P0
ernzRp1uvt9SfQVH,1638547476,Bolt,4121,4121,-8400,-8400,980,0,630,2096331,False,2EXX-ETTA-4TPH-AAB3
QtryHNcLh9EdV6lq,1638462695,MAGAZYN DAY AND DAY,5499,5499,-3139,-3139,980,0,0,2104731,False,95P8-BMT7-6372-X483
rrl28y-uE3qW7RzP,1638462377,OK Wine,5411,5411,-62400,-62400,980,0,0,2107870,False,P13A-2A7T-4072-93P9
0VPOU4H8FUcZYGae,1638461992,–ê–ø—Ç–µ–∫–∞ –ê–ù–¶,5912,5912,-49160,-49160,980,0,0,2170270,False,6P38-X1ME-AH90-71BK
UG6YpyUQIyuysJiz,1638449972,Flower Time,5193,4215,-105000,-105000,980,0,0,2219430,False,BCTX-8E8B-50BT-2AT3
lt06aWBh2u8ZB-d4,1638449392,–ö–æ–ª–æ,5411,5499,-24650,-24650,980,0,0,2324430,False,1XK4-1BP7-M191-8833
yZsK-mcyxpBw5QKU,1638382790,–°–∫–∞—Å—É–≤–∞–Ω–Ω—è. Bolt,4121,4121,7500,7500,980,0,0,2349080,False
8q2f7uUmctzCmxKO,1638376132,Bolt,4121,4121,-7500,-7500,980,0,0,2341580,False
tbxYvQ7mM19EVV-4,1638369140,MAGAZYN DAY AND DAY,5499,5499,-9250,-9250,980,0,0,2349080,False,KK39-P215-5B47-0T4T
75rP6Eu6xysj8R4a,1638368740,–ö–æ–ª–æ,5411,5499,-23500,-23500,980,0,0,2358330,False,8T5P-236K-46K4-6BKE
azaG9eUPsV2iKM32,1638368057,MONOPITSA,5814,5814,-17900,-17900,980,0,0,2381830,False,667A-C795-5567-73PB
A32YSWgwS58A3YgN,1638360618,Lesya,4829,4829,-2000000,-2000000,980,0,0,2399730,True,KHH8-8P1B-BCT8-E9ET
9KGhXFTB9Ru0xe55,1638360600,Lesya,4829,4829,-2000000,-2000000,980,0,0,4399730,True,BE2K-KX7P-PM12-MP68
FB2R3MhjV3wd4ukv,1638357860,–íi–¥: –ü–†–ò–•–û–î–¨–ö–û –ï.–í. –§–û–ü,4829,4829,5200000,5200000,980,0,0,6399730,True
WfYLtGbHUzTgAg9l,1638347402,Portmone,4814,4814,-25000,-25000,980,0,0,1199730,False,X1K9-K79K-38KT-H91C
PEzcZSiWzBARdCc0,1638338886,Bolt,4121,4121,-8200,-8200,980,0,0,1224730,False,T9PB-56CA-E392-A0A3
qa9H9Fv-YfCiEfkY,1638321740,–í—ñ–¥—Å–æ—Ç–∫–∏ –∑–∞ –ª–∏—Å—Ç–æ–ø–∞–¥,4829,4829,343,343,980,0,0,1232930,True
tIQYu8PJVqQNIhsx,1643549604,Yaroslaviv Val 37-1,5499,5499,-22600,-22600,980,0,169,1317608,False,E21A-71EX-MK4X-HHE4
-EGUH9xf4-Uimw4c,1643549167,MAGAZIN,5399,5399,-29900,-29900,980,0,224,1340208,False,C4MK-17CC-P03A-66MX
C63JhlSc5DRVVjj2,1643547192,PROSTOR 2099,5977,5977,-3776,-3776,980,0,0,1370108,False,33HK-342E-TTP5-K88T
w46c8NgvL_dgfJiC,1643541079,–°–∫–∞—Å—É–≤–∞–Ω–Ω—è. Bolt,4121,4121,5500,5500,980,0,0,1373884,False
jPDOq4AXMMYq44R2,1643540998,Bolt,4121,4121,-6500,-6500,980,0,0,1368384,False,HMXB-6XKM-8B0K-CXCK
ee4KS98-yUeBLnU6,1643540205,–°–∫–∞—Å—É–≤–∞–Ω–Ω—è. Bolt,4121,4121,5500,5500,980,0,0,1374884,False
kOtGoxB5eUxG7abT,1643540154,Bolt,4121,4121,-5500,-5500,980,0,0,1369384,False
fiwXOLguRgJavwbd,1643540139,Bolt,4121,4121,-5500,-5500,980,0,0,1374884,False
CiGxGliNttNVNul-,1643539806,–ú–µ–≥–∞–º–∞—Ä–∫–µ—Ç,5399,5411,-64100,-64100,980,0,480,1380384,False,8M14-PPKK-HMA5-3265
hyApSmfXYeEcCHEr,1643539689,–ú–µ–≥–∞–º–∞—Ä–∫–µ—Ç,5399,5411,-121750,-121750,980,0,913,1444484,False,9597-MBXT-389E-2TTT
wis_j_3MDUH1qXaw,1643539204,–°–∫–∞—Å—É–≤–∞–Ω–Ω—è. Bolt,4121,4121,200,10700,980,0,0,1566234,False
SCScVJ8BjQzs7Yfq,1643537229,Bolt,4121,4121,-10700,-10700,980,0,0,1566034,False
__R9nkqR7PZiNGN4,1643536667,Bolt,4121,4121,-4800,-4800,980,0,0,1576734,False,M099-40HA-AM1X-E35E
oPkJI2C5Ukd0Cocm,1643473663,–°—ñ–ª—å–ø–æ,5411,5411,-12500,-12500,980,0,93,1581534,False,C288-T848-THCE-7AK1
8CUfYsVN-mCkSOCp,1643470961,HUMANS COFFEE IN TECH,5814,5814,-8500,-8500,980,0,63,1594034,False,KK3M-BKE4-9C5M-P685
kiTdhGBkdx7_r2RR,1643467605,katsusando,5814,5814,-7500,-7500,980,0,56,1602534,False,A53M-X7M0-2KC0-HM32
FUTqck20ngTqvCL1,1643466065,katsusando,5814,5814,-51000,-51000,980,0,382,1610034,False,413C-XBBH-02EA-H4P2
hBR9w41t37RBxLIn,1643457808,PHotosalonMAN,7221,7221,-3000,-3000,980,0,0,1661034,False,C6C0-K0HC-787E-31C2
1Y4iBqAluyGDX1lF,1643452206,Mates,5814,5814,-100000,-100000,980,0,750,1664034,False,5KX6-1KMA-1K9P-522X
B0dInKTkfwMqi939,1643446096,516798****0634,4829,4829,-43781,-43781,980,1481,0,1764034,True,B785-B2EE-ME55-HP8C
oI1N5IsiYIBCXjpO,1643440306,–û–±—Å–ª—É–≥–æ–≤—É–≤–∞–Ω–Ω—è –ø–ª–∞—Ç–∏–Ω–æ–≤–æ—ó –∫–∞—Ä—Ç–∫–∏,4829,4829,-25000,-25000,980,0,0,1807815,True
175kl-PIRNvt7LgM,1643317169,–¶–∏–ø–∞ Craft Pub,5814,5814,-40000,-40000,980,0,300,1832815,False,55XX-39X3-TT7E-P509
opPsw5JT85cy4PI9,1643282003,–°–∫–∞—Å—É–≤–∞–Ω–Ω—è. Bolt,4121,4121,6500,6500,980,0,0,1872815,False
acjvIv6m1x-7lNgP,1643281875,Bolt,4121,4121,-7500,-7500,980,0,0,1866315,False,PPA3-BP5K-K9XB-44B0
F1sxgA6Zlg2ZFqE9,1643281861,–°–∫–∞—Å—É–≤–∞–Ω–Ω—è. Bolt,4121,4121,13100,13100,980,0,0,1873815,False
Byt9VVR6OSgoJMpz,1643281764,Bolt,4121,4121,-13800,-13800,980,0,0,1860715,False,XP6P-M56T-8XC1-4XEP
_C8CtNNriYJjUMry,1643280948,Bolt,4121,4121,-6500,-6500,980,0,0,1874515,False
e0FSJjEaLICd1zlO,1643278514,Harms,5814,5814,-18960,-18960,980,0,142,1881015,False,EM6A-8H73-K37P-CM1C
oCsk3p_vdnx6u81x,1643278410,Bolt,4121,4121,-13100,-13100,980,0,0,1899975,False
h4wl6aOPd-vQ1SHm,1643278176,–°–∫–∞—Å—É–≤–∞–Ω–Ω—è. Bolt,4121,4121,7600,7600,980,0,0,1913075,False
b5_F7HQ5pGH4eJL-,1643278122,Bolt,4121,4121,-8600,-8600,980,0,0,1905475,False,X707-0079-6AAH-K786
JwT2moSVfqwPsLz8,1643278075,SIGARNIY DIM FORTUNA,5993,5993,-34000,-34000,980,0,0,1914075,False,C8MA-65TP-5ABT-78KX
wnYdO5Dld_xfUFZf,1643276685,Bolt,4121,4121,-7600,-7600,980,0,0,1948075,False
SlSujoDtvfJEOR8I,1643267403,–°–∫–∞—Å—É–≤–∞–Ω–Ω—è. Bolt,4121,4121,10100,10100,980,0,0,1955675,False
u7E1F6wddwtxPBfK,1643267357,Bolt,4121,4121,-10700,-10700,980,0,0,1945575,False,084B-5K21-15TM-T6M6
bacCE3xCkuZSHJuw,1643265001,Bolt,4121,4121,-10100,-10100,980,0,0,1956275,False
G_bVjvrI0cKWnp7L,1643229523,Bolt,4121,4121,-6900,-6900,980,0,0,1966375,False,20EX-E46A-PEC6-T571
WxrlH4HYQBQapfZv,1643218916,–ö–æ–ª–æ,5411,5499,-20400,-20400,980,0,153,1973275,False,K5X4-TP8K-E1AA-2H20
sROGtPfvI5F5Fu7V,1643218758,Bolt,4121,4121,-7100,-7100,980,0,0,1993675,False,380P-8BBM-1T80-BPMB
JbNaC-NP6NyvcYip,1643212628,–°–∫–∞—Å—É–≤–∞–Ω–Ω—è. Bolt,4121,4121,6800,6800,980,0,0,2000775,False
0jNkCZUXSTRZzHN-,1643212510,Bolt,4121,4121,-9200,-9200,980,0,0,1993975,False,43MX-EET1-HA44-P8T4
XuzG0P54yoL7qPY0,1643209757,Bolt,4121,4121,-6800,-6800,980,0,0,2003175,False
743mNI7Qa1dCXUGY,1643208095,Bolt,4121,4121,-6800,-6800,980,0,0,2009975,False,BXBX-6BT5-4XK6-7C84
3yEnwr4KpGIdZILU,1643187466,410232****7225,4829,4829,-227500,-227500,980,0,0,2016775,True,BET9-3M3B-4821-EH7T
Ij8mgvjNR3x0yB8u,1643098886,WFP.AQUAMARKET_,5411,5411,-24320,-24320,980,0,364,2244275,False,CPAH-987K-M617-B5KM
j-Caksj287dPSh19,1643096278,bwtc cafe&roasters,5814,5814,-4050,-4050,980,0,81,2268595,False,9X9K-883H-BP75-AK0A
ec0Km-wsoWT39gcc,1643025916,414949****1146,4829,4829,-122613,-122613,980,0,0,2272645,True,H3T1-38B2-0TEM-AH57
q5pfyxbKH2Ko0fTs,1643025080,–ï–∫–æ-–õ–∞–≤–∫–∞,5411,5499,-8900,-8900,980,0,133,2395258,False,4K4A-E570-9PMX-13ME
quWxee705p1DRv_2,1643024995,–ö–æ–ª–æ,5411,5499,-20100,-20100,980,0,301,2404158,False,12AH-T804-B4PM-TX96
eCPuqNWYuf9msfgL,1643023811,Lesya,4829,4829,-1000000,-1000000,980,0,0,2424258,True,KMM2-57CE-XT06-K841
XXZ70ZCfBNAow5np,1643021562,–íi–¥: –ü–†–ò–•–û–î–¨–ö–û –ï.–í. –§–û–ü,4829,4829,1800000,1800000,980,0,0,3424258,True
3x1nivmFl40ZffvZ,1643010153,bwtc cafe&roasters,5814,5814,-9900,-9900,980,0,74,1624258,False,1866-3M1M-4371-20E5
Jm8duBMxkdB9XEpm,1642954148,–°–∫–∞—Å—É–≤–∞–Ω–Ω—è. Bolt,4121,4121,9800,9800,980,0,0,1634158,False
J2hQmQCe6olca_BR,1642954080,Bolt,4121,4121,-9800,-9800,980,0,0,1624358,False
Fi74HHKgGEjLoco8,1642939416,–°–∫–∞—Å—É–≤–∞–Ω–Ω—è. Bolt,4121,4121,11200,11200,980,0,0,1634158,False
SJCiRxgd_-xlKdu7,1642939364,Bolt,4121,4121,-13200,-13200,980,0,0,1622958,False,80B3-X343-8C6C-BKM1
3Oxy5EAeFMRN7TXL,1642939049,Lesya,4829,4829,-103500,-103500,980,3500,0,1636158,True,979B-6AA0-AXKM-9T7P
QlwcgeRv4mrlHgNi,1642939019,Bolt,4121,4121,-11200,-11200,980,0,0,1739658,False
5BXTRHgKQ50SZ5qP,1642861843,Beermood,4215,4215,-23800,-23800,980,0,0,1750858,False,4EK8-5TH2-P059-31B9
Iu330l3UV5lgyrAM,1642856359,Konteyer,5814,5814,-9900,-9900,980,0,74,1774658,False,6E0B-H4KA-7T98-90TK
Ta-uoYh0wcYiYPgU,1642848533,ProduktiJArVal19,5499,5499,-20400,-20400,980,0,153,1784558,False,6PKX-8C9A-TH9A-3C67
l_Pn92201cAviN67,1642797947,–°–∫–∞—Å—É–≤–∞–Ω–Ω—è. Bolt,4121,4121,9500,9500,980,0,0,1804958,False
hnfK9n6MM3YJTtT9,1642797898,Bolt,4121,4121,-11000,-11000,980,0,0,1795458,False,HT55-2CKX-6CXM-BK2H
ph8cY1J4WW5ahc4N,1642796708,Bolt,4121,4121,-9500,-9500,980,0,0,1806458,False
Wpolc-pZEi3o7XRO,1642796423,Garage,5921,5921,-280000,-280000,980,0,2819,1815958,False,7B75-0BE2-0EET-8XAH
JBdWRdSbc_bc265t,1642791149,516874****8251,4829,4829,-310000,-310000,980,0,0,2095958,True,XAM6-E58C-X9X7-C3MH
x03NnNUzJFqelR8-,1642790652,–°–∫–∞—Å—É–≤–∞–Ω–Ω—è. Bolt,4121,4121,6000,6000,980,0,0,2405958,False
kPJbZABZSANQHoj0,1642790590,Bolt,4121,4121,-7000,-7000,980,0,0,2399958,False,EAC2-1AP3-4439-9241
bYXPrHaSC4rgIVZT,1642790571,Bolt,4121,4121,-6000,-6000,980,0,0,2406958,False
lEqNOhNRAD0589ng,1642775651,Lesya,4829,4829,-800000,-800000,980,0,0,2412958,True,HHE3-MAXK-5733-3XC0
0l1EapAmBTKZ27k_,1642773995,–°–∫–∞—Å—É–≤–∞–Ω–Ω—è. Bolt,4121,4121,5600,5600,980,0,0,3212958,False
EJh1zryHDGUoXKK1,1642773941,Bolt,4121,4121,-6600,-6600,980,0,0,3207358,False,BX93-KX2A-1H79-C0BM
xzZ7EkCemCW8GBye,1642773914,Bolt,4121,4121,-5600,-5600,980,0,0,3213958,False
pxk7cWFIL9iL-RWT,1642770941,Lesya,4829,4829,-2000000,-2000000,980,0,0,3219558,True,03H6-55T2-A0C8-EKXT
xTPBjAD4Ub2zDvi-,1642770228,–íi–¥: –ü–†–ò–•–û–î–¨–ö–û –ï.–í. –§–û–ü,4829,4829,4000000,4000000,980,0,0,5219558,True
O2B7S5yudZAHQBq0,1642769919,Bolt,4121,4121,-5900,-5900,980,0,0,1219558,False,BKPM-HB16-9T8X-PBC3
KLsQMRdvaWbUNp1B,1642759606,Harms,5814,5814,-4560,-4560,980,0,34,1225458,False,03BP-63E4-XPTE-T30B
e_1-0wNWlQ_4pFkz,1642662276,Produkti,5499,5499,-13600,-13600,980,0,102,1230018,False,48C8-8B46-237M-6314
m1bm9NhiqXSDbc_3,1642662103,MC UNIVER KLINIK,8062,8062,-129000,-129000,980,0,0,1243618,False,2A9X-BK17-6CTP-59PM
jjxICHochTTmLVIx,1642660209,"Lifecell
+380631692598",4814,4814,-16000,-16000,980,0,0,1372618,True,KHXB-T6M7-9620-5617
-pSFy5nr3IW4rtAu,1642619122,LIQPAY*PITAKYIV,5812,5812,-44200,-44200,980,0,331,1388618,False,3E62-T6K8-T7TE-38MA
iZ5McM_CoB2HJb6e,1642616089,LIQPAY*Beebooks,8999,8999,-62000,-62000,980,0,0,1432818,False,976E-PCP1-HE08-7P1M
3mShRpr1yXoD_YAO,1642585828,Mates,5814,5814,-13000,-13000,980,0,97,1494818,False,P473-2HC8-7117-04HA
UVdtuQHkAHYuG55z,1642535351,MAGAZYN DAY AND DAY,5499,5499,-20400,-20400,980,0,153,1507818,False,62CB-5017-MK1A-7636
5JfMMvdHdH42SMEH,1642499185,Novapay,8999,8999,-3500,-3500,980,0,0,1528218,False,B9PK-HKA8-2EAC-X367
AIz-_IF328kA91aV,1642424093,MAGAZYN DAY AND DAY,5499,5499,-13600,-13600,980,0,102,1531718,False,XM29-MB42-8MB7-70A4
HQX7GZjJXcuvNCVV,1642423436,WFP.AQUAMARKET_,5411,5411,-70740,-70740,980,0,530,1545318,False,85A6-3B9C-838E-X706
iM8KOITgr0vaGlxv,1642371137,WFP*PETHOUSE.UA,5995,5995,-104900,-104900,980,0,0,1616058,False,P29K-TAP8-B7PH-6301
aA9hFbJcXaN8ymbX,1642329874,–ï–∫–æ-–õ–∞–≤–∫–∞,5411,5499,-20800,-20800,980,0,156,1720958,False,TH7A-0KA5-M64E-XTH1
59K-5_G-eZHhLWp8,1642329369,–°—ñ–ª—å–ø–æ,5411,5411,-198148,-198148,980,0,1486,1741758,False,3404-4HXB-90KC-XC69
Bqg1qCWCxH4MeOdq,1642271098,–ö–æ–ª–æ,5411,5499,-13600,-13600,980,0,102,1939906,False,2141-0CBP-87C6-K04H
_6C1XpGZqmT0zy5R,1642267412,–°–∫–∞—Å—É–≤–∞–Ω–Ω—è. Bolt,4121,4121,22700,22700,980,0,0,1953506,False
5A0H5r5DS1wRSvNl,1642267187,Bolt,4121,4121,-24100,-24100,980,0,0,1930806,False,4853-M742-C51E-M837
s8LU1fDTIZ7hzXf1,1642264748,Bolt,4121,4121,-22700,-22700,980,0,0,1954906,False
3_fJDdADi3ZeJRAn,1642251155,Bolt,4121,4121,-13300,-13300,980,0,0,1977606,False,B1XT-KEKM-9B57-C4H1
yIpTPWyw5bJiUw2d,1642245741,Mates,5814,5814,-71600,-71600,980,0,1318,1990906,False,AK8X-A5A0-18M8-93E3
_LElh3CyyQAfjW2G,1642197802,Lesya,4829,4829,-900000,-900000,980,0,0,2062506,True,THBK-A283-73M3-34MT
MZriXTR1l6GYCnw6,1642189247,Kitaika,5812,5812,-50500,-50500,980,0,1010,2962506,False,4KH6-XP1M-02KE-41TT
YHChbZ08dcrgeb5v,1642154529,Beer Market,5921,5921,-32348,-32348,980,0,485,3013006,False,5APT-3B58-2601-83X8
Zq4gZkxlqH0gYsn3,1642114300,–°–∫–∞—Å—É–≤–∞–Ω–Ω—è. Bolt,4121,4121,11600,11600,980,0,0,3045354,False
-h4RQz77kAna3o-Y,1642113852,Bolt,4121,4121,-11600,-11600,980,0,0,3033754,False
_O8XrSKtpyJptvuy,1642086347,–ï–∫–æ-–õ–∞–≤–∫–∞,5411,5499,-8900,-8900,980,0,133,3045354,False,HPP0-431T-953T-4XB0
MqNJSOC2wGFHX5nk,1642068114,Harms,5814,5814,-4560,-4560,980,0,91,3054254,False,B0CE-98AM-M849-MM76
ndAkH7sGhlycPBQ9,1642066773,Ponchyk Boy,5812,5812,-28402,-28402,980,0,568,3058814,True,483E-94ME-C98M-T2MX
bPp2FSMi3cEZXlYO,1642066139,Novus,5411,5411,-4199,-4199,980,0,62,3087216,False,AKE9-1AMK-X55T-4971
XUKAu_oQcWRfJrUO,1642059258,MC UNIVER KLINIK,8062,8062,-115000,-115000,980,0,0,3091415,False,M6C3-K6HK-PXMA-EE21
kP2zcWNkClGUa5X4,1642010084,Mates,5814,5814,-86400,-86400,980,0,1728,3206415,False,1K69-3E61-2259-8M5A
az7vViwp8ZuiLWtr,1641979470,–ö–æ–ª–æ,5411,5499,-20400,-20400,980,0,306,3292815,False,1P64-E1M1-1M1K-E1MP
FcIeFEZ9Gel1iMv7,1641940807,Bolt,4121,4121,-14800,-14800,980,0,0,3313215,False,41E3-211A-8CKX-74TK
-8ALScuAopFT6pW9,1641904471,–°–∫–∞—Å—É–≤–∞–Ω–Ω—è. Bolt,4121,4121,5700,5700,980,0,0,3328015,False
28pIeYSU8qamN2Yk,1641904371,Bolt,4121,4121,-5700,-5700,980,0,0,3322315,False
_3crVQixThneMbhN,1641892866,Lesya,4829,4829,-1000000,-1000000,980,0,0,3328015,True,T73P-P253-EA38-TM0A
MncmDbZn56Wb_J5o,1641891779,–íi–¥: –ü–†–ò–•–û–î–¨–ö–û –ï.–í. –§–û–ü,4829,4829,2600000,2600000,980,0,0,4328015,True
ufHrv6OGm9_4mjsv,1641843785,Comfy,5722,5722,-184600,-184600,980,0,0,1728015,False,4X67-E5CX-BE01-TMX6
6zlt-MRZjxLOpa3B,1641816773,MAGAZYN DAY AND DAY,5499,5499,-4200,-4200,980,0,31,1912615,False,8EB7-2KEP-HTXH-XMTC
q0bjCbwvJcjPx15_,1641816397,–ö–æ–ª–æ,5411,5499,-26000,-26000,980,0,195,1916815,False,HAM5-2P6C-ET87-A042
WRSVvB8jR8r9hUDf,1641804219,Lesya,4829,4829,-101934,-101934,980,1934,0,1942815,True,9E6T-P8B2-KTEA-61AC
B_FzipPXLChnA9Sn,1641766352,Lesya,4829,4829,-100000,-100000,980,0,0,2044749,True,9M69-8B2E-3T9X-ACEA
oDzX2ap4V1kDVAmI,1641754665,–°–∫–∞—Å—É–≤–∞–Ω–Ω—è. Bolt,4121,4121,16300,16300,980,0,0,2144749,False
JDeS8NrW1e8yZsXP,1641754603,Bolt,4121,4121,-16600,-16600,980,0,0,2128449,False,8035-K1M2-18EC-HH64
3KAmDsUN3um8Mszr,1641751680,Bolt,4121,4121,-16300,-16300,980,0,0,2145049,False
zFxDDKJaQBeqELOm,1641731447,Bolt,4121,4121,-14400,-14400,980,0,0,2161349,False,5M80-H969-X467-P6CT
oWgyblQ8SR4tajTJ,1641731417,–ï–∫–æ-–õ–∞–≤–∫–∞,5411,5499,-44650,-44650,980,0,669,2175749,False,4XT4-8KAP-8B6B-472C
Npm11nIgWZ1ztPKj,1641677211,LIQPAY*TOV TEHNOLAJN T,5732,5732,-29900,-29900,980,0,0,2220399,False,C43E-8HC6-3PPP-KT2C
U9t8JRU9tS7M-yOV,1641672807,–°–∫–∞—Å—É–≤–∞–Ω–Ω—è. Bolt,4121,4121,15700,15700,980,0,0,2250299,False
d_ideL3hWwgnqPPZ,1641672688,Bolt,4121,4121,-15700,-15700,980,0,0,2234599,False
HjSId0KRlmf8FcEk,1641657698,–°–∫–∞—Å—É–≤–∞–Ω–Ω—è. Bolt,4121,4121,14000,14000,980,0,0,2250299,False
eQGBQCYZ8vcAs9YM,1641657633,Bolt,4121,4121,-17000,-17000,980,0,0,2236299,False,9E16-66XH-7BBX-0A57
LZuQaGgb1Ibxnwu3,1641655782,Bolt,4121,4121,-14000,-14000,980,0,0,2253299,False
whW_jINDNk0vs2Ai,1641646603,–ö–æ–ª–æ,5411,5499,-20400,-20400,980,0,306,2267299,False,BC9P-AEMT-P4MX-40XA
lYVMVAWd94DaU4nT,1641635654,OK Wine,5411,5411,-128600,-128600,980,0,1929,2287699,False,TE07-T872-MT22-TTXX
TVjB_jW08hy--FZ6,1641635194,MusaCafe,5814,5814,-15000,-15000,980,0,300,2416299,False,MA3K-X288-6CC5-T3PM
Fr3yq_-SMcd5S7xC,1641564311,WFP.AQUAMARKET_,5411,5411,-24320,-24320,980,0,364,2431299,False,EAX8-TT93-P91B-0M00
3zhK5XBdRFcdHhvy,1641563240,–°–∫–∞—Å—É–≤–∞–Ω–Ω—è. Bolt,4121,4121,6200,6200,980,0,0,2455619,False
Vxwx2n99oujeWcfR,1641563184,Bolt,4121,4121,-6700,-6700,980,0,0,2449419,False,X825-T9H4-C48A-865X
gWmulpvpg8r7P0m5,1641562184,Bolt,4121,4121,-6200,-6200,980,0,0,2456119,False
XzXn5QD6EaPa0GnC,1641562100,–ú–µ–≥–∞–º–∞—Ä–∫–µ—Ç,5399,5411,-32269,-32269,980,0,484,2462319,False,X93K-633C-AH9C-4TX5
_HiRukCD83LPYbRx,1641557131,–°–∫–∞—Å—É–≤–∞–Ω–Ω—è. Bolt,4121,4121,7100,7100,980,0,0,2494588,False
aUWg4rnVzFHovDTu,1641557064,Bolt,4121,4121,-7600,-7600,980,0,0,2487488,False,4XM6-A840-5T5E-HC42
Xb5YJJxu07z9Vicd,1641556015,Bolt,4121,4121,-7100,-7100,980,0,0,2495088,False
ZVgtfxva0RtlpyXX,1641499165,Lesya,4829,4829,-400000,-400000,980,0,0,2502188,True,XPA9-212K-3TK5-6C3C
29JO__eUibKlaMIE,1641497941,–°–∫–∞—Å—É–≤–∞–Ω–Ω—è. Bolt,4121,4121,6400,6400,980,0,0,2902188,False
uPUkyFKPJh2tfXl_,1641497140,Bolt,4121,4121,-10600,-10600,980,0,0,2895788,False,CX4X-KP8M-KP8E-CCE6
FCAZi8fwKx2KiWhu,1641497041,Bolt,4121,4121,-6400,-6400,980,0,0,2906388,False
pza7PI95VXPxPSif,1641488632,–°–∫–∞—Å—É–≤–∞–Ω–Ω—è. Bolt,4121,4121,12800,12800,980,0,0,2912788,False
OxIjLEvLiLIdjjTK,1641488571,Bolt,4121,4121,-13000,-13000,980,0,0,2899988,False,43B5-E68H-T4C5-6PT0
FYGJUWYFgoqNf44B,1641486578,Bolt,4121,4121,-12800,-12800,980,0,0,2912988,False
pDsQ4a0tQnpjalVZ,1641479590,535432****9941,4829,4829,-5500,-5500,980,0,0,2925788,True,CM5H-A96B-83H9-2MT3
IM7Rua4AGNTmFJgP,1641477353,HUMANS COFFEE IN TECH,5814,5814,-29900,-29900,980,0,598,2931288,False,9KPH-AC4C-9MK9-4B8T
JujuHv-R-l8__2s7,1641475784,–°–∫–∞—Å—É–≤–∞–Ω–Ω—è. Bolt,4121,4121,5500,5500,980,0,0,2961188,False
YpPErHOzIwfmPWjc,1641475673,Bolt,4121,4121,-6500,-6500,980,0,0,2955688,False,A6XC-975X-ATBB-ECH8
gfbahftkFHptFf1k,1641474546,Bolt,4121,4121,-5500,-5500,980,0,0,2962188,False
YQFrFK3pi_-BYYCw,1641471089,–°—ñ–ª—å–ø–æ,5411,5411,-79164,-79164,980,0,1187,2967688,False,HKX0-T191-XTT1-PA0A
sP-odR_p9UQB502_,1641468943,MAGAZYNShop 146,5499,5499,-13600,-13600,980,0,204,3046852,False,C6C6-552B-EK33-8EK1
fAUu6J_eoNtUszkE,1641465679,–°–∫–∞—Å—É–≤–∞–Ω–Ω—è. Bolt,4121,4121,800,16700,980,0,0,3060452,False
6PGwWUhaMBPfrzWp,1641462042,Bolt,4121,4121,-16700,-16700,980,0,0,3059652,False
dcqtpfGrK2Vi6MpF,1641453613,–°–∫–∞—Å—É–≤–∞–Ω–Ω—è. Bolt,4121,4121,10100,10100,980,0,0,3076352,False
MNX2CpmD32pPLEfL,1641453560,Bolt,4121,4121,-10300,-10300,980,0,0,3066252,False,7CX0-6B6X-KT48-TH92
XAjFCJm2auS3Rit9,1641451130,Bolt,4121,4121,-10100,-10100,980,0,0,3076552,False
-sRDSYXV_fDLHt0n,1641397861,–°–∫–∞—Å—É–≤–∞–Ω–Ω—è. Bolt,4121,4121,6900,6900,980,0,0,3086652,False
GP2lRlRoLdp3L5sI,1641397800,Bolt,4121,4121,-7900,-7900,980,0,0,3079752,False,06EC-CA01-7KBT-BHKE
9nr9bC-WFNMy_Th3,1641396443,–°–∫–∞—Å—É–≤–∞–Ω–Ω—è. Bolt,4121,4121,8200,8200,980,0,0,3087652,False
yDAhtqEOAaWSQ7WV,1641396359,Bolt,4121,4121,-6900,-6900,980,0,0,3079452,False
sCDJpIPbLb6SNXE-,1641396222,Bolt,4121,4121,-9200,-9200,980,0,0,3086352,False,2AP5-90TH-E0E6-9XE7
ZcJ9tUjGqijn3TtM,1641395984,–°–∫–∞—Å—É–≤–∞–Ω–Ω—è. Bolt,4121,4121,6700,6700,980,0,0,3095552,False
JePHpuS2j7AadhRi,1641395048,Bolt,4121,4121,-8200,-8200,980,0,0,3088852,False
NZP74fkrnHklHkH7,1641394500,Bolt,4121,4121,-6700,-6700,980,0,0,3097052,False
bZJPVeDAkSDckGzw,1641389472,Yaroslaviv Val 37-1,5499,5499,-55910,-55910,980,0,838,3103752,False,3332-742A-HHMM-T6H3
c6Nf4KvjflbPZe_M,1641387624,Grin13,5814,5814,-34200,-34200,980,0,684,3159662,False,P8TH-XTX4-5AP8-B39A
88Rg9Xo1ARYuZ0av,1641385418,Lesya,4829,4829,-1000000,-1000000,980,0,0,3193862,True,H203-21MT-9M77-29BC
jMFSrw3P_sOK3ML5,1641384264,–íi–¥: –ü–†–ò–•–û–î–¨–ö–û –ï.–í. –§–û–ü,4829,4829,2000000,2000000,980,0,0,4193862,True
y0Crmts7NvBinTcn,1641322133,Lesya,4829,4829,-100000,-100000,980,0,0,2193862,True,B822-1EP5-TCTP-2PC9
6F486IKiY5gwNnsP,1641302488,Mates,5814,5814,-44500,-44500,980,0,890,2293862,False,7X30-4MA7-4XT1-TP8C
2RXR3wKQ1AoH2V6R,1641294253,Lesya,4829,4829,-100000,-100000,980,0,0,2338362,True,HPCM-3BTA-E76H-103A
WYF2Bi53wkuaOOAN,1641218554,–°–∫–∞—Å—É–≤–∞–Ω–Ω—è. Bolt,4121,4121,10400,10400,980,0,0,2438362,False
-yMONL9iqlHswh27,1641218495,Bolt,4121,4121,-11800,-11800,980,0,0,2427962,False,9XAX-9K1E-X4P1-PEC7
4b7dr65Cb_qXtJKp,1641216753,Bolt,4121,4121,-10400,-10400,980,0,0,2439762,False
IOkWtavYUJf7tisW,1641212228,–°–∫–∞—Å—É–≤–∞–Ω–Ω—è. Bolt,4121,4121,7800,7800,980,0,0,2450162,False
oCwBVJCezYXx8KGy,1641212167,Bolt,4121,4121,-8800,-8800,980,0,0,2442362,False,933E-4549-7T2B-TH4T
2wDPG80-v6wWLRJE,1641211230,Bolt,4121,4121,-7800,-7800,980,0,0,2451162,False
n8WKo3r6QK1g-uao,1641210956,Novus,5411,5411,-27299,-27299,980,0,409,2458962,False,X1HH-0MTE-96C1-1278
w4w__47AjBc7NvZg,1641210847,lifecell,4812,4812,-15000,-15000,980,0,0,2486261,False,991H-2BH7-45K4-0T38
F2RumLovXvybJG63,1641209914,AromaSistersRetroville,5977,5977,-80000,-80000,980,0,0,2501261,False,8A76-81HT-A73B-BC8C
NRta7qlsPOWWPYa0,1641209401,–Ü–Ω—Ç–µ—Ä—Ç–æ–ø,5699,5661,-39900,-39900,980,0,0,2581261,False,P5M8-07PM-7BH5-TPA4
FHELgifmH48NOeT6,1641207697,Lesya,4829,4829,-50000,-50000,980,0,0,2621161,True,4BC4-45HT-3B9A-8H87
d93vjiXOBOEvzPdA,1641207311,–°–∫–∞—Å—É–≤–∞–Ω–Ω—è. Bolt,4121,4121,11500,11500,980,0,0,2671161,False
w0EHnRYsF12gmx2k,1641207247,Bolt,4121,4121,-12000,-12000,980,0,0,2659661,False,4TC2-24XC-B488-8BKB
ZXBNgcMjlBvIwxho,1641204204,Bolt,4121,4121,-11500,-11500,980,0,0,2671661,False
PLVtmlzZ2yHtq0RV,1641198899,Lesya,4829,4829,-50000,-50000,980,0,0,2683161,True,A96M-784K-5PEP-EX07
9iyfz9kv37VP2_M2,1641146092,FDY*FOOD.BOLT.EU,4215,4215,-19500,-19500,980,0,0,2733161,False,HE54-K1X7-P4CT-3KTA
8cWKZ8cymksKQezu,1641134642,Plategka,4816,4816,-25625,-25625,980,0,0,2752661,False,9X74-8CTP-HH48-36HB
bCkfWjGx_Uafp7YB,1641134552,Portmone,4814,4814,-25000,-25000,980,0,0,2778286,False,BC32-X209-4960-8A28
Jaezvor0XBFD_KWD,1641134498,Portmone,4814,4814,-26000,-26000,980,0,0,2803286,False,42XE-7M56-X720-X3CP
IrWPRAGlKlRb0N5d,1641119460,–°—ñ–ª—å–ø–æ,5411,5411,-1555,-1555,980,0,23,2829286,False,3X6H-12H3-23K8-MH8K
1YQ1mLJiR4ub1Gzm,1641119257,–°—ñ–ª—å–ø–æ,5411,5411,-76257,-76257,980,0,1143,2830841,False,KHXM-6H10-P92X-M4EP
z6CxYXWaZO1TCKq3,1641063379,Produkti,5499,5499,-20400,-20400,980,0,0,2907098,False,KPXE-BKH7-ATC3-KT6X
1xzzgk5-pxehpn9P,1640998881,–í—ñ–¥—Å–æ—Ç–∫–∏ –∑–∞ –≥—Ä—É–¥–µ–Ω—å,4829,4829,432,432,980,0,0,2927498,True
kD7nxdZp_TeHj3SG,1645967419,–°–∫–∞—Å—É–≤–∞–Ω–Ω—è. DigitalOcean,5734,5734,15576,500,840,0,0,7106702,False
-9seOKy7eyzspaQS,1645967413,DigitalOcean,5734,5734,-15576,-500,840,0,0,7091126,False
xchDA5wZTSjyMh3s,1645877988,536354****2318,4829,4829,-100000,-100000,980,0,0,7106702,True,T227-3PEE-A25T-6P5T
Ys2EjPMUOQaq7O_3,1645873266,–ü—ñ–¥—Ç—Ä–∏–º–∫–∞ –∞—Ä–º—ñ—ó,4829,4829,-500000,-500000,980,0,0,7206702,True,7PT1-7B91-66KB-2HME
FWyYoXphJP6I4U_H,1645786077,–íi–¥: –ü–†–ò–•–û–î–¨–ö–û –ï.–í. –§–û–ü,4829,4829,5100000,5100000,980,0,0,7706702,True
UVrdSf8h_IXXI51E,1645693103,"Lifecell
+380631692598",4814,4814,-2500,-2500,980,0,0,2606702,True,CP1K-536A-PPK2-6B79
UP2gOYZ4E3JQb5UG,1645690906,–°—ñ–ª—å–ø–æ,5411,5411,-209438,-209438,980,0,3141,2609202,False,KPET-9TC7-M8CC-80BK
O-dTwE9arkwTP2Uy,1645638683,–°–∫–∞—Å—É–≤–∞–Ω–Ω—è. Bolt,4121,4121,5400,5400,980,0,-405,2818640,False
iUhDcVTFCFlNaGt8,1645638555,Bolt,4121,4121,-7500,-7500,980,0,562,2813240,False,5129-P0XB-2XKT-XHK4
2khbHr73cYAGfuVm,1645636921,LIQPAY*TOV Monopica,5812,5812,-39800,-39800,980,0,0,2820740,False,KMXP-A11C-76EA-2A68
ba9zSUXa6QU-GXen,1645636792,–°–∫–∞—Å—É–≤–∞–Ω–Ω—è. Bolt,4121,4121,5400,5400,980,0,-405,2860540,False
fcHaEj3vLUlcCpSa,1645636567,–°–∫–∞—Å—É–≤–∞–Ω–Ω—è. Bolt,4121,4121,6600,6600,980,0,-495,2855140,False
paSWMrc_AA0M4dNH,1645636350,Bolt,4121,4121,-5400,-5400,980,0,405,2848540,False
6bpZl_ybq5SaWid2,1645636104,Bolt,4121,4121,-5400,-5400,980,0,405,2853940,False
WLn6VbW-OscvXzR1,1645635202,Bolt,4121,4121,-6600,-6600,980,0,495,2859340,False
jhMGEW6Jjx3YvjCg,1645631184,Bolt,4121,4121,-8500,-8500,980,0,637,2865940,False,P4H9-613X-0B51-7CCK
RJo3Mwi7RpBqSJzu,1645605447,"Lifecell
+380631692598",4814,4814,-1000,-1000,980,0,0,2874440,True,496C-CHMT-6AKT-735B
3lrtaUCKtPNz_LgU,1645605425,–í—ñ–¥: –û–ª–µ—Å—è –°–∞—á–µ–Ω–∫–æ,4829,4829,100,100,980,0,0,2875440,True
vEuQuMJBG3YWkazV,1645605402,Lesya,4829,4829,-100,-100,980,0,0,2875340,True,C3X9-CBB0-HM03-M18P
T0jHzgF4xwUrokDD,1645543625,Steam,5816,5816,-27900,-27900,980,0,0,2875440,False,0CB9-CAHP-18HP-HTCT
3unxUDwCDAgN4F4M,1645536579,OK Wine,5411,5411,-47330,-47330,980,0,709,2903340,False,TMK0-1274-683X-67B5
peZAmVDuOwbkuAuj,1645536486,–°–∫–∞—Å—É–≤–∞–Ω–Ω—è. Bolt,4121,4121,6200,6200,980,0,-465,2950670,False
cZz1eRGX_PPJ4PCz,1645536373,Bolt,4121,4121,-7600,-7600,980,0,570,2944470,False,XT57-6H06-092M-5H64
5npwYH_PwngDFgmZ,1645536057,–°—ñ–ª—å–ø–æ,5411,5411,-26000,-26000,980,0,390,2952070,False,P715-975X-CPC5-CEC5
_VF6davUP-xx5Xvo,1645534547,Bolt,4121,4121,-6200,-6200,980,0,465,2978070,False
bEKmSUT9KrkY6b-2,1645516729,–ö–æ–ª–æ,5411,5499,-13000,-13000,980,0,195,2984270,False,8TCP-B7T9-1C81-3HBA
9K8Vddzt8RIeWFC2,1645516400,Kafe Right Coffee Bar,5814,5814,-5500,-5500,980,0,0,2997270,False,1654-BXC0-BKKB-0XTB
ppMMLr58rdH2JZ6J,1645452690,"–ö–∏—ó–≤—Å—Ç–∞—Ä
+380978495150",4814,4814,-2500,-2500,980,0,0,3002770,True,22AX-8A83-6669-XCX5
83skikUA-BouNvBt,1645449862,Lesya,4829,4829,-1000000,-1000000,980,0,0,3005270,True,MC80-BKXX-X1KB-9C10
nqSybLuEheSx71gc,1645447208,–íi–¥: –ü–†–ò–•–û–î–¨–ö–û –ï.–í. –§–û–ü,4829,4829,2000000,2000000,980,0,0,4005270,True
n12BRT9wN89AC59C,1645381058,Lesya,4829,4829,-120000,-120000,980,0,0,2005270,True,K9H6-0E93-BB2T-CPA9
A1ghz-ruk6G8NofX,1645365271,ZAZIKO(LVIVSKA),5812,5812,-37500,-37500,980,0,0,2125270,False,T659-BT1M-KPEC-271E
N9bF4tGUzYEZG3Nu,1645359945,Bolt,4121,4121,-14800,-14800,980,0,1110,2162770,False,KKC5-1C3X-C643-402B
vtQlpDmbo1xvtdIq,1645358286,RestoranHendriksBar,5814,5814,-47600,-47600,980,0,0,2177570,False,3C90-4E17-A951-XA29
yLPjixndu3LxfOzw,1645355431,–°–∫–∞—Å—É–≤–∞–Ω–Ω—è. Bolt,4121,4121,15200,15200,980,0,-1140,2225170,False
xAnrFr-peOrwJca9,1645355320,Bolt,4121,4121,-15600,-15600,980,0,1170,2209970,False,BP0P-XAT2-ECK0-77KP
oNJ1KhGwLDkmlw04,1645353335,Bolt,4121,4121,-15200,-15200,980,0,1140,2225570,False
TZhZJxKWHwPUdZDc,1645349476,–°–∫–∞—Å—É–≤–∞–Ω–Ω—è. Bolt,4121,4121,5500,5500,980,0,-412,2240770,False
ZVtQFwtkW5gXaHfi,1645349458,Bolt,4121,4121,-5500,-5500,980,0,412,2235270,False,XA86-2MAM-X3A4-5AHM
yjW2QNLmHqaueSKW,1645349405,Bolt,4121,4121,-5500,-5500,980,0,412,2240770,False
sdNylTuOPkpnaMfd,1645343130,Bolt,4121,4121,-5500,-5500,980,0,412,2246270,False,TE68-294M-EE9C-H9AP
2m0BPWkh6UCposMk,1645277106,bwtc cafe&roasters,5814,5814,-10000,-10000,980,0,0,2251770,False,C8C4-T83K-H8TK-H0XK
j-UXa9G5cl2qTvvi,1645267300,–°—ñ–ª—å–ø–æ,5411,5411,-26000,-26000,980,0,390,2261770,False,KHBA-P486-C286-A787
bLudfm-b77-N5TSW,1645263397,Simona,5814,5814,-67500,-67500,980,0,0,2287770,False,86B3-B076-0HH9-MTK4
31ebqNBrmc7I74so,1645197275,Novapay,8999,8999,-6800,-6800,980,0,0,2355270,False,1K0P-19B7-35PK-P3KH
QNNl9KIFXYHlCxON,1645171927,LIQPAY*FunKeys,5045,5045,-550000,-550000,980,0,0,2362070,False,8AX5-XT69-8C9P-APMX
UWWrCF1OTCNSQR3D,1645126664,Bolt,4121,4121,-8400,-8400,980,0,630,2912070,False,17H5-X458-9C23-K8H0
PUDT2PoQGFnAMSvp,1645121392,Bolt,4121,4121,-10900,-10900,980,0,817,2920470,False,EM93-A0XB-BHC1-B48M
zkVvVcoQ9cGrJDKJ,1645120820,–ö–æ–ª–æ,5411,5499,-31850,-31850,980,0,477,2931370,False,A8AK-0C51-CPBA-1APH
XoxoSfKm25GVAz8t,1645102851,–ö–æ–ª—è –û–≥–æ–π–∫–æ,4829,4829,-40000,-40000,980,0,0,2963220,True,330M-B8E7-9X8A-KXA6
m8kocYXCvwGxgBQS,1645100896,Lesya,4829,4829,-1000000,-1000000,980,0,0,3003220,True,132C-15M5-P4HH-374X
zMeh8srjeXSsutDe,1645094141,–íi–¥: –ü–†–ò–•–û–î–¨–ö–û –ï.–í. –§–û–ü,4829,4829,2600000,2600000,980,0,0,4003220,True
Yux8hzBQZzaZH_Cx,1645088863,WFP*CLOTHING,5691,5691,-183200,-183200,980,0,0,1403220,False,H705-K3X8-K356-XK5H
_pg5xn9-vJ2PchK2,1645024507,WFP.AQUAMARKET_,5411,5411,-66500,-66500,980,0,498,1586420,False,805B-4H6A-H296-652B
tAEEGeF1DPncgSp8,1644998343,"Lifecell
+380631692598",4814,4814,-5000,-5000,980,0,0,1652920,True,8TXE-XE02-10C3-AMM1
wD89nguSYXzOCknL,1644998302,"Lifecell
+380631692598",4814,4814,-15000,-15000,980,0,0,1657920,True,90A3-C16A-276X-M0KE
cnFzxZjObJtMoLz_,1644992310,ZOOLUX,5995,5995,-96500,-96500,980,0,0,1672920,False,K81H-5CMM-8H59-TT4H
wy9YvOFHC3cdPS9G,1644921108,Produkti,5499,5499,-14000,-14000,980,0,105,1769420,False,P989-62K0-0P19-H1P6
0_oLlqgH0cDOywXK,1644920532,Mates,5814,5814,-5000,-5000,980,0,0,1783420,False,5P2B-1BHB-03PK-AM59
HlnGOv5YADLkVpEA,1644919410,Mates,5814,5814,-11000,-11000,980,0,0,1788420,False,ATT7-E4B9-4M49-23T8
V1sa8k8HDsOzxPv4,1644845045,FOP PASHKOVA L. V.,5499,5499,-101988,-101988,980,0,764,1799420,False,2XMM-203A-MCM0-CE0B
iY2q8fOU5PjH0pXA,1644755866,Novus,5411,5411,-28000,-28000,980,0,210,1901408,False,0XXP-3P3A-XTAB-K90P
J0dgDv8mt6f8cvRW,1644755690,Novus,5411,5411,-27298,-27298,980,0,204,1929408,False,XB6M-MCET-T5MM-TTP1
rfhvP_SBz_Kth3TN,1644753780,bwtc cafe&roasters,5814,5814,-24000,-24000,980,0,0,1956706,False,76K5-883E-00K8-915B
sLSf6liMvryrm8Ot,1644688081,katsusando,5814,5814,-70000,-70000,980,0,0,1980706,False,HB23-7BA7-9A25-AXH8
HiSB_Qo_SJJ0MG9t,1644687628,Yaroslaviv Val 37-1,5499,5499,-3990,-3990,980,0,59,2050706,False,H0PM-3KXH-52PC-0564
1J-y1GuS27HArHNG,1644670658,–°–∫–∞—Å—É–≤–∞–Ω–Ω—è. Bolt,4121,4121,5500,5500,980,0,-412,2054696,False
w-dwaRnoxExCR8D2,1644670587,Bolt,4121,4121,-5900,-5900,980,0,442,2049196,False,E6H9-A9TP-68TA-7M9C
6Ux99CYPvbdZnamo,1644668817,Bolt,4121,4121,-5500,-5500,980,0,412,2055096,False
cSSn1y9iDvtWv7jG,1644659550,Lesya,4829,4829,-400000,-400000,980,0,0,2060596,True,BHKC-TKP8-E1KM-A0C6
TGMimbi9MGFvRkLZ,1644584344,–í—ñ–¥: –ë–æ–≥–¥–∞–Ω –ë—ñ–ª–æ—à–∏—Ü—å–∫–∏–π,4829,4829,50000,50000,980,0,0,2460596,True
sqkOia67SnHVTcdn,1644584227,LIQPAY*Kozhen Mozhe,8398,8398,-50000,-50000,980,0,0,2410596,False,371X-MT7P-P1P9-315B
x5qqAGgN4MpoEdOe,1644575823,Lesya,4829,4829,-2500000,-2500000,980,0,0,2460596,True,BM8K-3A3B-X066-723B
QLxwJD_84Dxb64or,1644575789,–íi–¥: –ü–†–ò–•–û–î–¨–ö–û –ï.–í. –§–û–ü,4829,4829,3300000,3300000,980,0,0,4960596,True
SMj7yjhh-ziW3y7g,1644571800,LIQPAY*Kozhen Mozhe,8398,8398,-100000,-100000,980,0,0,1660596,False,H8P6-K276-X563-6TEK
N19f_x32dAW15CF6,1644564926,–ö–æ–ª–æ,5411,5499,-21000,-21000,980,0,157,1760596,False,H0A2-PMPA-XPPB-0CA9
B-Xf84y2jX8aLZ1G,1644564748,–ê–ø—Ç–µ–∫–∞ ‚Ññ7,5912,5912,-27000,-27000,980,0,0,1781596,False,EXPM-255H-2682-9C7B
bm-4dQPOfBppE3V5,1644498726,–°–∫–∞—Å—É–≤–∞–Ω–Ω—è. Bolt,4121,4121,6000,6000,980,0,-45,1808596,False
K94K9QePAnMA9-P2,1644498135,Bolt,4121,4121,-7000,-7000,980,0,52,1802596,False,21H5-2885-E690-CTH1
fbIZitRL6Ose9E7c,1644497490,Bolt,4121,4121,-6000,-6000,980,0,45,1809596,False
89zBiATZtqtR3-XL,1644432370,LIQPAY*Fonarik.com,5200,5200,-100000,-100000,980,0,0,1815596,False,902C-2T0K-314B-PB63
qJtXYbh6UnwbCKRW,1644429707,WFP.AQUAMARKET_,5411,5411,-45600,-45600,980,0,342,1915596,False,C1CM-T7XH-TBA7-7A2X
jG4pTmbWjQDi5wSx,1644394180,Novus,5411,5411,-28000,-28000,980,0,210,1961196,False,87E5-E120-23C6-7675
FjJcbA0apTj6WXua,1644327859,Bolt,4121,4121,-6400,-6400,980,0,48,1989196,False,93KC-EP2B-4X04-B75C
ltWeJTbHKxN1QJJV,1644310711,"Lifecell
+380631692598",4814,4814,-15000,-15000,980,0,0,1995596,True,C470-0874-C128-4PEM
OoSfShMwDELQE3GU,1644250731,Cooker,5499,5499,-38277,-38277,980,0,574,2010596,False,190X-EC94-3HH9-T9KM
FSSm_7cqAEy0WtPk,1644230506,Lesya,4829,4829,-900000,-900000,980,0,0,2048873,True,9T86-TC08-KEK8-K65X
xcqHFB1UZqKxK6mg,1644228886,414962****1277,4829,4829,-771500,-771500,980,0,0,2948873,True,CK9X-742X-M2HC-HPK1
2jVtLpzCpAwPnYWI,1644227715,–íi–¥: –ü–†–ò–•–û–î–¨–ö–û –ï.–í. –§–û–ü,4829,4829,2000000,2000000,980,0,0,3720373,True
PCV3Bz55euULlRGf,1644221244,–ö–æ–ª–æ,5411,5499,-21000,-21000,980,0,157,1720373,False,P25P-A091-M08E-0349
9ScXupeSG-2qzEmN,1644148296,Novus,5411,5411,-47230,-47230,980,0,354,1741373,False,E04E-360P-85CP-A08C
J8xTcuE7iJfrZMSY,1644144339,bwtc cafe&roasters,5814,5814,-9000,-9000,980,0,0,1788603,False,61XC-5EP8-K0B9-4H83
ZW3cP2u-2jU9Tkxb,1644062240,–ö–æ–ª–æ,5411,5499,-14000,-14000,980,0,105,1797603,False,2K72-A1C4-ABM9-526H
T3-YzW1LF1juT4XU,1643988927,–°–∫–∞—Å—É–≤–∞–Ω–Ω—è. Bolt,4121,4121,7700,7700,980,0,-57,1811603,False
44SW3tyJIpG-pLlY,1643988490,Bolt,4121,4121,-7700,-7700,980,0,57,1803903,False
TKEiXbB93kSN-7vZ,1643965121,bwtc cafe&roasters,5814,5814,-4500,-4500,980,0,0,1811603,False,PX8M-60B0-M5EP-K498
5adfKxk3AQtPtfgD,1643906564,Produkti,5499,5499,-14000,-14000,980,0,105,1816103,False,762T-B24T-HC16-CT4T
lm4YVAI94uBFS5KS,1643883759,WFP.AQUAMARKET_,5411,5411,-25080,-25080,980,0,188,1830103,False,P263-6P74-5T6P-5AE5
nduMLuJqZTkylO4N,1643821688,–ê–ø—Ç–µ–∫–∞ –ê–ù–¶,5912,5912,-148500,-148500,980,0,0,1855183,False,BK05-61M5-15HH-25BM
L9AayBbDj8OUuC7N,1643795840,Bolt,4121,4121,-5500,-5500,980,0,0,2003683,False,HT05-PHK9-286P-XXET
ETLqLvB4KHXXsmaE,1643710669,–§–û–ü –ö—É—Ü–µ–Ω–∫–æ –ü–µ—Ç—Ä–æ,4829,4829,-108900,-108900,980,0,0,2009183,True,X85K-2H6P-106K-TP5K
4Xl2iFmRQrzSvR2q,1643679866,–í—ñ–¥—Å–æ—Ç–∫–∏ –∑–∞ —Åi—á–µ–Ω—å,4829,4829,475,475,980,0,0,2118083,True
4TXOlphlJ7RR6UOb,1648652335,–Ü—Ä–∏–Ω–∞ –ö.,4829,4829,-10000,-10000,980,0,0,2650694,True,5E8H-13EX-KE38-767X
vhs74qieCm5Ye-jX,1648641332,SKEChERS1,5661,5661,-219900,-219900,980,0,0,2660694,False,3PP6-7836-56C6-HA28
oukOvcuvVitFoKNY,1648636158,Epic Cheeseburger,5812,5812,-133800,-133800,980,0,0,2880594,True,T4X0-37B5-30TK-6K1C
4e6azLoVgNdxbNSF,1648630562,KNIGY NA FEDOROVA,5192,5942,-18000,-18000,980,0,0,3014394,False,03M5-XKB9-706E-TB54
u4lSnAaZv-8PRfVY,1648547466,Lesya,4829,4829,-700000,-700000,980,0,0,3032394,True,5758-EPX2-95KH-3CH0
bQ9RsOBZVZyXNUgZ,1648365316,TsRMMODRiChI1,7011,7011,-600000,-600000,980,0,0,3732394,False,5P7A-8C79-E6A9-83M7
EGxoJF5VjUJRXbqX,1648365285,FOPChupikMariyaPavlivna,7011,7011,-713000,-713000,980,0,0,4332394,False,XAC2-TC18-K855-5M91
2_GJqBbLaV6P_Z9I,1648327653,–ú–∏—Ö–∞–π–ª–æ –°.,4829,4829,-20000,-20000,980,0,0,5045394,True,E181-PA20-A316-1PH2
Jpn34_oatadfVWRH,1648210817,–ï–¥—ñ—Ç–∞ –ö.,–¢–∞—Ç—É —ñ –ë–∞–π—Ä–∞–∫—Ç–∞—Ä—á–∏–∫—É üê∂,4829,4829,-200000,-200000,980,0,0,5065394,True,KMH2-T00H-H4X0-33BH
US1Xf3vGPWLLj0YF,1648204912,Lesya,4829,4829,-1000000,-1000000,980,0,0,5265394,True,M6PM-E5P7-M2K3-AC57
D4LInc8HAwXEfXIO,1648204456,–íi–¥: –ü–†–ò–•–û–î–¨–ö–û –ï.–í. –§–û–ü,4829,4829,4000000,4000000,980,0,0,6265394,True
n0f_GwwrnZfhyPKA,1648119632,–ö–æ—Å—Ç—è–Ω—Ç–∏–Ω –ê.,–ë–µ—Ä—Ü—ã üë¢,4829,4829,-200000,-200000,980,0,0,2265394,True,61H6-1A0E-BAC0-TMXC
QRFwS6NbVTQA5U5G,1648112723,–∫—ñ–ª—å—Ü–µ –î—Ä–æ–≥–æ–±–∏—Ü—å–∫–∞ - –°—Ç–µ–±–Ω–∏—Ü—å–∫–∞,5499,5499,-13400,-13400,980,0,0,2465394,False,5P1C-472E-TMCA-XPE3
SrmJZFdcU47WoGGO,1648111707,OKKO,5541,5541,-90948,-90948,980,0,2046,2478794,False,2MMB-BM09-9X61-M351
n6WcRgOtJPEs_Dq2,1648022346,TsRMMODRiChI1,7011,7011,-480000,-480000,980,0,0,2569742,False,CCPK-PBE6-08KH-X05E
SgOacsPY0rDTo_To,1648022320,FOPChupikMariyaPavlivna,7011,7011,-570400,-570400,980,0,0,3049742,False,6603-E11C-7CBP-2P6T
M8zlir-_NLa-mmcZ,1647857654,Lesya,4829,4829,-1000000,-1000000,980,0,0,3620142,True,71HC-047E-835P-9KP9
_tAQFrm-SJ06DIpM,1647857596,–íi–¥: –ü–†–ò–•–û–î–¨–ö–û –ï.–í. –§–û–ü,4829,4829,2300000,2300000,980,0,0,4620142,True
ZwvdwChhJYKFqFDo,1647677791,TsRMMODRiChI1,7011,7011,-480000,-480000,980,0,0,2320142,False,52KT-3XA2-XXHT-562K
BMTd_cmPF21EN5GS,1647677765,FOPChupikMariyaPavlivna,7011,7011,-570400,-570400,980,0,0,2800142,False,44K1-K739-6852-B6T8
8elE00_02VTcthdA,1647524192,Lesya,4829,4829,-700000,-700000,980,0,0,3370542,True,EKA0-BE61-8573-19PT
KVhAchdx8CkGT1FG,1647341748,–∫—ñ–ª—å—Ü–µ –î—Ä–æ–≥–æ–±–∏—Ü—å–∫–∞ - –°—Ç–µ–±–Ω–∏—Ü—å–∫–∞,5499,5499,-80960,-80960,980,0,0,4070542,False,5B0M-TK50-KAM9-P98T
KbsixQ84iEnbgQqy,1647330144,TsRMMODRiChI1,7011,7011,-480000,-480000,980,0,0,4151502,False,PBAA-7M8E-63CX-ECHM
NIkvRfhVzUmgjB63,1647330119,FOPChupikMariyaPavlivna,7011,7011,-570400,-570400,980,0,0,4631502,False,94K2-T3PP-071B-T24H
p4x4co11OTjuwluJ,1647250797,Lesya,4829,4829,-1000000,-1000000,980,0,0,5201902,True,TA6B-E631-410A-K7P0
axpGrpUjooQ3g-Ge,1647250768,–íi–¥: –ü–†–ò–•–û–î–¨–ö–û –ï.–í. –§–û–ü,4829,4829,4400000,4400000,980,0,0,6201902,True
eUHZo0zYjRrftQJ7,1647198780,Google,7372,7372,-200,-200,980,0,0,1801902,False,24BH-19H7-3PHH-XAAX
-HliU-vh5URwM1_8,1647183563,Pethouse,5995,5995,-338800,-338800,980,0,0,1802102,False,EX9T-155T-5T7B-4E78
X0H7_OmNaFl2BgId,1647159606,TsRMMODRiChI1,7011,7011,-240000,-240000,980,0,0,2140902,False,4P0K-P11X-81A0-490X
tpNbwgsIjSwlvS-l,1647159581,FOPChupikMariyaPavlivna,7011,7011,-285200,-285200,980,0,0,2380902,False,89H8-42PM-257M-12P4
bxcUc8aIr6mn05-V,1647071873,Lesya,4829,4829,-500000,-500000,980,0,0,2666102,True,T55A-70C4-75E7-B07M
-fS2PgBmYvGbHnkm,1647019412,516874****1885,4829,4829,-50000,-50000,980,0,0,3166102,True,H4EK-KB8X-KX17-15KC
tvr4xppBsPQq1ojE,1647001580,–ë–∞–Ω–∫–æ–º–∞—Ç DN00 Sahaidachnoho  st,6011,6011,-1000000,-1000000,980,0,0,3216102,False,M94C-133T-A2K0-9985
XqR4qhsfImxWz4sI,1647001320,SHOP KARAVAN,5712,5712,-15750,-15750,980,0,0,4216102,False,PBX8-HC6X-8X8C-9157
bIpsV2ANEnnKezT5,1647000648,–°–≤—ñ–π –ú–∞—Ä–∫–µ—Ç,5499,5499,-35898,-35898,980,0,0,4231852,False,BHMT-MT5H-7EXT-XX4B
N1sE5TzmxAm92y8B,1646992859,516874****9228,4829,4829,-50000,-50000,980,0,0,4267750,True,CC6T-734C-07H7-10E0
w77X2d86BZGQNlSw,1646988334,–ü–æ–ø–æ–≤–Ω–µ–Ω–Ω—è ¬´–ù–∞ –ª—ñ–∫–∏ –¥–ª—è —Ö–ª–æ–ø—Ü—ñ–≤üíõ¬ª,4829,4829,-100000,-100000,980,0,0,4317750,True,6C7H-TMBP-CH5E-3P1T
YBIBoDMXWaINoEgy,1646909865,Lesya,4829,4829,-1000000,-1000000,980,0,0,4417750,True,097K-6ABX-7597-3HKB
YdUJ0opFIc5QMBis,1646906034,FDY*Clothing,5691,5691,-603000,-603000,980,0,0,5417750,False,H0C4-A6B8-KA7B-A4B6
MsF_jgB_h_zzJzBj,1646812708,LIQPAY*KU Mikolayivski,7922,7922,-50000,-50000,980,0,0,6020750,False,ET6H-3436-5M1H-7PH1
-dztQ_LF7wljqPym,1646809796,TsRMMODRiChI1,7011,7011,-120000,-120000,980,0,0,6070750,False,BP99-57T8-4P7P-C68P
cJ-XBk5xAoBvt6Mb,1646809758,FOPChupikMariyaPavlivna,7011,7011,-142600,-142600,980,0,0,6190750,False,8PTM-PBH8-4TP6-TK48
WXkrPKBF3DM9NfEE,1646739797,PARK ZDOROVJA,7011,7011,-280000,-280000,980,0,0,6333350,False,9C14-X1HP-P9T5-C6EX
AIqTfPvC3x8wwO8K,1646583921,–°–∫–∞—Å—É–≤–∞–Ω–Ω—è. Bolt,4121,4121,9500,9500,980,0,0,6613350,False
iYjNzlm8R25sSLDb,1646583864,Bolt,4121,4121,-12500,-12500,980,0,0,6603850,False,TA2T-0MXC-2K7T-B5X7
3CETTpUs2bkHO5gU,1646582214,Bolt,4121,4121,-9500,-9500,980,0,0,6616350,False
9kq3Lsj7Te0vxt3L,1646576624,Bolt,4121,4121,-6100,-6100,980,0,0,6625850,False,BKKH-3T26-776B-77X2
2lSXHKssG-rZWiuO,1646474214,MasterZoo,5995,5995,-52200,-52200,980,0,0,6631950,False,37HP-XBET-T4H9-54CC
nvFkWfOML2sHntPi,1646472618,Persha socialyna apteka,5912,5912,-106090,-106090,980,0,3182,6684150,False,2E8E-1KAE-TH14-1606
Ub8MBGJWBb2m8aRs,1646395952,Lesya,4829,4829,-1500000,-1500000,980,0,0,6790240,True,BBEH-AHP4-14KA-K3MH
gWHE5UyhwlMk6J8i,1646308327,MagazinkapheterijKasht,5499,5499,-125585,-125585,980,0,0,8290240,False,A20A-MKME-M2E1-3B2K
sci6DMqg1AWqScc3,1646306490,–§–æ—Ä–∞,5499,5499,-187555,-187555,980,0,0,8415825,False,KC38-T97K-1HXE-8M24
44zUBG4w_MFVs4iE,1646302893,–íi–¥: –ü–†–ò–•–û–î–¨–ö–û –ï.–í. –§–û–ü,4829,4829,3000000,3000000,980,0,0,8603380,True
PII3RuxdThg-jBnw,1646095664,–í—ñ–¥—Å–æ—Ç–∫–∏ –∑–∞ –ª—é—Ç–∏–π,4829,4829,1144,1144,980,0,0,5603380,True
CdZk6XgeDmR43-6z,1651212706,–û–±—Å–ª—É–≥–æ–≤—É–≤–∞–Ω–Ω—è –ø–ª–∞—Ç–∏–Ω–æ–≤–æ—ó –∫–∞—Ä—Ç–∫–∏,4829,4829,-30000,-30000,980,0,0,2994481,True
m71EWZu9fyEGRpSa,1651147265,magazin 3000873,5411,5411,-90768,-90768,980,0,907,3024481,False,PCC3-BHAP-K0K8-5CE9
r7gcL9TEjsmm3pJr,1651071487,Bolt,4121,4121,-8100,-8100,980,0,0,3115249,False,X84K-6T44-5A2B-E140
t3NAM6WiRmujYKvR,1651063900,Bolt,4121,4121,-10600,-10600,980,0,0,3123349,False,H8PK-HXP6-MMMM-CM83
NlPbILTyKYkN2vw5,1650968714,Lesya,4829,4829,-2000000,-2000000,980,0,0,3133949,True,3PK7-P96X-1MCT-3H52
Xk5LKnIdVEO3jXS5,1650965628,–íi–¥: –ü–†–ò–•–û–î–¨–ö–û –ï.–í. –§–û–ü,4829,4829,2500000,2500000,980,0,0,5133949,True
-wh6U-phc1d2-j1c,1650885810,magazin 3000873,5411,5411,-64731,-64731,980,0,647,2633949,False,7TX9-TA9A-CX3C-405C
RlE-RK6vdkK7BrOg,1650881265,Lesya,4829,4829,-500000,-500000,980,0,0,2698680,True,TMXM-1309-XE47-XE3P
h4YOnEDxOJhHclB9,1650880469,WOG,5541,5541,-37400,-37400,980,0,561,3198680,False,TK33-9161-B94E-5AXH
BC-AtMVDOOC_6eZO,1650879172,CILYTEL,5912,5912,-217850,-217850,980,0,0,3236080,False,7PAH-AAPX-56MP-AP8T
qAk_xU5ik0KdTnQI,1650714899,–ù–æ–≤–∞ –ø–æ—à—Ç–∞,4214,4214,-5100,-5100,980,0,0,3453930,False,50PP-E4XC-58AT-08C4
U3wZbhEBzw2kSEjg,1650706617,–°–µ—Ä–≥—ñ–π –ö.,4829,4829,-19400,-19400,980,0,0,3459030,True,AMC8-9MC2-6KXC-360K
bRD2rW3LlIFFaUoO,1650647877,–Ñ–≤–≥–µ–Ω –ë–∞–π—Ç–µ—Ä—è–∫–æ–≤,4829,4829,-500000,-500000,980,0,0,3478430,True,6KKC-6BA4-02T6-M0TC
QGjNxZtJgCvcwQEM,1650612775,516875****0909,4829,4829,-100000,-100000,980,0,0,3978430,True,XXE9-0M76-5H7A-M3PA
XaSh99aGp-3MFu0w,1650541784,Lesya,4829,4829,-100000,-100000,980,0,0,4078430,True,05M4-H60X-MKA1-3HE7
l5KXgcYDFiLMh-BG,1650541234,–£–∫—Ä–Ω–∞—Ñ—Ç–∞,5541,5541,-77328,-77328,980,0,1159,4178430,False,7MPP-6KM5-02M0-1P2K
bxl5kzgHHiN8Jaou,1650530650,TsRMMODRiChI1,7011,7011,-600000,-600000,980,0,0,4255758,False,X478-193K-MA4M-3B9K
ux58oGuxcUmT6nAw,1650530624,FOPChupikMariyaPavlivna,7011,7011,-713000,-713000,980,0,0,4855758,False,H983-T83E-17ME-7PXM
8yGQKL3JuNtQfIHZ,1650530059,–íi–¥: –ü–†–ò–•–û–î–¨–ö–û –ï.–í. –§–û–ü,4829,4829,2700000,2700000,980,0,0,5568758,True
6D6NkGAIEn9M5tOV,1650480510,–ö—Å–µ–Ω—ñ—è –ì.,–ß–æ–±—ñ—Ç –¥–ª—è –û–ª–µ—Å—ñ üë¢,4829,4829,-900000,-900000,980,0,0,2868758,True,9KAE-0T80-80C5-89HP
0fCtRMGuLklPc3mG,1650440446,Lesya,4829,4829,-500000,-500000,980,0,0,3768758,True,C66B-23PA-7XT2-25K6
4OxRCplrot7DAOlW,1650381570,516936****4246,4829,4829,-177800,-177800,980,0,0,4268758,True,80A6-A10T-H5H7-E3EX
PFVXvwz7LhHUJcH6,1650371407,Lesya,4829,4829,-250000,-250000,980,0,0,4446558,True,M236-9780-C03A-7TT7
BmQRMygHE1voi1P-,1650280975,Lesya,4829,4829,-800000,-800000,980,0,0,4696558,True,BTAH-1T7K-BK69-C5PB
lV0QGpHnX1SP7AsO,1650274149,–íi–¥: –ü–†–ò–•–û–î–¨–ö–û –ï.–í. –§–û–ü,4829,4829,4300000,4300000,980,0,0,5496558,True
E_Y304D4H5ZO51Bp,1650219962,WFP.CLOTHING*WFP,5651,5651,-138000,-138000,980,0,0,1196558,False,4BKA-47EX-BH21-H7HK
YhGRs0TKEnHSeL3S,1650100631,TsRMMODRiChI1,7011,7011,-600000,-600000,980,0,0,1334558,False,1X4X-9321-59HH-8011
rnGA6wDzdK0_hrNT,1650100596,FOPChupikMariyaPavlivna,7011,7011,-713000,-713000,980,0,0,1934558,False,C27C-A0MM-MTME-XKTH
MkuyjuEo-nprkbul,1650046699,–£–∫—Ä–Ω–∞—Ñ—Ç–∞,5541,5541,-3916,-3916,980,0,58,2647558,False,KM5P-ETA2-EE9C-X625
-wAdq73pKDymv4sx,1650046518,–£–∫—Ä–Ω–∞—Ñ—Ç–∞,5541,5541,-85140,-85140,980,0,1277,2651474,False,6042-370T-A301-C804
fC267PZnMmqJVTbL,1650040203,–ê–¢–ë,5411,5411,-28390,-28390,980,0,283,2736614,False,0188-KKCM-C9BX-XP0H
8we417LlIu0XT0YJ,1650036150,Cheese Bakery 2.0,5812,5812,-73200,-73200,980,0,0,2765004,True,3HM5-26TX-BXC1-C7AB
aW2zCYM6FhuoUiJ5,1650035062,–ü—Ä–∞–≤–¥–∞. Beer Theatre,5812,5812,-6000,-6000,980,0,0,2838204,False,BTBB-0KPX-PX1T-21T7
vIx3N52QXWBqlfht,1650035040,"–¢–µ–∞—Ç—Ä –ø–∏–≤–∞ ""–ü—Ä–∞–≤–¥–∞""",5812,5812,-35600,-35600,980,0,0,2844204,False,PC62-86E1-4M2T-MEH2
uZf9d1hARdmzb2-4,1650033102,KNIGY NA FEDOROVA,5192,5942,-8000,-8000,980,0,0,2879804,False,A3AB-T3H6-T5TB-X77A
t6EeRXl5YeAIi40-,1650032005,A 322,5912,5912,-187998,-187998,980,0,0,2887804,False,60X3-K1PA-XXE5-A2A7
AjryZKk2mkwO9K3V,1650031632,glo‚Ñ¢ STUDIO,5993,5993,-70000,-70000,980,0,0,3075802,False,X7KM-TKH1-EXM1-0428
Q1TKKRzFIA0FxRSW,1650021482,DODOSOKS,5651,5651,-54000,-54000,980,0,0,3145802,False,HB83-P547-2104-XA71
cM3daKf51uOopZqg,1650019078,RestoranFrancuzskieka1,5814,5814,-49300,-49300,980,0,0,3199802,False,X72C-9EMH-13KM-3531
tJQmERFJqQLb4tUQ,1650012811,FOP SHUMANSKYY N . O.,5812,5812,-73500,-73500,980,0,0,3249102,False,8H77-K058-X356-B34M
hOWpNJbyzUQZ_WQl,1649958482,535432****2069,4829,4829,-100000,-100000,980,0,0,3322602,True,51BT-9P7H-9ABC-886X
q9Y210dYCYZ1lbXT,1649937067,–†—É–¥—å,5942,5942,-13000,-13000,980,0,0,3422602,False,ET7M-4C4H-2XT4-1E5K
UJyZi0-beewZkN5F,1649776731,Lesya,4829,4829,-500000,-500000,980,0,0,3435602,True,AH93-MC66-070M-EA85
cYg3PIyVs61f7eCo,1649775442,–í–æ–ª–æ–¥–∏–º–∏—Ä –ü.,–ú–∞—Ä—ñ—É–ø–æ–ª—å ‚úä,4829,4829,-200000,-200000,980,0,0,3935602,True,M126-KX3B-E6E3-C40E
cIfyV9ug23Nv-7kU,1649675903,Lesya,4829,4829,-1000000,-1000000,980,0,0,4135602,True,6CAP-C2A6-68C5-BEXH
rETAyEdOpqU60svz,1649669297,Lesya,4829,4829,-1000000,-1000000,980,0,0,5135602,True,B8X8-1THP-M3KT-MX5H
mW0va_F-HnYwAtP1,1649666166,–íi–¥: –ü–†–ò–•–û–î–¨–ö–û –ï.–í. –§–û–ü,4829,4829,4000000,4000000,980,0,0,6135602,True
dxT_1SWP0iFy9YcW,1649665024,"Lifecell
+380631692598",4814,4814,-20000,-20000,980,0,0,2135602,True,931P-HAE7-AK91-HT1P
_zHKhI1krRkseUoV,1649597198,–õ—å–≤—ñ–≤—Å—å–∫–∞ –ú–∞–π—Å—Ç–µ—Ä–Ω—è –®–æ–∫–æ–ª–∞–¥—É,5411,5411,-30500,-30500,980,0,305,2155602,False,6C67-3X1X-9B27-KAM8
IgAkzwgpi4FW7gD4,1649594933,–î—ñ–∞–Ω–∞ –®.,4829,4829,-12000,-12000,980,0,0,2186102,True,C851-PAXM-9X31-T447
nM481NO5f0L53WiS,1649594881,Hnkalnya,5814,5814,-102000,-102000,980,0,0,2198102,False,04C4-3975-B9C4-K1K9
fQNZ6U3pXB3-kaKV,1649505586,–ü–æ–≤–µ—Ä–Ω–∏—Å—å –∂–∏–≤–∏–º,4900,4900,-1430000,-1430000,980,0,0,2300102,True,ETMT-KTKC-7CC1-PX79
7-HNPCfJbqlQMn8B,1649499925,414949****4122,4829,4829,-17085,-17085,980,0,0,3730102,True,KEHE-6PKH-TKCX-C8MX
jhtW2Cmhx2Yt-GVg,1649499794,magazin 3000873,5411,5411,-27765,-27765,980,0,277,3747187,False,7HE6-E203-M7PC-T920
FW0DqhmjfiFoglAP,1649496340,PunktN6,5399,5399,-55000,-55000,980,0,550,3774952,False,6TXB-2PTM-H433-645C
0jSHinMAs7h1-lkU,1649496217,FAST FUD DYADKO SEM,5921,5921,-30000,-30000,980,0,300,3829952,False,KPMH-AHT5-8H6M-7M2P
gNReT3orEEXz-NM1,1649491769,Karavan,5200,5200,-162600,-162600,980,0,0,3859952,False,MT4E-CM68-4XX7-P2P6
swHCdku8vfSwSSIN,1649491302,PLN A1 TRUSKAVETS SAGAIDA,5912,5912,-40530,-40530,980,0,0,4022552,False,7588-BAC4-EM1X-X47M
Kv7OGpOY1i8gMVzr,1649491091,–ó–æ–æ–º–∞–≥–∞–∑–∏–Ω,5995,5995,-15100,-15100,980,0,0,4063082,False,P55T-31B6-7XPK-08K9
9mSTj8RwCu-Cow4H,1649439180,–í–æ–ª–æ–¥–∏–º–∏—Ä –ü.,4829,4829,-300000,-300000,980,0,0,4078182,True,3MAT-XTM9-0MXH-1P87
Ch4LSvwYFgPW848x,1649428561,"–ë–∞–Ω–∫–æ–º–∞—Ç DN00 st.Torosevicha,5",6011,6011,-500000,-500000,980,0,0,4378182,False,EM79-36X7-B45C-XAA7
rpu3mxs2bfOUqz93,1649425312,FARMAKO A16,5912,5912,-29510,-29510,980,0,0,4878182,False,M7MX-30E4-706X-7H3M
yqIjS_3hHH5w_TWP,1649424764,MTS KONSYLIUM,8099,8099,-45000,-45000,980,0,0,4907692,False,9K0M-2C1B-X0X5-H4M7
KeoWELatdebtNoCT,1649412265,–íi–¥: –ü–†–ò–•–û–î–¨–ö–û –ï.–í. –§–û–ü,4829,4829,2400000,2400000,980,0,0,4952692,True
6efRu8lSrymNT0yY,1649403458,Lesya,4829,4829,-100000,-100000,980,0,0,2552692,True,XP67-B2BP-KPHT-93PP
jg-Dw7ztzQHIjNpH,1649359172,Lesya,4829,4829,-200000,-200000,980,0,0,2652692,True,MACC-20X2-EK79-K5CT
EGM3hLfMdhTuJnF-,1649320222,–ü–æ–ø–æ–≤–Ω–µ–Ω–Ω—è ¬´–ü—Ä–æ—î–∫—Ç ¬´–°–∏–ª—å–Ω—ñ¬ª¬ª,4829,4829,-200000,-200000,980,0,0,2852692,True,9KXB-762A-X659-E324
mONDPn2Te3d4MAYV,1649242875,TzOVVOKVERNIGORA,7011,7011,-50000,-50000,980,0,0,3052692,False,0T8C-A180-4HE7-M66K
m4BNitipVB4e1pFV,1649242848,TsRMMODRiChI1,7011,7011,-600000,-600000,980,0,0,3102692,False,623H-5E27-7860-2AT0
La-k6PxBOQRY0i6b,1649242822,FOPChupikMariyaPavlivna,7011,7011,-713000,-713000,980,0,0,3702692,False,06AX-4P9C-481H-XE85
gVfmXzwhjmpRgTeH,1649173159,Bolt,4121,4121,-8200,-8200,980,0,0,4415692,False,HTK7-T6PX-EPT5-2144
KY2r9SvPCXaljvaJ,1649163302,–û–ª–µ–Ω–∞ –ú.,–ù–∞ –º–∞—à–∏–Ω–∫—É. –°–º–µ—Ä—Ç—å –≤–æ—Ä–æ–≥–∞–º,4829,4829,-100000,-100000,980,0,0,4423892,True,XE6T-BATC-K3M2-K8MH
EmEjKOv-guy9_i6b,1649150958,–ù–∞—Ç–∞–ª—ñ—è –ì.,4829,4829,-80000,-80000,980,0,0,4523892,True,XCTA-3CBP-C81E-BKK8
wd5APz_vV-HYv8Wm,1648929666,–í—ñ–æ–ª–µ—Ç—Ç–∞ –û.,–ù–∞ —Å–º–µ—Ä—Ç—å –≤–æ—Ä–æ–≥–∞–º üá∫üá¶,4829,4829,-200000,-200000,980,0,0,4603892,True,5B19-99CA-01E7-4X97
bLjt2RYM4mo0rQS9,1648917465,Lesya,4829,4829,-1000000,-1000000,980,0,0,4803892,True,HX32-90E5-P02K-5B6M
uDa8djetwQrxZ9KE,1648893424,magazin 3000873,5411,5411,-64539,-64539,980,0,0,5803892,False,7E4H-9ABT-548X-67A6
VTvpt_Tn9v_nQZx5,1648890429,–ù–æ–≤–∞ –ø–æ—à—Ç–∞,4214,4214,-5300,-5300,980,0,0,5868431,False,2HT1-7E84-1E2H-CB7E
cvr-HfGgIpQr5k5P,1648890409,–ù–æ–≤–∞ –ø–æ—à—Ç–∞,4214,4214,-60300,-60300,980,0,0,5873731,False,4PXT-TCX8-K9C4-1MBH
3dpNf4DZ0JfGu5ro,1648889701,–ó–æ–æ–º–∞–≥–∞–∑–∏–Ω,5995,5995,-107700,-107700,980,0,0,5934031,False,P2KP-2060-7X95-HMB4
qc8c7cLOZrjzzLUq,1648807567,–íi–¥: –ü–†–ò–•–û–î–¨–ö–û –ï.–í. –§–û–ü,4829,4829,5100000,5100000,980,0,0,6041731,True
JlHTmr6O04Z9K1b4,1648801050,TsRMMODRiChI1,7011,7011,-600000,-600000,980,0,0,941731,False,2KEE-X3TK-6M64-2A24
nv_tlVdH6UOeeqom,1648801023,FOPChupikMariyaPavlivna,7011,7011,-713000,-713000,980,0,0,1541731,False,526P-P082-17PH-1KB9
gZ7e7yRFvm3eAcEK,1648781896,–í—ñ–¥—Å–æ—Ç–∫–∏ –∑–∞ –±–µ—Ä–µ–∑–µ–Ω—å,4829,4829,4037,4037,980,0,0,2254731,True
zJzzZs2z4aRFzHSk,1653930953,414943****3951,4829,4829,-40000,-40000,980,0,0,3570142,True,3ACP-CX0A-40HE-MCB1
WrXQsnHbW3GssXiv,1653914271,Lesya,4829,4829,-600000,-600000,980,0,0,3610142,True,7023-35A5-HE2E-PTE2
_uXs9vMkXKbbCIWr,1653907982,Bolt,4121,4121,-2052,-2052,980,0,0,4210142,False,4427-6K85-A69H-HA3P
F9KJK2FfS_obIKiY,1653904822,Bolt,4121,4121,-19400,-19400,980,0,0,4212194,False,02K7-3P47-K943-7048
mCkSHzr4D0801EpV,1653904022,WFP.AQUAMARKET,5411,5411,-44700,-44700,980,0,0,4231594,False,44AC-8KA6-5BM5-37X4
VrAt_gv-1jPjdyOV,1653898055,–ü–æ–≤–µ—Ä–Ω–∏—Å—å –∂–∏–≤–∏–º,4900,4900,-10340748,-10340748,980,0,0,4276294,True,5C6K-5E83-3MA8-T3P5
XVk_5mJdLvTEJ0o_,1653897986,–íi–¥: –ü–†–ò–•–û–î–¨–ö–û –ï.–í. –§–û–ü,4829,4829,6000000,6000000,980,0,0,14617042,True
5jSJiKP9vyPt5_5E,1653895507,Lesya,4829,4829,-500000,-500000,980,0,0,8617042,True,7B3B-X684-XC5A-MEXP
8getH3XoRM7OlSZ7,1653895487,–í–∏–ø–ª–∞—Ç–∞ –±–∞–Ω–∫–∏ ¬´–í—É—Å–∞—Ç–∏–π —Ñ–∞–Ω–¥—Ä–µ–π–∑—ñ–Ω–≥¬ª,4829,4829,7541077,7541077,980,0,0,9117042,True
dqI9gsUsbaJ1dS7M,1653893556,bwtc cafe&roasters,5814,5814,-4500,-4500,980,0,0,1575965,False,7129-735P-XH64-103E
XTLb_E_bBAFCmlKr,1653893335,Kafe La Fabrique,5814,5814,-29300,-29300,980,0,0,1580465,False,AC9P-0H31-4H61-X7E9
qAk4rk1nnEOSKXABVehMgQ,1653862413,–ë–†–°–ú,5541,5541,-122970,-122970,980,0,922,1609765,True
mmpD2W2zdPmfJWx7-F0y92x2dA,1653862413,–°–∫–∞—Å—É–≤–∞–Ω–Ω—è. –ë–†–°–ú,5541,5541,108132,108132,980,0,-1621,1732735,False
CHNdoN-cGcWYrRhiHSXAmA,1653862413,–°–∫–∞—Å—É–≤–∞–Ω–Ω—è. –ë–†–°–ú,5541,5541,14838,14838,980,0,-222,1624603,False
L8Twlhz9Ie1VDoxT,1653831849,Bar Kafebar,5814,5814,-45500,-45500,980,0,0,1609765,False,A1CX-7C78-AC95-13XC
zZZpaBMLAqGfJTXH,1653829044,Novus,5411,5411,-196915,-196915,980,0,0,1655265,False,HBK2-E400-T99P-T435
T0UUUH4bM3tLMRP4,1653822918,Yaroslaviv Val 37-1,5499,5499,-68800,-68800,980,0,0,1852180,False,6K72-PHHM-P7X2-XA24
_Ladms-rWMQAxWxX,1653809072,Kafe Right Coffee Bar,5814,5814,-24400,-24400,980,0,0,1920980,False,PK67-BX8E-MM8P-6508
Hyxej9uGe0x8zJEH,1653804680,–û–±—Å–ª—É–≥–æ–≤—É–≤–∞–Ω–Ω—è –ø–ª–∞—Ç–∏–Ω–æ–≤–æ—ó –∫–∞—Ä—Ç–∫–∏,4829,4829,-30000,-30000,980,0,0,1945380,True
NM8AIvbpn51CFBUE,1653764610,Bolt,4121,4121,-10600,-10600,980,0,0,1975380,False,9K24-CB81-9T09-7KB4
L0jP7mAddT897n7X,1653763035,Bolt,4121,4121,-14300,-14300,980,0,0,1985980,False,CAK9-5C79-AH12-THC0
5qkbEZkZI2cMuQea,1653754571,LIQPAY*TOV Vidavnictv,5942,5942,-20000,-20000,980,0,0,2000280,False,4M78-4438-B97H-BHX1
Pq7uKPD_errvK41r,1653748903,WINETIME,5921,5921,-58400,-58400,980,0,0,2020280,False,45MM-3673-BB93-BX48
uH6D_NRBXYovV9t7,1653747602,Mates,5814,5814,-126200,-126200,980,0,0,2078680,False,HB4C-MM3B-PC24-EH34
4lVWI6laKCECD4N0,1653744740,WFP.AQUAMARKET,5411,5411,-62130,-62130,980,0,0,2204880,False,A1TM-CC09-A18K-XAC8
WWyD6J0Bbi2zXAHO,1653736698,414949****1146,4829,4829,-65327,-65327,980,0,0,2267010,True,CHX6-C8P2-3B51-X0C6
N_sMeSc13U21DdwG,1653732656,–ö–æ–ª–æ,5411,5499,-6100,-6100,980,0,0,2332337,False,E6EA-KK0X-M843-P5CP
4g8eaiHLodpM6Bfg,1653732421,414962****6279,4829,4829,-110000,-110000,980,0,0,2338437,True,E7X5-6M24-CA9T-B326
gCw0FsLWEcjxWwCQ,1653723061,–ï–∫–æ-–õ–∞–≤–∫–∞,5411,5499,-4800,-4800,980,0,0,2448437,False,E3PE-K6H5-K137-564A
q64xZw5LKBjUBoiH,1653722952,–ö–æ–ª–æ,5411,5499,-22700,-22700,980,0,0,2453237,False,8B70-XK5H-3MX3-KC8K
pd-cMcM84WVFMLJ4,1653682940,–î–º–∏—Ç—Ä–æ –í.,–Ω–∞ –ø—ñ–¥—Ä–æ–∑–¥—ñ–ª,4829,4829,-150000,-150000,980,0,0,2475937,True,BK2P-0AKP-2HX2-AX4M
MbwUiEyibqf3p1Ep,1653672015,Kafe Right Coffee Bar,5814,5814,-9800,-9800,980,0,0,2625937,False,47CK-4830-C8EB-5A4X
UIoVSybCFKffBYnD,1653652648,Bolt Food,4215,4215,-52000,-52000,980,0,0,2635737,False,HP46-28M8-831K-TE05
c7Ccv8wjQJXp4mKY,1653630593,–°–∫–∞—Å—É–≤–∞–Ω–Ω—è. –ë–†–°–ú,5541,5541,14838,14838,980,0,-222,2687737,False
IRQFaAkW39WNvKyq,1653630142,–ë–†–°–ú,5541,5541,-122970,-122970,980,0,1844,2672899,False
60u6Z6dLT5_8Xu1E,1653585393,Bolt,4121,4121,-9000,-9000,980,0,0,2795869,False,M9EC-06H4-XH4A-EHP2
Tv8fjqLhpVmLGGF_,1653571804,Bolt,4121,4121,-2305,-2305,980,0,0,2804869,False,H5EC-94A4-320P-6H06
WhZM-Ara7gBhlXQA,1653556151,Lesya,4829,4829,-400000,-400000,980,0,0,2807174,True,2M92-TMM4-829B-CX9C
I4kp4Zk0CjqWC7Tk,1653475465,–ê–ª—ñ–Ω–∞ –ë.,–°–∞—á–µ–Ω–∫–æ,4829,4829,-380000,-380000,980,0,0,3207174,True,A7E4-MTX0-99A0-9PEH
1n2iha18aMzXLK7w,1653470007,–°–∫–∞—Å—É–≤–∞–Ω–Ω—è. –Ñ–≤–≥–µ–Ω –ë–∞–π—Ç–µ—Ä—è–∫–æ–≤,4829,4829,100000,100000,980,0,0,3587174,False
RM-haJLDPmf-DaEj,1653470007,–Ñ–≤–≥–µ–Ω –ë–∞–π—Ç–µ—Ä—è–∫–æ–≤,4829,4829,-100000,-100000,980,0,0,3487174,False
kYn9nvU0XLrknOO1,1653467911,–í–∞—Å–∏–ª—å –í.,–ü—ñ–∫–∞–ø–∏ üöó,4829,4829,-300000,-300000,980,0,0,3587174,True,6484-3495-X795-PHBT
4OBHqW_wpGpgbsR6,1653467562,–íi–¥: –ü–†–ò–•–û–î–¨–ö–û –ï.–í. –§–û–ü,4829,4829,1800000,1800000,980,0,0,3887174,True
lRN4evM-L7Ed0IBm,1653463581,Lesya,4829,4829,-300000,-300000,980,0,0,2087174,True,0542-H2CX-0T76-506P
_zYv1EszK8ponnu2,1653462848,Bolt,4121,4121,-1938,-1938,980,0,0,2387174,False,EMH3-X3P7-6365-89E2
qgWXu4XONBmnec4q,1653403741,–§–û–ü –ö–æ—á—É—Ç –Ü–≥–æ—Ä –ê–Ω–¥—Ä—ñ–π–æ–≤–∏—á,4829,4829,-532000,-532000,980,0,0,2389112,True,5860-BPA8-HC2T-HXE8
40FiH7XlX3uHjDZ0,1653399961,Lesya,4829,4829,-500000,-500000,980,0,0,2921112,True,XAHK-MC3T-24K9-27HK
0MsPdpf21Z9hSpyJ,1653399569,–õ—é–∫—Å–æ–ø—Ç–∏–∫–∞,8043,8043,-3500,-3500,980,0,70,3421112,False,XMEK-E993-7K84-E1XC
AC_Sl7llVCYNhnoU,1653312985,–î–∞–Ω–∏—ó–ª –ü.,–ö–≤–∞—Ä—Ç–∏—Ä–∞,4829,4829,-484800,-484800,980,0,0,3424612,True,7E16-E1X1-62XE-1EC2
1f-RyVShi0lAJbeX,1653305211,Bolt,4121,4121,-2398,-2398,980,0,0,3909412,False,33AM-96ET-5TCB-PM35
QUd5d1bwxZaS2LXc,1653303147,Bolt,4121,4121,-1228,-1228,980,0,0,3911810,False,K0HH-HT80-MT09-EX41
vBKdtLLHptOdhudZ,1653293874,Lesya,4829,4829,-500000,-500000,980,0,0,3913038,True,CA14-1H45-T1EA-KM66
8WsIaBbilBp6E0Th,1653226546,Magazyn Bukling,5942,5942,-42000,-42000,980,0,0,4413038,False,7MP2-4035-P611-XB4X
YQuVrQoJlsHVzOip,1653224249,TOV LUSH UKRAINA,5977,5977,-91500,-91500,980,0,1830,4455038,False,M636-24AP-XP67-PB40
QlBd89ExVNeJf6J2,1653223447,CHEESE BAKERY,5812,5812,-30400,-30400,980,0,0,4546538,False,8117-18XE-AMT3-21T9
yDvDFykbvdOBFex1,1653222718,PARADJANOV1,5812,5812,-57000,-57000,980,0,0,4576938,False,5K61-AKA5-AKB4-3CA5
mnuge8cpxQ5z7Qbw,1653222660,PARA DJANOV,5812,5812,-50000,-50000,980,0,0,4633938,False,8MX0-X6K5-460A-PM04
sQiEm0fwPYdJ5OhC,1653210587,WINETIME,5921,5921,-40300,-40300,980,0,0,4683938,False,8906-6X5B-6114-4H2X
kFpt4Fo32hlJtvvC,1653207389,516887****1677,4829,4829,-100000,-100000,980,0,0,4724238,True,8PAT-KTMM-P3KE-H319
knS7ruN1scrWMKGo,1653205304,Coqandtail1,5812,5812,-21400,-21400,980,0,0,4824238,False,9C9T-5MXH-CH89-M0CE
G1i2YJC1mxmrdeWC,1653145716,Bolt,4121,4121,-1428,-1428,980,0,0,4845638,False,6C7H-X97P-0KP6-T659
e1h1xA_oEyw_qbQ7,1653082324,–ü–æ–ø–æ–≤–Ω–µ–Ω–Ω—è ¬´–ø–∞–Ω–∞–º–æ—á–Ω–µ¬ª,4829,4829,-10000,-10000,980,0,0,4847066,True,TP82-X644-15P9-77K1
YXzRx8Oyu8P4Yh4e,1653064477,–ê—à–∞–Ω,5411,5411,-12790,-12790,980,0,0,4857066,False,86A8-9PX8-T8P0-H378
V1olga5aQEsp9bw7,1653061535,LIQPAY*TEDDI (Krasota,5812,5812,-53500,-53500,980,0,0,4869856,False,T6E7-TMH0-B4HX-2BCK
lpZ3oh5MbfCnNxXh,1653035631,–íi–¥: –ü–†–ò–•–û–î–¨–ö–û –ï.–í. –§–û–ü,4829,4829,3000000,3000000,980,0,0,4923356,True
kU2B4at9mL3ImYnE,1652883689,Vernisazh,5499,5499,-31500,-31500,980,0,0,1923356,False,C5X0-5P8B-81B9-3AP1
6i7ucgd2UROKBWa2,1652883058,Bolt,4121,4121,-1805,-1805,980,0,0,1954856,False,330P-00AK-63TE-32H8
IkaVoY7D0LNOrdeZ,1652864166,Bolt,4121,4121,-1195,-1195,980,0,0,1956661,False,KT8H-8AXM-P856-AA47
w-0pNT-tiHeFKXyJ,1652807336,CAFE RYNOK,5814,5814,-50522,-50522,980,0,0,1957856,False,PA5T-6TM8-CCAE-7H56
y0eW8rbHizYgVkzO,1652806674,TheDealer,5814,5814,-13600,-13600,980,0,0,2008378,False,A7H9-X075-EMBH-274A
cPMIncZ7kQEVpm1m,1652771340,–ê–Ω–¥—Ä—ñ–π –ú.,–ù–∞ –æ–¥—É–∂–∞–Ω–Ω—è,4829,4829,-50000,-50000,980,0,0,2021978,True,MM0T-XBXC-A44B-5XT9
GM5FLRwoF7K-l5fT,1652735852,–î–∞–Ω–∏—ó–ª –ü.,–ö–≤–∞—Ä—Ç–∏—Ä–∞,4829,4829,-848400,-848400,980,0,0,2071978,True,T48T-CB12-1721-HAHE
OUPoLk126FzyYin1,1652690872,Bolt,4121,4121,-2058,-2058,980,0,0,2920378,False,7AM4-XHM6-6XA6-2EM9
NtiJ6r-2X18uLyKU,1652689904,Lesya,4829,4829,-300000,-300000,980,0,0,2922436,True,8T45-PET2-4HTE-7EK6
QvKem-j1k_1xQqFY,1652686992,Hartskaphe1,5814,5814,-12500,-12500,980,0,0,3222436,False,96HE-36PB-P1CB-8M3B
0rclh64gxizvc2Wa,1652686656,Carpaccio,5499,5499,-17000,-17000,980,0,0,3234936,False,72B8-E73H-9K30-7CX4
vNPrOIjfEgsvqRKd,1652651683,–û–ª–µ–∫—Å—ñ–π –í.,4829,4829,-130000,-130000,980,0,0,3251936,True,1MK5-EK85-A6B7-4K62
zdsiM9tLvaG7zcxs,1652651516,–û–ª–µ–≥ –¢.,4829,4829,-70900,-70900,980,0,0,3381936,True,A8A0-24C2-TX3T-2PBA
ylQkJaIcbxf_UGZu,1652606735,EuroVet,742,742,-80000,-80000,980,0,0,3452836,False,KAC7-6584-MMAM-33K5
0kpcUMK9p5fFmY_w,1652600150,Hartskaphe1,5814,5814,-12500,-12500,980,0,0,3532836,False,401H-9B43-E4XP-7AHA
Hr3PkHB8iBDL30kG,1652557990,–°–∫–∞—Å—É–≤–∞–Ω–Ω—è. –°–µ—Ä–≥—ñ–π –ü—Ä–∏—Ç—É–ª–∞,4829,4829,100000,100000,980,0,0,3545336,False
LX8-vsk_QB05MSsa,1652557989,–°–µ—Ä–≥—ñ–π –ü—Ä–∏—Ç—É–ª–∞,4829,4829,-100000,-100000,980,0,0,3445336,False
8ElTqIT3Cf1K0X_M,1652545343,Flora De Luxe,5992,5992,-78000,-78000,980,0,0,3545336,False,2T05-H4TC-813T-X84X
hv7FN042G8Rtar_m,1652541154,FOP MUKOVOZOV SIu,5814,5814,-9300,-9300,980,0,0,3623336,False,E66P-3A98-1HP8-MX40
GZTXVNrwvO8c_x8R,1652538457,FOP MUKOVOZOV SIu,5814,5814,-8800,-8800,980,0,0,3632636,False,H664-C104-4PC8-29T7
wLD1o332P83gjVZC,1652536485,FOP MUKOVOZOV SIu,5814,5814,-16100,-16100,980,0,0,3641436,False,018H-M4BX-5H95-08EA
BbpIrRJLq8PGv7wr,1652528921,473118****5817,4829,4829,-100000,-100000,980,0,0,3657536,True,8798-0C3K-2K57-ACKT
e0aiVWvnRk28UPdu,1652517093,Carpaccio,5499,5499,-27000,-27000,980,0,0,3757536,False,2E93-P134-H5CC-05PP
rpL3jw5VwGLrAuH1,1652516140,–¢–∞–±–∞–∫–µ—Ä–∫–∞,5993,5993,-73000,-73000,980,0,0,3784536,False,1T39-B0K6-60HK-P6B6
G45VaTvc5-pzWteB,1652515711,–ê–ø—Ç–µ–∫–∞ –î–æ–±—Ä–æ–≥–æ –î–Ω—è,5912,5912,-30580,-30580,980,0,611,3857536,False,8914-5383-329X-6B34
HV4U6ipmkj1hCYaY,1652476071,–°–≤—è—Ç–æ—Å–ª–∞–≤ –ö.,–ü—Ä–∏—Ü—ñ–ª üéØ,4829,4829,-200000,-200000,980,0,0,3888116,True,B8C3-C3M1-71KT-M91T
j9LFW_oOQi_3agPZ,1652440371,Lesya,4829,4829,-500000,-500000,980,0,0,4088116,True,048B-3CE6-CTK9-85K0
b32-cL-YyLJ9D7qy,1652433406,–íi–¥: –ü–†–ò–•–û–î–¨–ö–û –ï.–í. –§–û–ü,4829,4829,2500000,2500000,980,0,0,4588116,True
Mct5PrkcNkd852Aq,1652388361,Uklon,4121,4121,-28700,-28700,980,0,0,2088116,False,97CX-PE4P-H3CB-K8XM
t8HXYuEo-t-LF3eC,1652387914,–ü–∞–≤–ª–æ –ü.,4829,4829,-60000,-60000,980,0,0,2116816,True,1EX5-3EK8-M583-HTT4
o-epSzsPQOGRJSmB,1652371158,KAFE,5814,5814,-14500,-14500,980,0,0,2176816,False,130T-X5A2-53H7-M371
7yhL2P4Y03FvkcEw,1652370113,Lesya,4829,4829,-200000,-200000,980,0,0,2191316,True,7E47-487X-50BH-0X02
m6JDx02W4lKS_qaL,1652265079,Bolt,4121,4121,-5000,-5000,980,0,0,2391316,False,M982-01P9-593B-20PH
cWtFVzWrKX3nwY2B,1652250893,–£–∫—Ä–∑–∞–ª—ñ–∑–Ω–∏—Ü—è,4112,4112,-164387,-164387,980,0,0,2396316,False,37P0-BC38-E61X-TMCE
jP5zsm9JBA3SY2Fs,1652200584,Lesya,4829,4829,-400000,-400000,980,0,0,2560703,True,T2PH-0737-TAP9-475X
gS-cGsZ1u46_KUhs,1652181661,Lesya,4829,4829,-300000,-300000,980,0,0,2960703,True,AB08-94H9-H5BP-A3E8
vjG_aqQAIKdgVGaN,1652099523,CAFERYNOK,5499,5499,-6990,-6990,980,0,0,3260703,False,1524-B594-4C6P-PXP9
xaF5TbaJbPe-PQ1v,1652099503,Kapherinok1,5814,5814,-25810,-25810,980,0,0,3267693,False,E4KE-A3B2-678B-E2CB
lp2ybYdfBsEh4S-Y,1652098044,LIQPAY*TEDDI (Krasota,5812,5812,-46000,-46000,980,0,0,3293503,False,3B1X-APXH-HP6T-79B5
91ZbXB5YZoiiP5Q6,1652090313,Lesya,4829,4829,-500000,-500000,980,0,0,3339503,True,7BP4-5K94-8120-3TM6
m0giDviOM9yEajC1,1652086674,CHANGE.ORG,8398,8398,-10000,-10000,980,0,0,3839503,False,4HX1-M50K-C576-1C3A
2L_LNgOhPyDDRun6,1652086449,–î–∞–Ω–∏—ó–ª –ü.,–ö–≤–∞—Ä—Ç–∏—Ä–∞,4829,4829,-848400,-848400,980,0,0,3849503,True,2MP2-EPTK-MT91-XXAT
VgkPnoAhKo0w2z8A,1652084404,CAFE RYNOK,5814,5814,-9800,-9800,980,0,0,4697903,False,B7XC-E660-B58P-24B8
8q2e6ewlc9vElBKC,1652084126,Coqandtail1,5812,5812,-34400,-34400,980,0,0,4707703,False,925E-36XC-511X-754M
-ZIR49blaf66xdAr,1652027084,–û–ª—å–≥–∞ –°.,4829,4829,-200000,-200000,980,0,0,4742103,True,C46E-6934-XHC9-CP9K
Kxzhy_0mQVAttxpb,1652009864,CAFE RYNOK,5814,5814,-42390,-42390,980,0,0,4942103,False,X1XT-T423-H964-4E10
unXDd_7YtHB3RpVQ,1652009443,Carpaccio,5499,5499,-101200,-101200,980,0,0,4984493,False,1X9B-8P97-1730-MB4B
f3Syw6bjFzkC1Eym,1651996081,Hartskaphe1,5814,5814,-12500,-12500,980,0,0,5085693,False,5XCE-TK15-2MP1-0M71
8hM6OX149YNW-CwV,1651938547,Lesya,4829,4829,-200000,-200000,980,0,0,5098193,True,57AK-4ETM-2H31-KC2K
8my8eg_B9lhkp8WU,1651938282,TheDealer,5814,5814,-18500,-18500,980,0,0,5298193,False,B551-3C23-4X77-M673
dnymXwlrgRCz9rcT,1651937939,VERYWANT,5499,5499,-31863,-31863,980,0,0,5316693,False,45H7-3405-K3H4-2AHP
w67Q8yCJKHxrJZ36,1651911341,Avtozapchastini,5533,5533,-219000,-219000,980,0,3285,5348556,False,K5HA-1M0C-2B8E-E76M
22nZCEMxN-L068Do,1651857210,Lesya,4829,4829,-700000,-700000,980,0,0,5567556,True,P0KK-0163-94BP-6K67
tFoRPGj7mpTu61aw,1651842463,KAFE,5814,5814,-15500,-15500,980,0,0,6267556,False,53KM-PXM6-6EBK-B84B
roGNH5gLTel1NrKZ,1651841885,TheDealer,5814,5814,-12200,-12200,980,0,0,6283056,False,T513-XHPT-CB8T-BBX1
agOeJs_Hcfe83_AJ,1651841656,–ê–ø—Ç–µ–∫–∞ –î–æ–±—Ä–æ–≥–æ –î–Ω—è,5912,5912,-37746,-37746,980,0,754,6295256,False,P50M-9PC3-8KK3-TKMH
RjHXIKwxtKK5EUks,1651830546,–íi–¥: –ü–†–ò–•–û–î–¨–ö–û –ï.–í. –§–û–ü,4829,4829,3000000,3000000,980,0,0,6333002,True
Au4iyCenOcYoS9Es,1651820992,EuroVet,742,742,-30000,-30000,980,0,0,3333002,False,9P02-1B81-59K8-9M0E
XBszWDb0ZnY9D-zU,1651817854,Hartskaphe1,5814,5814,-12500,-12500,980,0,0,3363002,False,T404-K727-E4HA-E777
nGNyWLQte6mE_tMr,1651817440,–ú–µ—Ä–µ–∂–∞ –∞–ø—Ç–µ–∫ D.S.,5912,5912,-1400,-1400,980,0,28,3375502,False,56A9-77C7-251A-MC69
SlYhx8OUs4IFfhjF,1651817065,–ê—à–∞–Ω,5411,5411,-22300,-22300,980,0,0,3376902,False,C1HX-32C0-K173-195E
ykDhSoaC3e3qwDua,1651778002,Bolt,4121,4121,-6500,-6500,980,0,0,3399202,False,4H75-95T0-H5A1-77T4
wOHrDAvXNcOHYV-Z,1651773545,KAFE,5814,5814,-14500,-14500,980,0,0,3405702,False,A7PH-MMT1-PK1K-2H53
Y8Vb-e5LzXx69J6h,1651763896,–ù–æ–≤–∞ –ø–æ—à—Ç–∞,7399,7399,-26000,-26000,980,0,0,3420202,False,1TEP-T5A4-2X08-8MKK
85KetzrdAx4OUgtz,1651761099,Lesya,4829,4829,-1000000,-1000000,980,0,0,3446202,True,1764-07HH-42B2-B20H
uF5yVdg-DZTlLhIh,1651751012,AIRBNB,7011,7011,-311160,-10202,840,0,0,4446202,False,X5B7-X2BK-945P-1129
Pk1dKJJb9LKuIqjX,1651744118,TsRMMODRiChI1,7011,7011,-240000,-240000,980,0,0,4757362,False,09EX-7P8T-2H65-T2H7
SAAR_2lGoqOkZc_i,1651744072,FOPChupikMariyaPavlivna,7011,7011,-285200,-285200,980,0,0,4997362,False,MA4T-KKKB-53AT-E64C
SQdfSP16B9ZmN6C5,1651744038,FOPChupikMariyaPavlivna,7011,7011,-30000,-30000,980,0,0,5282562,False,2P82-9EC6-TM95-71A6
KBWm0YPF_o8nHgG5,1651741477,–íi–¥: –ü–†–ò–•–û–î–¨–ö–û –ï.–í. –§–û–ü,4829,4829,2100000,2100000,980,0,0,5312562,True
mpBOMhhxZIV_EgYP,1651667045,FOPChupikMariyaPavlivna,7011,7011,-7000,-7000,980,0,0,3212562,False,0B6C-E6CM-X131-5PA1
JxYIknGNpIIo3N6Z,1651566878,TOV LIuKSPROMGAZ,5172,5172,-71000,-71000,980,0,1065,3219562,False,A56B-416X-7T3E-C545
cGkwIGbKe_Eufyio,1651491915,OKKO,5541,5541,-64280,-64280,980,0,964,3290562,False,AT33-KPE1-A231-9AX5
Qwh4TKWCOOUk4H8X,1651489140,–ó–æ–æ–º–∞–≥–∞–∑–∏–Ω,5995,5995,-35600,-35600,980,0,0,3354842,False,86M1-99C9-2BTE-MBM2
o6I2RvHD_U5YldBn,1651487607,Lesya,4829,4829,-1000000,-1000000,980,0,0,3390442,True,80M3-A0H2-M3C6-7AP9
HTbPW1_TyarIF8q3,1651480669,–íi–¥: –ü–†–ò–•–û–î–¨–ö–û –ï.–í. –§–û–ü,4829,4829,3100000,3100000,980,0,0,4390442,True
IC_Xr82Wrxttc1PO,1651400496,TsRMMODRiChI1,7011,7011,-600000,-600000,980,0,0,1290442,False,T019-9T4M-X9T6-KEP6
qKgP17bww9WIdHEl,1651400465,FOPChupikMariyaPavlivna,7011,7011,-713000,-713000,980,0,0,1890442,False,57E9-5P5P-MH2K-ET4B
8mvYH1ugCtlqcIoL,1651398514,DigitalOcean,5734,5734,-9030,-301,840,0,0,2603442,False,M25P-6T3M-BC2H-T04T
Xr4gCREIv-pBmyjT,1656516558,Bolt,4121,4121,-9600,-9600,980,0,0,3364113,False,5EKK-10KM-5M69-3T2M
HQX6F5vIWMqgNyJX,1656511785,Novapay,8999,8999,-5000,-5000,980,0,0,3373713,False,TAXC-BHCB-CETB-53XX
MwSORNvEseABlGt-,1656507339,Bolt,4121,4121,-9300,-9300,980,0,0,3378713,False,C24H-8C53-8476-6M0K
d2QBuvPXxBWEx92m,1656501510,–°–∫–∞—Å—É–≤–∞–Ω–Ω—è. Bird,7999,7999,8500,8500,980,0,0,3388013,False
eRyT0-MP9RdQ-L_d,1656501508,Bird,7999,7999,-8500,-8500,980,0,0,3379513,False
UNKfxYxZLzRuXYGP,1656500802,–°–∫–∞—Å—É–≤–∞–Ω–Ω—è. Bird,7999,7999,8500,8500,980,0,0,3388013,False
nxfRMN3rZCabb0gj,1656500798,Bird,7999,7999,-8500,-8500,980,0,0,3379513,False
MwUfUtHDU0i-7Egu,1656498868,KafeKafeSubota,5814,5814,-31500,-31500,980,0,0,3388013,False,30K5-47E4-9M2P-2A0T
I0_QQSBgLQItF543,1656490753,–íi–¥: –ü–†–ò–•–û–î–¨–ö–û –ï.–í. –§–û–ü,4829,4829,2900000,2900000,980,0,0,3419513,True
NeAkpmXJp5vu-RUU,1656482992,bwtc cafe&roasters,5814,5814,-5000,-5000,980,0,0,519513,False,B4MB-AC80-AHE8-6M21
VLQ_vNOqvI-3z8WV,1656426408,Novapay,8999,8999,-5300,-5300,980,0,0,524513,False,44X7-C778-PB4C-4E3K
cLZwu90y0iy4hOyR,1656414582,–°—ñ–ª—å–ø–æ,5411,5411,-21000,-21000,980,0,0,529813,False,0629-9K13-5EHK-KHT6
jIePjpRQNRJal2Ec,1656414501,–°—ñ–ª—å–ø–æ,5411,5411,-151626,-151626,980,0,0,550813,False,C2B4-0C89-1K2H-C46K
VZwtJpGsi8BDzub_,1656413166,–ï–ª–µ–∫—Ç—Ä–æ—Å–∞–º–æ–∫–∞—Ç–∏ Bolt,7999,7999,-6486,-6486,980,0,0,702439,False,AE01-1570-MXBX-C6AB
wYjxol9Je7Sh8hL_,1656413143,BIRD UKR* RIDE,7999,7999,-10000,-10000,980,0,0,708925,False,HT87-8MH3-5504-KM49
6nQvSvH9KObd7Obu,1656412798,Mates,5814,5814,-29000,-29000,980,0,0,718925,False,EB6K-17XB-5BP6-XP31
qDITkZ8usHhWjXdQ,1656411248,–°–∫–∞—Å—É–≤–∞–Ω–Ω—è. Bird,7999,7999,8500,8500,980,0,0,747925,False
NnIVFkjlMckuAEvR,1656411244,Bird,7999,7999,-8500,-8500,980,0,0,739425,False
l0JftZCez5huDtIz,1656409891,MasterZoo,5995,5995,-54500,-54500,980,0,0,747925,False,849A-BBC4-2980-C003
QkENpUnBaUF6iXUm,1656409707,BIRD UKR* RIDE,7999,7999,-10000,-10000,980,0,0,802425,False,MHBP-33C2-M175-47HT
LSHwtbjUqK--3IRP,1656409703,–ï–ª–µ–∫—Ç—Ä–æ—Å–∞–º–æ–∫–∞—Ç–∏ Bolt,7999,7999,-4155,-4155,980,0,0,812425,False,BT74-TK32-7BK2-B6CA
h2OYX6rg2-iLnNNw,1656408485,–°–∫–∞—Å—É–≤–∞–Ω–Ω—è. Bird,7999,7999,8500,8500,980,0,0,816580,False
EZfG5adL6OuZc2ZV,1656408481,Bird,7999,7999,-8500,-8500,980,0,0,808080,False
DuaBaiSyEz6gkmgq,1656408223,–ê–ø—Ç–µ–∫–∞ –ë–ú–¢–°,5912,5912,-16807,-16807,980,0,126,816580,False,X7P6-87B3-5746-198C
T1BqNyyyR2llxuQT,1656407957,TOV ROZMARI,5814,5814,-10000,-10000,980,0,0,833387,False,64EM-H7KM-8E26-B74X
uoGqkhAw7HZ8kkj5,1656406486,–ï–ª–µ–∫—Ç—Ä–æ—Å–∞–º–æ–∫–∞—Ç–∏ Bolt,7999,7999,-3858,-3858,980,0,0,843387,False,K6A7-6B68-CEH8-BBCE
_oKY2wbTaToc5LSU,1656406479,–ï–ª–µ–∫—Ç—Ä–æ—Å–∞–º–æ–∫–∞—Ç–∏ Bolt,7999,7999,-3851,-3851,980,0,0,847245,False,954B-BPAB-96K1-3153
FmKjTNeSpIvunRTh,1656357601,LIQPAY*FOP Voloshina A,5977,5977,-276100,-276100,980,0,2070,851096,False,80P5-M580-970C-K1K2
Qh0kBvhv5iWxHiUR,1656328687,Novus,5411,5411,-263812,-263812,980,0,0,1127196,False,PHT3-M1K4-P4AH-0CKE
FRB3ZR4zQkgVx4TQ,1656325790,bwtc cafe&roasters,5814,5814,-14600,-14600,980,0,0,1391008,False,K2TC-7KCE-EEKK-15CE
8niM7EYGgNB7pGzf,1656265579,WFP.AQUAMARKET,5411,5411,-39420,-39420,980,0,0,1405608,False,MKHC-P67A-5X9T-P6P4
1eN4SU74QadvS92P,1656248992,FOPTokaychukArinaOlegivna,5814,5814,-434500,-434500,980,0,0,1445028,False,M20M-75PX-H324-84E3
y45Z2M00hLPy4mrV,1656248967,Restoran Publicist,5814,5814,-99600,-99600,980,0,0,1879528,False,9K7P-64B0-0M00-3508
yfVQPYO8Wa71kVrd,1656230250,bwtc cafe&roasters,5814,5814,-11000,-11000,980,0,0,1979128,False,PMX1-TPK4-85CK-5TC7
uqGq6HjsppOq8pKH,1656176556,Simona,5814,5814,-45000,-45000,980,0,0,1990128,False,7T13-278X-7738-575A
jQlkjGWFfjXZaQRm,1656162022,–ü–æ–ø–æ–≤–Ω–µ–Ω–Ω—è ¬´–ë–∞–Ω–¥–µ—Ä–∞ power¬ª,4829,4829,-25000,-25000,980,0,0,2035128,True,0C39-XPKC-6M1P-H7BP
c-SKeDgFRtAnCCIw,1656161846,Novapay,8999,8999,-5300,-5300,980,0,0,2060128,False,T765-MPCB-7H2X-7K9M
7hj9HOtvBOrInpyL,1656161353,KARABAS.COM,7922,7922,-79900,-79900,980,0,0,2065428,False,XC5T-P3C0-MCPP-4XE9
hcMWI-KAatu2ke5S,1656158840,–ü–æ–ø–æ–≤–Ω–µ–Ω–Ω—è ¬´–ù–∞ –¥—ñ–º –¥–ª—è –±–∞–±–∏ –í–∞–ª—ñ¬ª,–ó –¥–Ω–µ–º –Ω–∞—Ä–æ–¥–∂–µ–Ω–Ω—è ü§ó,4829,4829,-200000,-200000,980,0,0,2145328,True,T495-3X4X-MTM3-HB44
MC767UalU0FR9Oww,1656154830,–ï–ª–µ–∫—Ç—Ä–æ—Å–∞–º–æ–∫–∞—Ç–∏ Bolt,7999,7999,-1783,-1783,980,0,0,2345328,False,M2PM-84TK-85M6-3HA0
K7w9QNaJ7ckShjSK,1656154815,–ï–ª–µ–∫—Ç—Ä–æ—Å–∞–º–æ–∫–∞—Ç–∏ Bolt,7999,7999,-1725,-1725,980,0,0,2347111,False,K70T-K0A3-34BH-193K
Gl6FQoQXXBV7g_Uu,1656154549,–°—ñ–ª—å–ø–æ,5411,5411,-28000,-28000,980,0,0,2348836,False,HTE7-MC8X-0C1M-0E32
nigc8huqIHI3kN8u,1656154517,–°—ñ–ª—å–ø–æ,5411,5411,-100333,-100333,980,0,0,2376836,False,B6PE-HP24-MX2T-KK8C
OHt6p4hCMnrk7O_B,1656153982,–ï–ª–µ–∫—Ç—Ä–æ—Å–∞–º–æ–∫–∞—Ç–∏ Bolt,7999,7999,-1513,-1513,980,0,0,2477169,False,BHB7-CB78-2CB6-T9A6
peZAkVztMgLlugSj,1656153832,–°–∫–∞—Å—É–≤–∞–Ω–Ω—è. Bird,7999,7999,8500,8500,980,0,0,2478682,False
IAdyG5tnfdKtX3iO,1656153827,Bird,7999,7999,-8500,-8500,980,0,0,2470182,False
Gx-7E1xbKZiBXRM_,1656152955,–ï–ª–µ–∫—Ç—Ä–æ—Å–∞–º–æ–∫–∞—Ç–∏ Bolt,7999,7999,-2129,-2129,980,0,0,2478682,False,02E9-K054-5661-0ATX
75NID7p9lCfASYbR,1656152649,–°–∫–∞—Å—É–≤–∞–Ω–Ω—è. Bird,7999,7999,8500,8500,980,0,0,2480811,False
ScN_rDrwi_w8FI8y,1656152646,Bird,7999,7999,-8500,-8500,980,0,0,2472311,False
sF5zX9isL8GdpFjq,1656152552,KapheMates,5814,5814,-30000,-30000,980,0,0,2480811,False,MET2-E0H8-MK35-M39K
fJJwnpCkCShmLAV9,1656152543,Mates,5814,5814,-30000,-30000,980,0,0,2510811,False,2CH0-05PE-1AT9-M2A6
1Gkdyq1UaHXvSEzp,1656149070,–ï–ª–µ–∫—Ç—Ä–æ—Å–∞–º–æ–∫–∞—Ç–∏ Bolt,7999,7999,-2433,-2433,980,0,0,2540811,False,CB4T-7202-92C6-TAX4
RD5v0vZr66Rq9ZVl,1656149070,–ï–ª–µ–∫—Ç—Ä–æ—Å–∞–º–æ–∫–∞—Ç–∏ Bolt,7999,7999,-2971,-2971,980,0,0,2543244,False,HP57-6A58-3PPE-C58B
HWpyJ7lUn9MB_BFY,1656085684,OK Wine,5411,5411,-14460,-14460,980,0,0,2546215,False,BH62-7ATA-6K6X-BM1H
hNBRpcZsUqiawrX5,1656083427,Novapay,8999,8999,-6000,-6000,980,0,0,2560675,False,2BEA-XBXT-EPHC-8K51
FLT4D22K5ym-BEhc,1656072683,magazin 762597,5912,5912,-42010,-42010,980,0,840,2566675,False,P3CK-XB0H-46B5-B8P9
_BW6zXgpGTlYHeKo,1656070270,Beer Market,5921,5921,-18918,-18918,980,0,0,2608685,False,ATB4-3038-XMB4-55X6
xdXWOLlzY-K-QPp0,1656065980,Novapay,8999,8999,-4800,-4800,980,0,0,2627603,False,9P0T-5CAK-492K-X367
l3VDVAtcfFEuRdhC,1656062816,414962****6413,4829,4829,-50000,-50000,980,0,0,2632403,True,A6E9-EM1H-E334-K1A9
vLa7hGgQZw913HiE,1656062780,Lesya,4829,4829,-400000,-400000,980,0,0,2682403,True,201B-6331-5P8X-HMEC
-6H3A5f66USBzJpR,1656059423,bwtc cafe&roasters,5814,5814,-10000,-10000,980,0,0,3082403,False,PK7C-8M4P-XT7K-M2PC
obRNRBjmAhJ8baxP,1656059332,SalonkrasotiHighFive,7230,7230,-42750,-42750,980,0,855,3092403,False,X913-PKBA-6BB1-46T2
E_AmCanl3F2fM9XH,1656056847,–íi–¥: –ü–†–ò–•–û–î–¨–ö–û –ï.–í. –§–û–ü,4829,4829,2000000,2000000,980,0,0,3135153,True
I27MGxHtzTsQ8prQ,1655994652,CAFE COFFEERELIGIA,5812,5812,-8500,-8500,980,0,0,1135153,False,8ME1-X72P-3T1M-T1CE
trhlE2-U8TbTG6BE,1655994342,–ê–ø—Ç–µ–∫–∞ –î–æ–±—Ä–æ–≥–æ –î–Ω—è,5912,5912,-8240,-8240,980,0,61,1143653,False,ATP7-A58K-9AXP-82K2
5jwo1cLJ2PfCy5A0,1655990891,Mates,5814,5814,-27500,-27500,980,0,0,1151893,False,XX98-646H-3B1B-HPM6
Rr1oNJn1HZDV6vEE,1655979201,Bolt,4121,4121,-7300,-7300,980,0,0,1179393,False,M54A-H260-287H-4E46
NSZQAPpQIqhjcNzF,1655978428,365Studio1,7230,7230,-320000,-320000,980,0,2400,1186693,False,K8C7-PB38-6MHP-87KE
izO2QYzPc4sslynV,1655965326,bwtc cafe&roasters,5814,5814,-9000,-9000,980,0,0,1506693,False,9E43-67HA-0T49-064E
pDpS0KpNQ_mSQWSJ,1655922045,naberechno lycowa,5541,5541,-94717,-94717,980,0,710,1515693,False,98PH-2HEC-662M-EBC0
OEPc8LRzyjBbXrjJ,1655920497,Novapay,8999,8999,-374500,-374500,980,0,0,1610410,False,8P2M-E96M-8679-9A2T
GxqgVXtKvdwYoJoG,1655920343,KFC,5814,5812,-37600,-37600,980,0,0,1984910,False,AK3B-34AC-65E0-0TXM
ueT-3ae6fyD--IUJ,1655915100,Coffeeopia,5814,5814,-3600,-3600,980,0,0,2022510,False,MT7A-8ACE-MCPT-0C7P
xZ8aKarrc1G5w6Z-,1655910923,–ï–ª–µ–∫—Ç—Ä–æ—Å–∞–º–æ–∫–∞—Ç–∏ Bolt,7999,7999,-2924,-2924,980,0,0,2026110,False,CAAE-7E2C-1H03-E9CK
ufxkRDECOxeouF8N,1655909852,Novapay,8999,8999,-1600,-1600,980,0,0,2029034,False,5M1B-1K71-2PEA-5APC
5aynWZFiWiXA-8-K,1655907820,–ü—Ä–æ—Ü–µ–Ω—Ç –≤—ñ–¥ –æ–±–ª—ñ–≥–∞—Ü—ñ–π,4829,4829,5500,5500,980,0,0,2030634,True
1JtKIV5y2gGMzrrm,1655904583,–ï–ª–µ–∫—Ç—Ä–æ—Å–∞–º–æ–∫–∞—Ç–∏ Bolt,7999,7999,-3763,-3763,980,0,0,2025134,False,1H2X-975C-T22A-392X
sK8-ffiPLzN0qwja,1655896462,–ï–ª–µ–∫—Ç—Ä–æ—Å–∞–º–æ–∫–∞—Ç–∏ Bolt,7999,7999,-2965,-2965,980,0,0,2028897,False,537E-1MXP-M47H-P50T
tGHdwjQb9RYzN_Gr,1655896395,–°—ñ–ª—å–ø–æ,5411,5411,-53787,-53787,980,0,0,2031862,False,C57M-TPC2-3E9E-P916
vkpVUACISap4V3Qj,1655895715,–ê–ø—Ç–µ–∫–∞ –ê–ù–¶,5912,5912,-33450,-33450,980,0,669,2085649,False,6X18-H09H-3MK7-1E9T
yaG4jy6OL7ldZJ3_,1655885800,Steam,5816,5816,-11900,-11900,980,0,0,2119099,False,90T0-0XTA-H074-3T9T
ARfAsmNXzv9YExEY,1655882039,–°—ñ–ª—å–ø–æ,5411,5411,-21900,-21900,980,0,0,2130999,False,KPMX-9XK7-0359-BK90
ucB0Iiwb_a5c-mol,1655824304,Novapay,8999,8999,-5000,-5000,980,0,0,2152899,False,8K6B-2HX3-K713-88MT
BRMAz-JS5XpBIpy7,1655803901,–ê–Ω–Ω–∞ –§.,–ë–ª–æ–∫–Ω–æ—Ç,4829,4829,-40000,-40000,980,0,0,2157899,True,T903-TTCX-653H-0B5P
4I5nClH0idpmuZM7,1655794078,–ö–∏—ó–≤ –¶–∏—Ñ—Ä–æ–≤–∏–π,4111,4111,-7000,-7000,980,0,0,2197899,False,4CM6-4MTC-62BE-M0P7
KOAfBUrLFksCutoq,1655792591,bwtc cafe&roasters,5814,5814,-10000,-10000,980,0,0,2204899,False,0A4C-H5T0-M1K4-TKT8
L0sxR47xZNKHxdbK,1655751886,–ö–∏—ó–≤ –¶–∏—Ñ—Ä–æ–≤–∏–π,4111,4111,-8750,-8750,980,0,0,2214899,False,3CT6-A818-H00H-AM7H
bw7XUD9nMcYjWgP-,1655741046,–ü–æ–ø–æ–≤–Ω–µ–Ω–Ω—è ¬´–ö–ª—ñ–Ω—ñ–Ω–≥ –≤—ñ–¥ –ó–°–£¬ª,4829,4829,-2057,-2057,980,0,0,2223649,True,9024-A4CT-5113-T918
mWFjR9l6CB2qvAqc,1655740954,Novapay,8999,8999,-5000,-5000,980,0,0,2225706,False,HA38-TB23-H3T7-XHEP
cN_-Q_W6AJMFSVdb,1655734970,–°—ñ–ª—å–ø–æ,5411,5411,-51514,-51514,980,0,0,2230706,False,TX9E-4M5T-ETX2-04EK
ch1mQTjkLM9HPB8D,1655734359,–ï–ª–µ–∫—Ç—Ä–æ—Å–∞–º–æ–∫–∞—Ç–∏ Bolt,7999,7999,-5603,-5603,980,0,0,2282220,False,2B36-C1CC-BTB3-K8MM
V4v_Cv049nTPh1Sg,1655734088,Novapay,8999,8999,-4400,-4400,980,0,0,2287823,False,K7TC-4H7X-9T8E-20MM
ul4EeMstKboKCAdM,1655728298,Novapay,8999,8999,-4000,-4000,980,0,0,2292223,False,X8K1-X1X4-9XAE-E14A
a5BE07KZ4xiBzmgH,1655728154,Novapay,8999,8999,-6800,-6800,980,0,0,2296223,False,6303-2406-1283-K761
1FoxyrymsY8jn8qy,1655727981,Bolt,4121,4121,-6800,-6800,980,0,0,2303023,False,3TA6-69H1-4C30-6PE0
er905zsyCoJpftRv,1655726742,5045Kavjarnja,5814,5814,-9500,-9500,980,0,0,2309823,False,A21E-H3EX-TEM7-KX7X
wq6R1H7cP9qFj1ee,1655725718,–ü–∏—Ä—ñ–∂–∫–æ–≤–∞ ¬´–¢—ñ—Ç–∫–∞ –ö–ª–∞—Ä–∞¬ª,5814,5814,-19400,-19400,980,0,0,2319323,False,AAX4-BK99-HH96-0B5K
nYlst5sKlkh3BMqA,1655722126,–ü–æ–ø–æ–≤–Ω–µ–Ω–Ω—è ¬´–ù–∞ –ø—ñ–∫–∞–ø 79¬ª,4829,4829,-20000,-20000,980,0,0,2338723,True,2PM4-0ME8-CEP4-2X16
vT44h1W6TMMeHBpQ,1655707797,SECHST,5912,5912,-14395,-14395,980,0,287,2358723,False,TPBH-EC38-5PA1-T5C6
cXt-jK9zd1vrT7u7,1655657355,Ponchyk Boy,5812,5812,-11600,-11600,980,0,0,2373118,True,EPX4-08A4-P78C-37A1
wIYklopnTlKPIapp,1655639627,Novapay,8999,8999,-8000,-8000,980,0,0,2384718,False,3BMK-4M25-1HH4-00T0
De5-f7rm5soBf--k,1655639502,Kafe La Fabrique,5814,5814,-10000,-10000,980,0,0,2392718,False,X408-2E9A-T9K2-H8K3
Rk7YNpqDfXXh9RBY,1655631739,–ï–ª–µ–∫—Ç—Ä–æ—Å–∞–º–æ–∫–∞—Ç–∏ Bolt,7999,7999,-972,-972,980,0,0,2402718,False,E73K-56A4-KC89-1M5X
HqbCWtMiCyAPiH4E,1655631713,BIRD UKR* RIDE,7999,7999,-10000,-10000,980,0,0,2403690,False,BB86-TBA3-E8KA-K8H0
tr-8xkFo-Za1QEEZ,1655631317,–°–∫–∞—Å—É–≤–∞–Ω–Ω—è. Bird,7999,7999,8500,8500,980,0,0,2413690,False
KS-r6j2HKduJCTET,1655631314,Bird,7999,7999,-8500,-8500,980,0,0,2405190,False
Z2Z3AC7YIQTK7e7b,1655631188,FRANKLY,5814,5814,-40500,-40500,980,0,0,2413690,False,368P-MPKP-2XTE-H17A
A1XTT-O4Og1h4jcd,1655630726,–ö–æ–ª–æ,5411,5814,-29200,-29200,980,0,0,2454190,False,84CX-225P-9A59-516B
nqD0ywe4BsxBKWIZ,1655629800,Fotovramke,5946,5946,-15000,-15000,980,0,0,2483390,False,T6A6-A27H-T7XA-0752
BSLDW9iLFKVqgvJQ,1655623227,Katimo Cafe,5812,5812,-14000,-14000,980,0,0,2498390,False,01HA-5EHB-EK8C-0H6T
Uo_S7HfyOogvW3kK,1655562105,–ê–ø—Ç–µ–∫–∞ –ê–ù–¶,5912,5912,-32450,-32450,980,0,649,2512390,False,BKCP-7BK0-9TAH-AX85
ZPE3Qrv6LSYOPZR7,1655550585,Mates,5814,5814,-76000,-76000,980,0,0,2544840,False,KETT-TH44-BEH0-69AB
IO3fVUxNSr8YqJ5G,1655536629,bwtc cafe&roasters,5814,5814,-16000,-16000,980,0,0,2620840,False,0791-46M4-X008-5MXX
Z5RhJx5rrNysFlvg,1655480706,Lesya,4829,4829,-500000,-500000,980,0,0,2636840,True,3KH9-0B10-E42M-32TH
1r1_g3El3Ha2zer1,1655457531,536354****7221,4829,4829,-79100,-79100,980,0,0,3136840,True,CB58-26A6-5C96-KB16
KNzw2H0JDQWdbRRX,1655457362,–íi–¥: –ü–†–ò–•–û–î–¨–ö–û –ï.–í. –§–û–ü,4829,4829,1200000,1200000,980,0,0,3215940,True
2suxHZttTdWgtAS2,1655455564,Produkti,5499,5499,-29200,-29200,980,0,0,2015940,False,PEB0-026A-2H8P-P7T3
7wVZt0Cu00osrcEY,1655454788,Produkti,5499,5499,-5500,-5500,980,0,0,2045140,False,T9EX-5H5K-E0M2-EKAM
C7S0Q_HicNmmo4Id,1655453394,–°–∫–∞—Å—É–≤–∞–Ω–Ω—è. Bird,7999,7999,8500,8500,980,0,0,2050640,False
8FZrNXEwJVW26uXF,1655453391,Bird,7999,7999,-8500,-8500,980,0,0,2042140,False
Wm0NmynFfTiuwENe,1655403111,Lesya,4829,4829,-20000,-20000,980,0,0,2050640,True,5509-M8KP-BP11-H4AE
neH936xh68hkb7Ae,1655387573,–í—ñ–¥: –û–ª–µ—Å—è –°–∞—á–µ–Ω–∫–æ,ü§ë,4829,4829,100000,100000,980,0,0,2070640,True
-1gZTg80TdoqQ2MM,1655385575,–ï–∫–æ-–õ–∞–≤–∫–∞,5411,5499,-4400,-4400,980,0,0,1970640,False,0M1E-EB2E-BC80-TE0H
MP_O8nPTm5BmzMQs,1655385406,OkvajnSichovih,5399,5399,-14500,-14500,980,0,0,1975040,False,CXT4-817P-PA5C-8537
lgtAfrMreiT3m19w,1655378741,Novapay,8999,8999,-6000,-6000,980,0,0,1989540,False,A0M2-9T1H-4X6H-X6C2
OdNKH230olthrdZX,1655375680,DELiTANT,5814,5814,-19500,-19500,980,0,0,1995540,False,K71P-58BE-AAMK-H435
Ynm6faOkRSIeXHG5,1655375569,–ï–ª–µ–∫—Ç—Ä–æ—Å–∞–º–æ–∫–∞—Ç–∏ Bolt,7999,7999,-5485,-5485,980,0,0,2015040,False,40E8-4394-AM66-EP8B
JkvbFvu0WfHYRwTT,1655375221,MagazinVuzlik,5399,5399,-5500,-5500,980,0,0,2020525,False,40TT-99P3-T382-322C
i9Jr_sxSKZOO4N-c,1655374251,PHotosalonMAN,7221,7221,-10300,-10300,980,0,0,2026025,False,73E2-597E-9089-6253
jFVJc6cc9-S0MzTT,1655369942,Apteka Mirra,5912,5912,-12320,-12320,980,0,246,2036325,False,T348-2E9E-9T7K-9M27
ZKoPx1gmKsoLmnBQ,1655368596,Bolt,4121,4121,-5600,-5600,980,0,0,2048645,False,4540-87EH-1X75-3M91
bYQSceB6zo44Dsix,1655357770,Bolt,4121,4121,-5500,-5500,980,0,0,2054245,False,X0EE-XT1K-6KXH-80ME
fLyRhroj2_2tQD9v,1655320475,Etsy,5699,5699,-19620,-600,840,0,0,2059745,False,BHA9-63CE-811M-22EH
tE5OSo8VCuVKCvSP,1655320232,WFP.AQUAMARKET,5411,5411,-58440,-58440,980,0,0,2079365,False,8941-36P5-EMM8-PTEE
OSb54dhNJvXuP0Hr,1655310358,–ê–ø—Ç–µ–∫–∞ –ê–ù–¶,5912,5912,-24650,-24650,980,0,493,2137805,False,92H0-695P-EX98-X9EK
Rbj8NhhH8lJOlbRZ,1655286219,Bolt,4121,4121,-12800,-12800,980,0,0,2162455,False,EHP7-136P-CA21-0TK8
vVbXBXKP-6KwT9Ue,1655283776,Bolt,4121,4121,-11300,-11300,980,0,0,2175255,False,CKKM-MT8C-70A6-M700
Pf2CP8R5mUa49o7A,1655276566,–í—ñ–¥: –û–ª–µ—Å—è –°–∞—á–µ–Ω–∫–æ,ü§ë,4829,4829,100000,100000,980,0,0,2186555,True
KMPRzqVC8V9AwlMu,1655276370,Lesya,4829,4829,-400000,-400000,980,0,0,2086555,True,80K1-ME4A-5XT9-M586
dWK0iUJPM_CND0mL,1655273766,bwtc cafe&roasters,5814,5814,-12500,-12500,980,0,0,2486555,False,56TA-HC07-H489-EEP5
GBv7YO5Z_PJalnuY,1655273566,Kafe La Fabrique,5814,5814,-8500,-8500,980,0,0,2499055,False,H51H-B2H5-35K8-CKK2
7ftQ68jlXspoGJVq,1655220763,–í–∞–ª–µ—Ä—ñ—è –ö.,4829,4829,-80000,-80000,980,0,0,2507555,True,KTM3-T9T3-A6KA-HB8P
wQtnnzzQb6aT8ZzC,1655214024,–ï–ª–µ–∫—Ç—Ä–æ—Å–∞–º–æ–∫–∞—Ç–∏ Bolt,7999,7999,-3575,-3575,980,0,0,2587555,False,39B4-89HP-7A9E-04C0
pRlvQ2rLV_XeWO6V,1655213688,ZOOISAD,5995,5995,-32000,-32000,980,0,0,2591130,False,4H2E-P469-5P1K-AH56
MciWpxNTe3Xrna5E,1655213380,–ö–æ–ª–æ,5411,5814,-21900,-21900,980,0,0,2623130,False,MM0E-04KK-8E76-203A
wi8xo1jvZyJygKlu,1655211655,–ï–ª–µ–∫—Ç—Ä–æ—Å–∞–º–æ–∫–∞—Ç–∏ Bolt,7999,7999,-1593,-1593,980,0,0,2645030,False,P0AK-A58B-C85B-8B79
I8SIYpziylGYQifC,1655211196,–ï–ª–µ–∫—Ç—Ä–æ—Å–∞–º–æ–∫–∞—Ç–∏ Bolt,7999,7999,-1638,-1638,980,0,0,2646623,False,3PHP-K974-A34E-H5XH
oJFg_hV8d7m6IXZm,1655207823,Novapay,8999,8999,-10500,-10500,980,0,0,2648261,False,3AEC-4ACM-3C9H-6PT1
W1RQAlcA7E94cVeG,1655204884,Lesya,4829,4829,-100000,-100000,980,0,0,2658761,True,K0H7-A13A-5716-EEKB
fADNYmhevk-lapTN,1655204838,–û–ª–µ–≥ –¢.,–°–∞—á–µ–Ω–∫–æ,4829,4829,-285800,-285800,980,0,0,2758761,True,4EBT-52A8-CM4E-2PE9
0ri5ih9iheAFOEJH,1655203445,Bolt Food,4215,4215,-57800,-57800,980,0,0,3044561,False,T6A7-15XP-9MTE-06E7
i9BgiDH_alNIoZUO,1655201089,–íi–¥: –ü–†–ò–•–û–î–¨–ö–û –ï.–í. –§–û–ü,4829,4829,1500000,1500000,980,0,0,3102361,True
em-DaB2iYpfT4GeW,1655198551,Steam,5816,5816,-16700,-16700,980,0,0,1602361,False,95XT-X9C4-88H5-8XC9
_G-Bftl83ViQnQ6F,1655146153,–ï–ª–µ–∫—Ç—Ä–æ—Å–∞–º–æ–∫–∞—Ç–∏ Bolt,7999,7999,-2133,-2133,980,0,0,1619061,False,432T-H69H-X3P8-BHC3
kPWKOkpawOVA_4xh,1655140051,Novapay,8999,8999,-6000,-6000,980,0,0,1621194,False,BEK0-K027-1PMC-6HC1
GyUxBJKrbje-a0Rm,1655132542,–ï–ª–µ–∫—Ç—Ä–æ—Å–∞–º–æ–∫–∞—Ç–∏ Bolt,7999,7999,-1988,-1988,980,0,0,1627194,False,ECB3-PX90-MXE9-2EXH
esg6FLgQf71CZfBq,1655127285,–ï–ª–µ–∫—Ç—Ä–æ—Å–∞–º–æ–∫–∞—Ç–∏ Bolt,7999,7999,-3263,-3263,980,0,0,1629182,False,56EB-B9TK-3901-MT54
fnRIUWEGLDN3QYwk,1655126603,Pryazha,5200,5200,-27000,-27000,980,0,0,1632445,False,P28X-7X5M-6E91-T5B8
BcxFirYmEPPSlEfA,1655122341,–§–û–ü –ö—Ä–∞—Å–Ω–æ–∫—É—Ç—Å—å–∫–∏–π –í–æ–ª–æ–¥–∏–º–∏—Ä –Æ—Ä—ñ–π–æ–≤–∏—á,4829,4829,-38760,-38760,980,760,0,1659445,True,2M3K-5A2A-H90P-5ABH
7mHx77U6SLVo08B1,1655119791,–ï–ª–µ–∫—Ç—Ä–æ—Å–∞–º–æ–∫–∞—Ç–∏ Bolt,7999,7999,-3160,-3160,980,0,0,1698205,False,XH37-CX36-P96K-11BP
919ns9QeSJz0bypi,1655106133,Mates,5814,5814,-15000,-15000,980,0,0,1701365,False,7TA5-1TA3-75MC-6008
u8Mt3NEy-bcCliC9,1655104257,ZOOLYUKS,742,742,-27500,-27500,980,0,0,1716365,False,137C-9TCX-KMP9-K5P3
VHNky8QvWT_O6gFa,1655051376,–°—ñ–ª—å–ø–æ,5411,5411,-582,-582,980,0,0,1743865,False,95KA-T660-7XHK-BMA0
HryhyQaZw_eRX8Pc,1655051091,–°—ñ–ª—å–ø–æ,5411,5411,-99695,-99695,980,0,0,1744447,False,MTCB-BKME-A178-0P9P
vJOfmdmX2xzuxQOy,1655049701,BIRD UKR* RIDE,7999,7999,-10000,-10000,980,0,0,1844142,False,8H5T-0KTM-0AX1-68C3
eEsLx-Sxl5T8jMhG,1655049603,–°–∫–∞—Å—É–≤–∞–Ω–Ω—è. Bird,7999,7999,8500,8500,980,0,0,1854142,False
Gfr9B2XJi17VXTft,1655049600,Bird,7999,7999,-8500,-8500,980,0,0,1845642,False
l_b10PgtKoCKjL8v,1655047308,5045Kavjarnja,5814,5814,-17500,-17500,980,0,0,1854142,False,6AE2-9269-0H45-219H
Zj9Oi7i52D8ZcNha,1655044903,–°–∫–∞—Å—É–≤–∞–Ω–Ω—è. Bird,7999,7999,8500,8500,980,0,0,1871642,False
yg2Zug-hS4S-mHmp,1655044900,Bird,7999,7999,-8500,-8500,980,0,0,1863142,False
mcOsWNFy4K62zb7M,1655039583,–°–∫–∞—Å—É–≤–∞–Ω–Ω—è. Bird,7999,7999,8500,8500,980,0,0,1871642,False
lOQw6ImJ8qIsQ4st,1655039580,Bird,7999,7999,-8500,-8500,980,0,0,1863142,False
5pZd4bKnHicDDJ8w,1655024441,IDEALIST COFFEE CO,5814,5814,-36500,-36500,980,0,0,1871642,False,1289-PBM5-M4H1-6B94
FLePfxkRw7mxUgyx,1655021776,–ï–ª–µ–∫—Ç—Ä–æ—Å–∞–º–æ–∫–∞—Ç–∏ Bolt,7999,7999,-1540,-1540,980,0,0,1908142,False,K0T5-TMXX-XPCC-BXK3
bV7rUbV3BSv0P7Yb,1654953230,–ö–æ–ª–æ,5411,5499,-34550,-34550,980,0,0,1909682,False,AX9A-015H-55KA-E2TX
oRAd6C33CSgpM0av,1654951901,–ö–æ–ª–æ,5411,5499,-8350,-8350,980,0,0,1944232,False,X9B3-386M-36TM-T022
UZd4onDgozQY-aUD,1654951815,–ê–ø—Ç–µ–∫–∞ –ê–ù–¶,5912,5912,-40580,-40580,980,0,304,1952582,False,90T6-3A9E-3M82-M8XE
Mmma-PYUv3DdBBuU,1654951776,–ï–∫–æ-–õ–∞–≤–∫–∞,5411,5499,-20500,-20500,980,0,0,1993162,False,8TB6-K90A-8994-A262
NsX20ESA3fluHI27,1654938136,Pryazha,5200,5200,-27000,-27000,980,0,0,2013662,False,KMPB-11C0-2H22-HE69
Af23upGXHpWeEG7a,1654932129,KapheSubota,5814,5814,-36200,-36200,980,0,0,2040662,False,1AKM-49PM-EKMP-C471
i0N5ZqKkUAFSqn3x,1654878375,Novapay,8999,8999,-6000,-6000,980,0,0,2076862,False,CTK1-TC2E-MA88-3M2E
1lxHa2FrSq-WOfhP,1654875765,Yaroslaviv Val 37-1,5499,5499,-38300,-38300,980,0,0,2082862,False,97H9-HAME-9AHH-ABKH
uWxCewPYJBjT8AY9,1654872084,–ï–ª–µ–∫—Ç—Ä–æ—Å–∞–º–æ–∫–∞—Ç–∏ Bolt,7999,7999,-2243,-2243,980,0,0,2121162,False,61PC-XH5T-2710-B804
huoktP1LcYUiyaLE,1654862460,DELiTANT,5814,5814,-8000,-8000,980,0,0,2123405,False,HX3B-AB35-K6CM-6H0P
7n6RbAIIagtBIsA9,1654862160,–ï–ª–µ–∫—Ç—Ä–æ—Å–∞–º–æ–∫–∞—Ç–∏ Bolt,7999,7999,-2388,-2388,980,0,0,2131405,False,CP40-5H08-2EPB-4PC2
uhiv5uPofYhR4Vu7,1654794014,Novapay,8999,8999,-9100,-9100,980,0,0,2133793,False,C220-TH0E-23A5-CMK8
MxDH4cBZKNn_m2q0,1654793919,Kitaika,5812,5812,-70000,-70000,980,0,0,2142893,False,P0B0-T414-BX7P-C1XA
FlqoY6Pk-ZyAlLIP,1654793284,OkvajnSichovih,5399,5399,-19230,-19230,980,0,0,2212893,False,2250-9PB7-C1EB-7BM2
ZKRIX-1newNmB60w,1654793087,Novapay,8999,8999,-6000,-6000,980,0,0,2232123,False,312C-65A3-1ET7-645C
rNZI-IlGv37lsJ6_,1654788698,–ü–æ–ø–æ–≤–Ω–µ–Ω–Ω—è ¬´–Ω–∞ —Ç–µ–ø–ª–æ–≤—ñ–∑–æ—Ä¬ª,4829,4829,-50000,-50000,980,0,0,2238123,True,281A-8C7P-XTC5-1778
W9uP0LjsGB0rmicS,1654782161,–ö–æ–ª–æ,5411,5499,-26950,-26950,980,0,0,2288123,False,B3A3-95EE-3H48-XK57
jMO0YTb1-zmBKX8i,1654780375,Bolt,4121,4121,-22400,-22400,980,0,0,2315073,False,C0E9-3CP3-0BB2-ME09
AoUASswzSOkxeuPr,1654775396,Novapay,8999,8999,-11700,-11700,980,0,0,2337473,False,1650-99K6-6K6E-7HAB
hH7bt4vvcugteFb3,1654768160,Bolt,4121,4121,-21900,-21900,980,0,0,2349173,False,KH9H-K8EX-889A-PT2C
-NARCCZBTv7Ce8OC,1654758729,Mates,5814,5814,-49000,-49000,980,0,0,2371073,False,X4E8-P7C7-BK10-MBM8
-vkMPCMyzvfGgXXA,1654711010,Lesya,4829,4829,-400000,-400000,980,0,0,2420073,True,142M-90K1-PKH0-1X13
0Xcy29pDKQThMJq3,1654695016,–û–ª–µ–∫—Å–∞–Ω–¥—Ä-–í–∞—Å–∏–ª—å –ú.,4829,4829,-72400,-72400,980,0,0,2820073,True,53K9-E6E1-801H-H696
uO0v21eWwcmPkNIo,1654687758,–ë–æ–≥–¥–∞–Ω–∞ –ë.,–û–ø–ª–∞—Ç–∞ –∑–∞ –ø—Ä–∏–∫—Ä–∞—Å–∏ –°–∞—á–µ–Ω–∫–æ,4829,4829,-35700,-35700,980,0,0,2892473,True,C8HP-3AE1-631X-A867
-_P9FWCy1xY_7VHN,1654683344,–ï–ª–µ–∫—Ç—Ä–æ—Å–∞–º–æ–∫–∞—Ç–∏ Bolt,7999,7999,-3618,-3618,980,0,0,2928173,False,482E-M8XT-585X-3EX7
0iVyr6rEEHo-O0wp,1654680166,"Lifecell
+380631692598",4814,4814,-16000,-16000,980,0,0,2931791,True,9CPB-4T3C-BB8B-3KKP
d4POUPFgxtRU7WVG,1654676746,DELiTANT,5814,5814,-3500,-3500,980,0,0,2947791,False,M06E-9HCC-3B02-4410
oNF_ghT2kHZDngfk,1654676720,Bolt,4121,4121,-8400,-8400,980,0,0,2951291,False,A533-3KH8-K452-MM89
IJ4OgW5kjeiLaEz9,1654675671,–íi–¥: –ü–†–ò–•–û–î–¨–ö–û –ï.–í. –§–û–ü,4829,4829,2600000,2600000,980,0,0,2959691,True
a-0cxZoc4Mh5JKuy,1654670822,–ï–ª–µ–∫—Ç—Ä–æ—Å–∞–º–æ–∫–∞—Ç–∏ Bolt,7999,7999,-1827,-1827,980,0,0,359691,False,A00X-EHCE-1KP9-H124
pYisO2VX5fZFv5lD,1654623088,–ö–æ–ª–æ,5411,5499,-31550,-31550,980,0,0,361518,False,53H1-5PXX-408T-K2ME
3xMvQj-yxTXcMxCg,1654621283,Bolt Food,4215,4215,-61500,-61500,980,0,0,393068,False,H59E-1CHC-6C19-T7TA
AsmWY4-H9BeAdlCE,1654617331,BIRD UKR* PRELOAD,7999,7999,-10000,-10000,980,0,0,454568,False,1K2X-20BB-KB01-M09A
u3pGUSMRqUw8iKc1,1654615851,Novapay,8999,8999,-5000,-5000,980,0,0,464568,False,T478-AEK4-C56T-P8KX
Ql6qWRgkPvkcH-ts,1654593277,–ê–ø—Ç–µ–∫–∞ –ê–ù–¶,5912,5912,-14070,-14070,980,0,105,469568,False,5T94-601C-7715-076B
EimZofW3lBf-48et,1654586071,Kafe La Fabrique,5814,5814,-8700,-8700,980,0,0,483638,False,83XK-46A1-0510-X5M9
HSkoDd_Lq1j5suuR,1654537177,–†–æ–¥-–ù–∏–∫,5541,5541,-211597,-211597,980,0,1586,492338,False,54MA-A3ME-K916-XMP3
WrRk2RrursqMILZw,1654522867,–ï–ª–µ–∫—Ç—Ä–æ—Å–∞–º–æ–∫–∞—Ç–∏ Bolt,7999,7999,-2535,-2535,980,0,0,703935,False,4T3P-C28B-XA1M-KBAH
EnmieX6Js0S0llGb,1654513883,Novus,5411,5411,-9999,-9999,980,0,0,706470,False,PBTC-37AP-X3AP-291E
sk82vw_hXxEhHpcz,1654513835,Novus,5411,5411,-62647,-62647,980,0,0,716469,False,0PPT-158P-9K65-71C9
1_nkFEnRrElu37gR,1654513549,–ï–ª–µ–∫—Ç—Ä–æ—Å–∞–º–æ–∫–∞—Ç–∏ Bolt,7999,7999,-7245,-7245,980,0,0,779116,False,79K0-HPAT-X7K1-845H
UZ3TsXDkLmTVzJaO,1654512564,"Vodafone
+380978495150",4814,4814,-6000,-6000,980,0,0,786361,True,9AA0-XMMA-8BE5-83K8
GB4UOOG_DJSY5pGE,1654511674,–£–∫—Ä–ø–æ—à—Ç–∞,9402,9402,-3500,-3500,980,0,0,792361,False,MH70-2B18-M2C7-HM4P
YR9_1rb7O65gKJNY,1654511621,–£–∫—Ä–ø–æ—à—Ç–∞,9402,9402,-24195,-24195,980,0,0,795861,False,85TP-54XK-TXCT-K7PA
7EUCmYQVgjcLDawL,1654509607,DELiTANT,5814,5814,-6500,-6500,980,0,0,820056,False,PT8M-44H9-TKB5-49A0
nH6Ks2GVAYaWQf1h,1654506599,Produkti,5499,5499,-14600,-14600,980,0,0,826556,False,3K4T-K7HA-HMH7-8B9H
2dvhFNy_MeRl3E6S,1654505092,Mates,5814,5814,-10500,-10500,980,0,0,841156,False,C372-6HBT-AKH1-08K6
dg2gy0g-lcPk9vzQ,1654504427,ZOOLYUKS,742,742,-50000,-50000,980,0,0,851656,False,PXEP-432C-3K0C-HBX3
7n2XEN6cs8_zW07G,1654504127,–ï–ª–µ–∫—Ç—Ä–æ—Å–∞–º–æ–∫–∞—Ç–∏ Bolt,7999,7999,-983,-983,980,0,0,901656,False,5HME-P20M-M0X9-6E0K
18xdkbPpSTOtBNdf,1654439966,–ö–æ–ª–æ,5411,5499,-6550,-6550,980,0,0,902639,False,83M6-8MK7-4B1X-P2M1
73x6kI6hfyA4hSws,1654439270,Novus,5411,5411,-46222,-46222,980,0,0,909189,False,38M1-BK1T-PAXX-2EPC
gaI0Vkvu17xNo2qV,1654438783,–ê–ø—Ç–µ–∫–∞ –î–æ–±—Ä–æ–≥–æ –î–Ω—è,5912,5912,-19570,-19570,980,0,146,955411,False,HEH7-6AX7-86KX-BP1H
PRHFByNXPuR-JuEW,1654437357,SALON KRASY BACKSTAGE,7230,7230,-50000,-50000,980,0,375,974981,False,222H-T554-33M1-1AHA
Yo0j803dP3UVMk59,1654416030,Kafe La Fabrique,5814,5814,-18700,-18700,980,0,0,1024981,False,0C11-76X1-3XC1-PCT6
mTdsEHVZjML6UM8E,1654378208,MAKEUP,5977,5977,-142200,-142200,980,0,1066,1043681,False,EK39-5C1A-1M1K-B0AK
6SE2iH9IvtT_MVMh,1654356177,Novapay,8999,8999,-6800,-6800,980,0,0,1185881,False,M18C-HKBA-7MTK-M0BP
m9vOhwcReb9BJcS2,1654343855,Novus,5411,5411,-6199,-6199,980,0,0,1192681,False,KE3P-TA68-X44M-6ME2
FIb6p1lde8fWkEAc,1654343084,MolokovidPHermera,5499,5499,-4990,-4990,980,0,0,1198880,False,C0XT-HX6M-25E4-EEK6
37CMFKZIZmdtsz_x,1654341378,DelviMag146,5499,5499,-17560,-17560,980,0,0,1203870,False,3511-676K-1191-B484
miQVNUgy9L1VmQJ1,1654340810,83 ASM PAVLIVSKA 17,5912,5912,-65747,-65747,980,0,493,1221430,False,3091-A146-K96K-78AX
yKwss0UZFTEUovAl,1654340514,ZOOLYUKS,742,742,-476630,-476630,980,0,0,1287177,False,K5EX-X930-B902-9699
jbScLpHedWC04sSL,1654338519,–ï–ª–µ–∫—Ç—Ä–æ—Å–∞–º–æ–∫–∞—Ç–∏ Bolt,7999,7999,-1435,-1435,980,0,0,1763807,False,PX27-22T4-11M2-C2B7
NLD33jtvuUCYk8Od,1654332686,Bolt,4121,4121,-14700,-14700,980,0,0,1765242,False,08K5-5MP1-EP26-HKKT
jfCAnjst1OqwGe_U,1654331510,Mates,5814,5814,-43500,-43500,980,0,0,1779942,False,0PT7-1MTE-CH12-CKB0
Szf_1RVhwXUAbFXX,1654327942,–ï–∫–æ-–õ–∞–≤–∫–∞,5411,5499,-53500,-53500,980,0,0,1823442,False,PMMH-7680-H31C-9BPE
7CD3U-B7pTAS0MLq,1654277211,Bolt,4121,4121,-6500,-6500,980,0,0,1876942,False,7HP7-718C-50AH-9A42
AnI9h0RPyHI8jUF0,1654276497,ZOOLYUKS,742,742,-300000,-300000,980,0,0,1883442,False,638B-3AAH-37H9-2C0K
uiaMD06Xo_kjr3Uk,1654266794,Bolt,4121,4121,-17200,-17200,980,0,0,2183442,False,2H6X-6EKK-4A63-5126
o2BRuhtJNd1NJ54P,1654253846,Bolt,4121,4121,-14000,-14000,980,0,0,2200642,False,KB2H-XXKA-PCHT-27A9
it6RamBqR3rAbnaf,1654252061,Bolt,4121,4121,-9200,-9200,980,0,0,2214642,False,75KP-713P-C801-2000
0LeijuCnKHNBBTY6,1654243841,Bolt,4121,4121,-16200,-16200,980,0,0,2223842,False,99HA-9T3M-4MET-TMCM
h-IJkROXCLD75WFu,1654237528,Lesya,4829,4829,-400000,-400000,980,0,0,2240042,True,91PH-H49E-39A5-0X66
C9F61l2iUwllg5il,1654175790,–ï–ª–µ–∫—Ç—Ä–æ—Å–∞–º–æ–∫–∞—Ç–∏ Bolt,7999,7999,-4580,-4580,980,0,0,2640042,False,7762-1381-E6H6-7XMK
ATYeagYurTaCa2FN,1654151863,–ê–ø—Ç–µ–∫–∞ –ê–ù–¶,5912,5912,-4800,-4800,980,0,0,2644622,False,8X19-5553-4869-T21X
VtGSbfajp7neixC2,1654113114,–ê–ª—ñ—Å–∞ –ß.,–ù–∞ –∫–æ—Ä—á,4829,4829,-100000,-100000,980,0,0,2649422,True,X07K-X4MC-ECTH-H91H
CsHlIWSl65ksLeFD,1654104386,–í—ñ–¥: –í–ª–∞–¥–∏—Å–ª–∞–≤ –ß–æ—Ä–Ω–∏–π,–ü–∏–≤–∞—Å,4829,4829,31500,31500,980,0,0,2749422,True
q6mtBPG1Ek5_WNfj,1654104241,–¢–∞—Ä–∞—Å –ì.,4829,4829,-87000,-87000,980,0,0,2717922,True,K476-H30C-H32X-71K8
MMytQ8fvzsdzxnC0,1654099537,Bolt,4121,4121,-1200,-1200,980,0,0,2804922,False,AMB5-75M3-X132-XT0P
GqNwAKcQQJ7n3jEB,1654086447,Bolt,4121,4121,-8400,-8400,980,0,0,2806122,False,5X4T-4H2E-T646-932P
qWR-Rb-r0vSWoRZH,1654077378,Lesya,–ù–∞ –ø—É—Ö–∫—ñ,4829,4829,-500000,-500000,980,0,0,2814522,True,HC59-86KB-XH9H-33H2
s8wWHqkXWnTfd42S,1654068292,DigitalOcean,5734,5734,-39120,-1200,840,0,0,3314522,False,B3EC-6314-P16K-C17K
6Bpt4yPyG-V12DZ6,1654063030,Mates,5814,5814,-16500,-16500,980,0,0,3353642,False,511T-C593-264P-03CX
JTrLut4R3aCFBg78,1659204062,LIQPAY*TOV Avto-Holl,5533,5533,-53800,-53800,980,0,0,730597,False,8BPA-M061-1TPE-P7E0
craOBktwb2Q5RmDm,1659185155,OK Wine,5411,5411,-5800,-5800,980,0,43,784397,False,HBBT-E01T-3EK0-1E40
IDrPc_0ynv002Ou1,1659184980,Bolt,4121,4121,-6700,-6700,980,0,0,790197,False,8ABH-AK1P-T864-PEKM
8QMQhU5-WYVUCOaA,1659184536,DOWNTOWNNAILS,7230,7230,-50000,-50000,980,0,0,796897,False,0PBA-0A2A-XET7-3MA7
kaiMYw3IV83cOF1z,1659183818,–°—ñ–ª—å–ø–æ,5411,5411,-32038,-32038,980,0,240,846897,False,CE41-680H-MP1E-66T1
DaJAyTthiTWUHCS6,1659183729,–°—ñ–ª—å–ø–æ,5411,5411,-97810,-97810,980,0,733,878935,False,004M-17X4-1190-62BH
9Di19yt-anKELjGA,1659182892,–ï–ª–µ–∫—Ç—Ä–æ—Å–∞–º–æ–∫–∞—Ç–∏ Bolt,7999,7999,-1500,-1500,980,0,0,976745,False,1X0K-AHA7-531T-KT2T
-r3IwFFBqj7vr_Ji,1659161657,bwtc cafe&roasters,5814,5814,-24000,-24000,980,0,0,978245,False,K7BB-640K-50T0-9BB0
J6GEzYd_3rm5YbV7,1659159889,–ü–ª–∞–Ω–µ—Ç–∞ –ö—ñ–Ω–æ,7832,7832,-30000,-30000,980,0,0,1002245,False,MXTC-K105-9CME-9M5C
flCdPwtV_-BU8gIm,1659112673,–ö–æ–ª–æ,5411,5499,-1600,-1600,980,0,12,1032245,False,C784-0K68-EXK5-2EEP
TmIEcFXnFF3Lu5m9,1659111397,5045Kavjarnja,5814,5814,-19000,-19000,980,0,0,1033845,False,HM1B-1ACK-3B0E-HPKK
w6RrckUwQL41dWej,1659111073,5045Kavjarnja,5814,5814,-12000,-12000,980,0,0,1052845,False,851H-948P-63B2-H9M3
5foyUWjcQ4zXs-Jo,1659103188,–ö—ñ–Ω–æ–º–∞—Ä–∫–µ—Ç –ü–ª–∞–Ω–µ—Ç–∞ –ö—ñ–Ω–æ,5411,5411,-16400,-16400,980,0,123,1064845,False,25KM-0P68-P96X-B224
3yazlIDI4m9iCivJ,1659102423,–°–∫–∞—Å—É–≤–∞–Ω–Ω—è. WFP ELECTRONICS,5732,5732,23300,23300,980,0,0,1081245,False
QLaVZwP-zJjiMKmv,1659099241,MAGAZIN,5399,5399,-69000,-69000,980,0,517,1057945,False,TT9C-75BA-76A0-HKHC
3z5xzWb-AKv47fti,1659099131,Bird,7999,7999,-10000,-10000,980,0,0,1126945,False,PMA2-0K54-CKCM-HTKH
3500Xe88H3cLhlrh,1659098876,–°–∫–∞—Å—É–≤–∞–Ω–Ω—è. Bird,7999,7999,8500,8500,980,0,0,1136945,False
s2LF2t_LLuJUpRvR,1659098872,Bird,7999,7999,-8500,-8500,980,0,0,1128445,False
PoWFB7cresmeBBp8,1659098697,NUGA,5621,5621,-160000,-160000,980,0,0,1136945,False,0T8H-H8BP-09CA-AKXK
jXbw-WE2C3uSr2-m,1659097978,Bolt,4121,4121,-6100,-6100,980,0,0,1296945,False,16KC-5BAP-EEX2-B5BT
hd9IvGJsOjGD2W5-,1659097113,SHOP COOSH,5621,5621,-8000,-8000,980,0,0,1303045,False,T6PB-K92X-9KE9-MCP9
O4pWZ6BOjtkEGPIh,1659097034,IBOXBANK 17,4814,4814,-12000,-12000,980,0,0,1311045,False,MMK6-A4H8-X3CT-XC31
rTPBwFz7BnxgMn5y,1659096377,Bolt,4121,4121,-8400,-8400,980,0,0,1323045,False,0EP0-B9X9-2024-P990
XH-PYXTdT2T0Woiv,1659089606,bwtc cafe&roasters,5814,5814,-10000,-10000,980,0,0,1331445,False,E4H4-0HM5-69CT-C9E9
qa9F91T-Yv-gF_ob,1659074212,Produkti,5499,5499,-6900,-6900,980,0,51,1341445,False,01C7-E242-4TM2-5P3A
ubZVzBlTxtNKs1PX,1659035803,WFP ELECTRONICS,5732,5732,-23300,-23300,980,0,0,1348345,False
VE64LAfFwJQiZYuT,1659034895,PRTMN  *AUTO W,5533,5533,-50100,-50100,980,0,0,1371645,False,B455-H65B-BE9A-E70M
mCK5pCzsVI_9fYGN,1659034440,LIQPAY*Fonarik.com,5200,5200,-291000,-291000,980,0,0,1421745,False,761T-7TM8-MEH0-K5E0
nF717NLVFmd5IZCE,1659028573,Novus,5411,5411,-4399,-4399,980,0,32,1712745,False,5797-CP1X-X6T7-0C56
ZYKToocCOYWYV4BT,1659027632,Ponchyk Boy,5812,5812,-24200,-24200,980,0,0,1717144,True,06M4-XCMP-8X2T-1329
ZVxZONNQIh0huXb9,1659019905,Novapay,8999,8999,-6800,-6800,980,0,0,1741344,False,BBCX-92EB-53H6-T7T3
vef_qaR6ZpTZ-PTF,1659017799,JYSK,5712,5712,-220000,-220000,980,0,0,1748144,False,P5CH-TXBB-K06B-M54H
ZalI0I1A64BMACvP,1659014497,–ö–æ–ª–æ,5411,5499,-3200,-3200,980,0,24,1968144,False,PTP3-CXKM-B26B-H228
4XiDXrLIlAMqGsq4,1659013228,5045Kavjarnja,5814,5814,-18500,-18500,980,0,0,1971344,False,3C40-B21X-XXKH-2747
8v_zgkxqAQrjcJvU,1659010341,MAGAZIN,5399,5399,-33900,-33900,980,0,313,1989844,False,XK88-1KCP-B18P-K940
T86YpDBFey3Fksio,1659010303,–§–ö –ï–í–û,5399,5399,-95300,-95300,980,0,953,2023744,False,A7K7-3BPH-44TE-XTE1
PjDFiVWRUUCVuZnr,1659005417,Lipa,5814,5814,-19000,-19000,980,0,0,2119044,False,XB16-0CPB-8826-2335
3IP_rsbmcDYcWHcI,1659000758,Lipa,5814,5814,-45500,-45500,980,0,0,2138044,False,4XTK-H89E-E6E2-C4CB
U-MxVvNEMKuOYzJ3,1658999096,–°–∫–∞—Å—É–≤–∞–Ω–Ω—è. Bird,7999,7999,8500,8500,980,0,0,2183544,False
nfD9yKQL8CrV2Xmr,1658999093,Bird,7999,7999,-8500,-8500,980,0,0,2175044,False
uAOWr9CvN3pFKGeB,1658989127,bwtc cafe&roasters,5814,5814,-25500,-25500,980,0,0,2183544,False,41C0-KAMK-69XB-3CC4
vZSP4fYj0UEf4G37,1658940743,–ö–æ–ª–æ,5411,5499,-21900,-21900,980,0,219,2209044,False,AHA3-AT65-5PAE-H41P
njyqCBY8ORmR4CXD,1658939939,Novapay,8999,8999,-5000,-5000,980,0,0,2230944,False,7EEE-A2C4-61M3-KTE3
zEyWIOo36Cul0gYh,1658939482,FOP DOBRIaNSKAIa,4812,4812,-40000,-40000,980,0,0,2235944,False,P05A-TK6B-56KT-P4KM
ejM68GRXIdEqRPfg,1658939382,FOPDobryanskiyOleksand,4812,4812,-485000,-485000,980,0,0,2275944,False,X2HH-907P-39E2-071X
TPdlI2jMPGktgplO,1658914156,Lesya,4829,4829,-100000,-100000,980,0,0,2760944,True,16HK-892X-6PBH-9613
7tbDPJhQRlV600ww,1658912007,Bolt,4121,4121,-8400,-8400,980,0,0,2860944,False,X17P-534T-5KT1-3263
uLqsMez68r-EL5RD,1658908716,MEDICALCENTERUNIVERSUM,8099,8099,-140000,-140000,980,0,0,2869344,False,9MKX-55P2-K8CE-K563
T3Y9t04V82V4qtvH,1658901000,bwtc cafe&roasters,5814,5814,-9500,-9500,980,0,0,3009344,False,709X-920H-1T49-C020
oNbyv1mJiOtKxc8n,1658869681,LIQPAY*Pethouse,5995,5995,-64000,-64000,980,0,0,3018844,False,X1KC-HEX2-M48C-K2XT
zj4oLZjgVFZS_eHr,1658856286,Novapay,8999,8999,-6500,-6500,980,0,0,3082844,False,M286-2248-3EBC-2C49
L6Oe42IUj0Ou8w6D,1658855066,bwtc cafe&roasters,5814,5814,-5600,-5600,980,0,0,3089344,False,X65H-M732-MA2A-2CA8
dQ7u87AjyYvvgCFc,1658854788,bwtc cafe&roasters,5814,5814,-5000,-5000,980,0,0,3094944,False,A6C1-3A26-EP5P-18BX
TPMBXP6ISZj1tY1C,1658847533,–ï–ª–µ–∫—Ç—Ä–æ—Å–∞–º–æ–∫–∞—Ç–∏ Bolt,7999,7999,-3839,-3839,980,0,0,3099944,False,X368-5H01-HPBA-P79M
d5VfeiV1yTX4NZcQ,1658846464,Novapay,8999,8999,-5000,-5000,980,0,0,3103783,False,EA8E-H1C1-5XXE-7PPP
eBbQH7Dr--FdZUi2,1658837445,Lesya,4829,4829,-100000,-100000,980,0,0,3108783,True,133M-0XTH-XHE8-1MXP
vYtPx76tGBy6SKl2,1658835063,t.c.pizza,5812,5812,-109600,-109600,980,0,0,3208783,True,P5P0-8CPA-5H20-3CT0
53mYjiEzy-YcNSU7,1658834470,Novapay,8999,8999,-8000,-8000,980,0,0,3318383,False,HC3H-B291-2P73-00MH
5ZvgN_oUBf47wn4x,1658834151,Novapay,8999,8999,-8000,-8000,980,0,0,3326383,False,9KE3-5151-HP55-CX7H
b-K50kTW48zERRIu,1658830734,–ï–ª–µ–∫—Ç—Ä–æ—Å–∞–º–æ–∫–∞—Ç–∏ Bolt,7999,7999,-1606,-1606,980,0,0,3334383,False,63T2-1511-3BT6-PPCK
HPKJRGkS3R11StJy,1658828906,WFP.AQUAMARKET,5411,5411,-36880,-36880,980,0,368,3335989,False,E81H-TH89-2E1T-4XH4
1mxWz25MavZ5mAhI,1658828142,Lesya,4829,4829,-800000,-800000,980,0,0,3372869,True,76M1-AM1H-XPPC-9090
s_I83896s3IdbEw_,1658828103,–íi–¥: –ü–†–ò–•–û–î–¨–ö–û –ï.–í. –§–û–ü,4829,4829,3400000,3400000,980,0,0,4172869,True
pvWmWPoE_cwGgHKH,1658827023,Novapay,8999,8999,-8000,-8000,980,0,0,772869,False,771T-6KE6-M57K-3CT8
MBujB8BAHuZJC0A1,1658825894,Novapay,8999,8999,-5000,-5000,980,0,0,780869,False,62KP-8PCM-B0B2-2TTE
g6twLrsWMZosqr8j,1658825858,Novapay,8999,8999,-2500,-2500,980,0,0,785869,False,XTM3-TPCH-2T7K-8B20
sMB8MGtS-_Jvy7NO,1658825524,Novapay,8999,8999,-8000,-8000,980,0,0,788369,False,P0K7-0562-6P8T-2558
-ZIS59HmZP6-ytAh,1658820059,–ü–∏—Ä—ñ–∂–∫–æ–≤–∞ ¬´–¢—ñ—Ç–∫–∞ –ö–ª–∞—Ä–∞¬ª,5814,5814,-2100,-2100,980,0,0,796369,False,P3MC-XTTK-6P6P-1150
JTb4QW81bH08R7zh,1658819992,–ê–ø—Ç–µ–∫–∞ –ê–ù–¶,5912,5912,-19430,-19430,980,0,582,798469,False,5KHK-5CH2-6C40-E8AC
Tty9DyPgyxe_sPww,1658819479,Master Zoo,5995,5995,-136280,-136280,980,0,6814,817899,False,AETK-4C78-57CA-76TH
MuBw_nIH_ThpLbMV,1658817467,5045Kavjarnja,5814,5814,-7900,-7900,980,0,0,954179,False,BC7B-BB8T-457X-5HM7
6KDkzkxhQui0GMpQ,1658817108,–ö–æ–ª–æ,5411,5499,-25000,-25000,980,0,187,962079,False,90TB-7028-3898-253B
O8waweYj37z4DLKE,1658765680,Novapay,8999,8999,-5000,-5000,980,0,0,987079,False,79BP-P762-K58P-05XA
6iXtHSSrj6Y4ut5u,1658758991,Novapay,8999,8999,-5700,-5700,980,0,0,992079,False,XPP6-3M2P-CM50-A0K3
zdwUVfLj2uBh_HL9,1658748798,Bird,7999,7999,-10000,-10000,980,0,0,997779,False,CMM0-6M17-0KPP-E8KP
p_tEoKc9wDC-7swN,1658747923,–°–∫–∞—Å—É–≤–∞–Ω–Ω—è. Bird,7999,7999,8500,8500,980,0,0,1007779,False
_cq_5alXhJ1mgKEx,1658747920,Bird,7999,7999,-8500,-8500,980,0,0,999279,False
CHypCco12W6MpxHG,1658747611,Konteyner,5814,5814,-37000,-37000,980,0,0,1007779,False,8B4K-2C7C-MM92-BBA8
rd_7ixWD-P1z0kGE,1658747013,–§–ö –ï–í–û,5399,5399,-179700,-179700,980,0,1347,1044779,False,HKKE-0P6X-EP73-3944
yYGZXyx0Djo85vcz,1658738240,–ï–ø—ñ—Ü–µ–Ω—Ç—Ä,5211,5211,-12700,-12700,980,0,0,1224479,False,K4P4-5C76-CT4P-K5PH
UMe-MHwAkD4wB1ft,1658733379,magazin 762597,5912,5912,-51750,-51750,980,0,0,1237179,False,AKH7-AK51-PTA4-05M8
G1uhBrXA3AfHuLru,1658732818,–°–∫–∞—Å—É–≤–∞–Ω–Ω—è. Bird,7999,7999,8500,8500,980,0,0,1288929,False
JUjb7BqGqTqAKKqe,1658732814,Bird,7999,7999,-8500,-8500,980,0,0,1280429,False
CTg4UD6MJGRq3RHq,1658729614,bwtc cafe&roasters,5814,5814,-10500,-10500,980,0,0,1288929,False,M1KM-M776-EK15-2KH2
mVRVC6fL4GYIhM3l,1658682087,–ö–æ–ª–æ,5411,5499,-23700,-23700,980,0,177,1299429,False,X0HE-KEEC-BC0M-8147
0JzXbOtEfczWkVnP,1658681438,–°—ñ–ª—å–ø–æ,5411,5411,-6696,-6696,980,0,50,1323129,False,AH12-PC2H-09CA-XEEK
WA1D6ZIKv0T7fZi3,1658675253,FDY*Charitable_s,8398,8398,-130000,-130000,980,0,0,1329825,False,9X7A-TAHE-394X-TC7B
81yayXQnTyGpEk26,1658669907,Novapay,8999,8999,-5000,-5000,980,0,0,1459825,False,MHTA-1AP2-C644-A40P
DNt9RBDIwoeVc9ar,1658666469,–ö–æ–ª–æ,5411,5499,-5850,-5850,980,0,43,1464825,False,H49B-6B68-5H3T-A93H
vgR7nBkQ9gWdLSid,1658660965,–ù–æ–≤–∞ –ø–æ—à—Ç–∞,7399,7399,-21500,-21500,980,0,0,1470675,False,50T3-8C2K-2704-6H6C
Q7d3P_F4bJWWoD8b,1658659256,ATL,5533,5533,-7900,-7900,980,0,0,1492175,False,TPA1-21XM-9PT4-ETX7
eJgobuqzjpCtE4Kl,1658658741,ATL,5533,5533,-73300,-73300,980,0,0,1500075,False,M0T5-K175-6BH8-X7M8
TAIQbQ6dhooGHbKQ,1658653304,–ê–≤—Ç–æ—Å—Ç–∞–Ω—Ü—ñ—è,5812,5812,-136400,-136400,980,0,0,1573375,True,0C69-AE12-EPHB-TB1T
VMBBOgxjJaAsWtpI,1658652604,Novapay,8999,8999,-8000,-8000,980,0,0,1709775,False,H6C0-AKPM-T6C4-45PC
jj0D9qsVNS2-ByWn,1658598191,IDEALIST COFFEE CO,5814,5814,-24900,-24900,980,0,0,1717775,False,9E66-CP82-7353-1APM
PyaabTxMC7BEItj5,1658587375,Novapay,8999,8999,-5800,-5800,980,0,0,1742675,False,9P84-M9BX-8PCE-27XH
9e5e-DV8NrOu8-U2,1658586702,Novapay,8999,8999,-4500,-4500,980,0,0,1748475,False,390K-K086-0ABC-K18B
lHe9cy9FASGT8qc8,1658584028,Novus,5411,5411,-36893,-36893,980,0,276,1752975,False,PA4H-T107-TCX6-PAA3
BgrnLkVJIHl2Blww,1658578850,–ü–æ–ø–æ–≤–Ω–µ–Ω–Ω—è ¬´–ù–ê –ë–õ–ê–ö–ò–¢–ù–Ü –ú–†–Ü–á üíô¬ª,4829,4829,-51750,-51750,980,1750,0,1789868,True,EHXA-6HMA-34BM-HAPB
ezGlBfF0lTYJU_f6,1658576844,OK Wine,5411,5411,-24220,-24220,980,0,181,1841618,False,21E6-0P98-KHKM-X447
8rmXC8T6BmlKhqwo,1658572199,ATL Car Service,7538,7538,-53000,-53000,980,0,0,1865838,False,E9C5-28XH-C241-A336
nUfUvoKbtT7EENip,1658570985,Mates,5814,5814,-45500,-45500,980,0,0,1918838,False,1H4C-9X7A-5B07-H3C7
BQNlOkDr4aK-FnOg,1658569303,DelviMag146,5499,5499,-18000,-18000,980,0,135,1964338,False,6920-MAKA-C299-EMEH
LEa_nJBOMYyf67NI,1658559709,bwtc cafe&roasters,5814,5814,-10000,-10000,980,0,0,1982338,False,HK59-647B-6978-2BP1
gKc4h3nkvfR4YzIY,1658511737,bwtc cafe&roasters,5814,5814,-17000,-17000,980,0,0,1992338,False,PB75-0046-4H8E-CT83
vNcjr0XLrTL9YiTN,1658501443,Lesya,4829,4829,-140000,-140000,980,0,0,2009338,True,B9K2-7975-9965-4513
Hv9BHIJyjE-RLvoa,1658500614,Bolt Food,4215,4215,-52000,-52000,980,0,0,2149338,False,MME2-42CX-P704-CXX7
sF5wVtKuKc-aoVvt,1658499334,Avantage 7,5541,5541,-246326,-246326,980,0,0,2201338,False,7090-043E-T1KE-8MM5
ZwPZ0Xj-GVYhlYTy,1658499241,MagazinOTeligi,5499,5499,-2200,-2200,980,0,22,2447664,False,A6H4-3997-EHX9-083K
tkL-AGF5EEqt1v8o,1658494589,Bolt,4121,4121,-10900,-10900,980,0,0,2449864,False,8ATK-02H7-6KE3-12A1
FiMLRagbKnuSvJub,1658494226,–íi–¥: –ü–†–ò–•–û–î–¨–ö–û –ï.–í. –§–û–ü,4829,4829,2000000,2000000,980,0,0,2460764,True
Rdx8iL2TS4Hq2HWp,1658483687,Roshen,5441,5441,-1675,-1675,980,0,12,460764,False,E0A0-71H9-53H5-9EH3
gJnqfHC8SA7kZe7S,1658424912,Novapay,8999,8999,-14500,-14500,980,0,0,462439,False,B8M1-A4TX-6PXT-7BHB
1AVx-XUfcAAdUOYh,1658422765,bwtc cafe&roasters,5814,5814,-25500,-25500,980,0,0,476939,False,P006-KH9A-9M16-M2HE
1Kp0UMJmdwaxlxnK,1658416000,Bird,7999,7999,-10000,-10000,980,0,0,502439,False,4K6M-P97B-B90H-6C5H
NG0dfmHBOenNFD7H,1658415100,–°–∫–∞—Å—É–≤–∞–Ω–Ω—è. Bird,7999,7999,8500,8500,980,0,0,512439,False
-2ihcPpTL3jnOaHy,1658415097,Bird,7999,7999,-8500,-8500,980,0,0,503939,False
yNKs5yffArDTU7F3,1658415026,–°–∫–∞—Å—É–≤–∞–Ω–Ω—è. Bird,7999,7999,8500,8500,980,0,0,512439,False
TCAOzwIlKbhKSJLQ,1658415023,Bird,7999,7999,-8500,-8500,980,0,0,503939,False
JCfFXcQHFWmp56li,1658414492,DELiTANT,5814,5814,-8000,-8000,980,0,0,512439,False,HB36-AA4P-H801-7X4P
fWS1vDOXNfjvcUSl,1658414428,Novapay,8999,8999,-5600,-5600,980,0,0,520439,False,K9H7-X372-T0P9-C5PC
s7OCDhHIohj-MD7V,1658410335,Bolt,4121,4121,-6800,-6800,980,0,0,526039,False,5M8C-C603-B5C0-5P17
_ZbDoKSWehLqptFi,1658404646,OK Wine,5411,5411,-135360,-135360,980,0,1015,532839,False,A6CK-AEHC-6549-C51A
fMrJT9mMiBMrzSvL,1658404187,Novapay,8999,8999,-7000,-7000,980,0,0,668199,False,TKP8-M6B0-764P-A844
Vvul8sdqqrE5bWqg,1658402110,Novapay,8999,8999,-4500,-4500,980,0,0,675199,False,A4B6-A9K0-X31C-BAC6
fUb4eMsq3GEytx5C,1658399671,Bolt,4121,4121,-23600,-23600,980,0,0,679699,False,EH15-0THE-135T-76M7
CTu47fY8hKfQVp-E,1658399459,Lesya,4829,4829,-104,-104,980,4,0,703299,True,X6C4-EP1H-7C9B-MA47
4lnbjnfkBAaNLCZF,1658399451,Novapay,8999,8999,-6500,-6500,980,0,0,703403,False,XCX0-9AE9-3HTX-6APK
6Xz3bHZgtqUPsg2e,1658392578,Bolt,4121,4121,-21600,-21600,980,0,0,709903,False,94CH-4826-M417-7E5H
-GjOF7TB7pPIyUze,1658390274,Bolt,4121,4121,-24400,-24400,980,0,0,731503,False,129C-CBKB-329B-C3AE
7R7_akAV5trHi9jf,1658380912,bwtc cafe&roasters,5814,5814,-16500,-16500,980,0,0,755903,False,8E2H-79EE-04C3-7H00
46vBUeG_p61LS5XX,1658332039,–ï–ª–µ–∫—Ç—Ä–æ—Å–∞–º–æ–∫–∞—Ç–∏ Bolt,7999,7999,-1818,-1818,980,0,0,772403,False,6C7H-H72B-ME9K-8C48
zh93debE2LI2zK2Y,1658331652,–ï–ª–µ–∫—Ç—Ä–æ—Å–∞–º–æ–∫–∞—Ç–∏ Bolt,7999,7999,-3041,-3041,980,0,0,774221,False,1028-HC66-M639-KPH3
KgL8vaqgk9W3T9zN,1658331544,bwtc cafe&roasters,5814,5814,-18000,-18000,980,0,0,777262,False,HEK3-TA7H-8354-APEB
Ukin6RRRpWtWAxlx,1658330726,Novapay,8999,8999,-8800,-8800,980,0,0,795262,False,AMT0-6PCT-9T08-1A3E
yjLZyPrGdz5_UhlM,1658330704,Novapay,8999,8999,-13000,-13000,980,0,0,804062,False,00P6-HEK4-M56M-36BH
3fipkDIjJNg6h3ly,1658326857,Harms,5814,5814,-12300,-12300,980,0,0,817062,False,K3HP-4XT2-51P5-1H5A
g4omkgSV6huwPZUe,1658324699,STEYKHAUS,5814,5814,-13000,-13000,980,0,0,829362,False,9HPM-HP9T-718M-T1B6
Lvrp6BTmDZHj2kSV,1658312202,–°—ñ–ª—å–ø–æ,5411,5411,-38698,-38698,980,0,290,842362,False,12CM-0123-6T99-449A
7bga1hp8zLIc2RNT,1658309969,Novapay,8999,8999,-6000,-6000,980,0,0,881060,False,KMEE-2H8A-9A3K-E102
_gH5xRlH4mp10I8q,1658308621,–ï–ª–µ–∫—Ç—Ä–æ—Å–∞–º–æ–∫–∞—Ç–∏ Bolt,7999,7999,-2591,-2591,980,0,0,887060,False,6TC8-X652-9B6C-K3BC
04U0ktgCl37PisvB,1658308546,MasterZoo,5995,5995,-32500,-32500,980,0,1625,889651,False,15CA-EX38-4122-CBC9
-do9gRnBWKDjWZi0,1658303362,Novapay,8999,8999,-6000,-6000,980,0,0,922151,False,T8H0-B6CH-PEHB-25KC
OOxW5TOvvJP1VFCq,1658302417,Portmone,4814,4814,-30000,-30000,980,0,0,928151,False,XKB8-ACA0-AE5H-90TB
5K-Y5eRuwZmmX_iY,1658299948,5045Kavjarnja,5814,5814,-13900,-13900,980,0,0,958151,False,51P7-T4BT-EPH2-HPXB
tSN3sxLWYEEGffMq,1658299534,Novapay,8999,8999,-3500,-3500,980,0,0,972051,False,81XE-6KCX-TKE0-4342
IP-zTHvv-lQiQaNH,1658248178,Mates,5814,5814,-5000,-5000,980,0,0,975551,False,9A1C-H1HT-M537-6BM6
A7ACQlXANUn9DP_P,1658246861,Kafe Right Coffee Bar,5814,5814,-11800,-11800,980,0,0,980551,False,C795-8197-PM92-M1P0
0AQKEqW_3-IitXZV,1658241973,Foxtrot,5722,5732,-103800,-103800,980,0,0,992351,False,CMT0-46H1-864B-KPTB
mUtcU3UyQ4_dHJbz,1658238910,OK Wine,5411,5411,-21900,-21900,980,0,164,1096151,False,E0T3-A8BH-9KMX-7PHT
9KDh0wuCgcVA9TlO,1658238353,–°–∫–∞—Å—É–≤–∞–Ω–Ω—è. Bird,7999,7999,8500,8500,980,0,0,1118051,False
U7WOC74jodENa_yu,1658238349,Bird,7999,7999,-8500,-8500,980,0,0,1109551,False
gYvS-0zQfmwJr-hn,1658238059,–°–∫–∞—Å—É–≤–∞–Ω–Ω—è. Bird,7999,7999,8500,8500,980,0,0,1118051,False
jkkUZJ15gxy-tgaI,1658238055,Bird,7999,7999,-8500,-8500,980,0,0,1109551,False
5_CabT-WqWo3aTld,1658237175,DELiTANT,5814,5814,-8000,-8000,980,0,0,1118051,False,TM44-KM1T-1A56-K483
RutqMWlRSaBAdn8o,1658231795,–ï–ª–µ–∫—Ç—Ä–æ—Å–∞–º–æ–∫–∞—Ç–∏ Bolt,7999,7999,-3167,-3167,980,0,0,1126051,False,05H2-56KH-K591-E2KP
2FqWsX3sMUSsMwek,1658231030,Novapay,8999,8999,-3500,-3500,980,0,0,1129218,False,E43B-E653-33EC-A2TP
Y06UJsE0r7cW53Dd,1658223144,bwtc cafe&roasters,5814,5814,-5000,-5000,980,0,0,1132718,False,E9X4-MT19-EHBA-K005
YMrtPmWJ0iTePpgM,1658222667,–°–∫–∞—Å—É–≤–∞–Ω–Ω—è. Bird,7999,7999,8500,8500,980,0,0,1137718,False
kn88dix8J-epVPkG,1658222663,Bird,7999,7999,-8500,-8500,980,0,0,1129218,False
tfFe3O7DMskLdulM,1658222434,–£–∫—Ä–ø–æ—à—Ç–∞,9402,9402,-8788,-8788,980,0,0,1137718,False,79M8-BAKM-8KTB-TMA9
torC7YBHnnCWy45K,1658222313,Novapay,8999,8999,-40500,-40500,980,0,0,1146506,False,PE7B-970M-0T22-172E
5v3IH-u5-EpRyfo3,1658222274,Novapay,8999,8999,-12000,-12000,980,0,0,1187006,False,CHK0-8MAE-617E-A2HM
elLgFzivS2LamTcn,1658212999,5045Kavjarnja,5814,5814,-7900,-7900,980,0,0,1199006,False,4M93-T439-BXPE-PCMK
mPyagr-BS5RZQDiB,1658171944,–ï–ø—ñ—Ü–µ–Ω—Ç—Ä,5211,5211,-58500,-58500,980,0,0,1206906,False,PH68-E72P-94EM-PCHX
LzpuvPgA97azHR3g,1658171887,–ï–ø—ñ—Ü–µ–Ω—Ç—Ä,5211,5211,-47100,-47100,980,0,0,1265406,False,3X73-233K-43HM-6236
zHGoazwoQzPlgEDl,1658161394,bwtc cafe&roasters,5814,5814,-9000,-9000,980,0,0,1312506,False,BM4A-2HMM-5EAC-5TBM
yyVfa6_Chx_RO2ik,1658156472,Novapay,8999,8999,-5000,-5000,980,0,0,1321506,False,7C5M-3PME-9KXK-3A1B
uqdeQbfknGnbsC6u,1658140611,Novapay,8999,8999,-10000,-10000,980,0,0,1326506,False,H5M4-PXHX-E1CE-C809
CPsFaDvgFO5oBDhL,1658140047,Mates,5814,5814,-17300,-17300,980,0,0,1336506,False,X1E9-5049-96A6-2XM0
YrG4I-S3QOmlsiFE,1658137075,–ï–ª–µ–∫—Ç—Ä–æ—Å–∞–º–æ–∫–∞—Ç–∏ Bolt,7999,7999,-1758,-1758,980,0,0,1353806,False,5BKC-34P3-7BE8-5H9M
KiPEN7IsXvEZjZ2t,1658132299,FDY*Charitable_s,8398,8398,-50000,-50000,980,0,0,1355564,False,B0T4-CXM5-3A4K-E9TK
sIaqi-70cw8KTMFJ,1658130946,Novapay,8999,8999,-5000,-5000,980,0,0,1405564,False,1P34-21C0-CK5B-3HMX
iA3YeK9CvxH2Xfsn,1658126294,bwtc cafe&roasters,5814,5814,-15500,-15500,980,0,0,1410564,False,MHP1-8X7E-KHH3-CB0B
YL2t5COHgDHlmRaI,1658078445,–ö–æ–ª–æ,5411,5499,-21900,-21900,980,0,164,1426064,False,5X33-9861-HEX5-X8B6
8fqWjDQT8g8jVruB,1658077208,Bolt Food,4215,4215,-31000,-31000,980,0,0,1447964,False,T8X0-E3XH-HHX6-61C2
qCsDnREf7M6qAbie,1658069418,Novapay,8999,8999,-8000,-8000,980,0,0,1478964,False,CTM9-6B01-795K-2405
zo_EBU-VtS3-qX5v,1658069392,Novapay,8999,8999,-8000,-8000,980,0,0,1486964,False,EP40-AKHA-XK24-P783
wwLeEl1d58HDgnaJ,1658069292,Novapay,8999,8999,-9700,-9700,980,0,0,1494964,False,60XP-8586-2TT4-AP21
vepcwbm1Oa6e0JEm,1658068753,Novus,5411,5411,-107701,-107701,980,0,807,1504664,False,C3C8-644E-M613-B1H0
DFV4K1LVffhms-_m,1658054269,Mates,5814,5814,-29000,-29000,980,0,0,1612365,False,CP13-3T2A-9C8E-P22P
2kOAQhcWbHBb9pQB,1658041563,Novus,5411,5411,-13900,-13900,980,0,104,1641365,False,H6KH-13XT-24E1-HX6M
83snikkD-h4oOfdp,1658040850,FOP,5814,5814,-18000,-18000,980,0,0,1655265,False,7838-MMK0-KEE5-E6XT
njOzTeAxpLauq2VG,1657976906,–°—ñ–ª—å–ø–æ,5411,5411,-231926,-231926,980,0,1739,1673265,False,PE9E-02AE-H9KK-A7T1
_uZDehJV-ul3t3Il,1657976804,–°—ñ–ª—å–ø–æ,5411,5411,-40900,-40900,980,0,306,1905191,False,99A9-6T4M-CTX5-KPP8
Bx_iqF9NUCHKGtNE,1657975071,Novapay,8999,8999,-8000,-8000,980,0,0,1946091,False,469P-KTXK-9H71-235A
ZgyvEO6bBmUOsT0p,1657974385,Novapay,8999,8999,-3900,-3900,980,0,0,1954091,False,7983-X9XK-MB85-MKMK
LCYAyU51TBj75bRn,1657973007,Kafe Right Coffee Bar,5814,5814,-19600,-19600,980,0,0,1957991,False,CBM7-ABB6-EB2M-10TC
HWHvifxI9id-qMJ8,1657972774,Bolt,4121,4121,-7100,-7100,980,0,0,1977591,False,4C8P-HPMB-0511-8166
uALujYKrEQd_liyk,1657972677,–ê–ø—Ç–µ–∫–∞ –ê–ù–¶,5912,5912,-37600,-37600,980,0,1128,1984691,False,453X-PXPB-H68M-KCHH
EV1tbYJgmCU-OMJp,1657969797,Lesya,4829,4829,-100000,-100000,980,0,0,2022291,True,9T3A-A4EA-BHB5-A8AK
UK8skTKGrHyG0K71,1657969461,bwtc cafe&roasters,5814,5814,-8500,-8500,980,0,0,2122291,False,69EK-3BT3-HC78-3M8X
VLiwO5i7qSirxS_y,1657961704,–°—É–≤–µ–Ω–∏—Ä—ã –ø–æ–¥–∞—Ä–∫–∏ –∏–≥—Ä—É—à–∫–∏ wayforpay,5947,5947,-40000,-40000,980,0,0,2130791,False,3H18-MA86-A2P1-21T5
Z7RHGFrTXAGzpBhp,1657961069,Mates,5814,5814,-67500,-67500,980,0,0,2170791,False,H9H5-X09H-7TP0-4M9K
wFookvYdc6ltxJ6l,1657955026,Pollen Buro,5992,5992,-68500,-68500,980,0,0,2238291,False,TEC3-EK90-H31E-M92C
VtvSiBx2XPseEdm2,1657952992,Lesya,4829,4829,-100000,-100000,980,0,0,2306791,True,PC74-HA6H-AAMH-MC23
u7840b1N-94VAzcc,1657919673,Topolskyi Nazar,6012,6012,83200,83200,980,0,0,2406791,False,Topolskyi Nazar
du3BBlPcS2eS0UE_,1657912343,BIRD UKR* PRELOAD,7999,7999,-10000,-10000,980,0,0,2323591,False,BE47-73M6-XKKE-9331
ySinv0Wk9r5ZHfq-,1657910446,–í—ñ–¥: –í–ª–∞–¥–∏—Å–ª–∞–≤ –ß–æ—Ä–Ω–∏–π,–ü–∏–≤–∞—Å üçª,4829,4829,34500,34500,980,0,0,2333591,True
ZCFmGaKM4nLF9x1q,1657910039,Varvar Bar,5812,5812,-184600,-184600,980,0,0,2299091,False,0TTM-EE00-727K-3144
2H38GEq-ED6znrqH,1657903496,Pethouse,5995,5995,-49100,-49100,980,0,0,2483691,False,XKTC-9K47-CTP1-PA0P
J5pXNjRvvEiVf5LO,1657902145,–ï–ª–µ–∫—Ç—Ä–æ—Å–∞–º–æ–∫–∞—Ç–∏ Bolt,7999,7999,-3683,-3683,980,0,0,2532791,False,07TA-H3X7-232H-7B5K
E-dHZoKVpEsFEt-W,1657900695,–ï–ª–µ–∫—Ç—Ä–æ—Å–∞–º–æ–∫–∞—Ç–∏ Bolt,7999,7999,-1692,-1692,980,0,0,2536474,False,6A60-204A-140K-HAB0
7e9khXrPpNRuZfgI,1657899541,bwtc cafe&roasters,5814,5814,-24500,-24500,980,0,0,2538166,False,83TK-EXCP-K6E5-1K5M
raQzyqaKWS1Ce2l5,1657875197,Novapay,8999,8999,-10500,-10500,980,0,0,2562666,False,T194-07EB-K0TC-564M
eH1sVD5i-PiHcp21,1657867091,Kafe La Fabrique,5814,5814,-15000,-15000,980,0,0,2573166,False,AX4A-EHT1-B1HT-X7E0
LMJw-VVwHlP4tawR,1657866800,bwtc cafe&roasters,5814,5814,-10000,-10000,980,0,0,2588166,False,2518-XC11-4888-3EH2
skNdEg_JaO_kVDij,1657813103,bwtc cafe&roasters,5814,5814,-3500,-3500,980,0,0,2598166,False,A2K8-02HP-XHK9-2KKK
Q4oqaU35_r7HULGY,1657809943,–ö–æ–ª–æ,5411,5499,-10350,-10350,980,0,103,2601666,False,H4E1-60A8-B5KA-HTHT
W9LIW7dImc-GqnCN,1657808025,–ö–æ–ª–æ,5411,5499,-49050,-49050,980,0,490,2612016,False,35M4-AMHT-M31K-0104
EIVr2-AO2_gqNxoW,1657807798,–ï–∫–æ-–õ–∞–≤–∫–∞,5411,5499,-114700,-114700,980,0,1147,2661066,False,15M1-4TC1-5TE7-50X1
ck08EEbX7ulDzh8Z,1657804095,–ü–æ–ø–æ–≤–Ω–µ–Ω–Ω—è ¬´–ù–∞ –º–∞—à–∏–Ω—É –¥–ª—è –¢—Ä–û –ñ—Ç¬ª,üöó,4829,4829,-100000,-100000,980,0,0,2775766,True,CE51-C1BT-42XE-M942
FmpDG9AGfYvjCf9y,1657797338,MagazinProdukti,5499,5499,-25800,-25800,980,0,258,2875766,False,79X8-EA9H-91C2-21E4
opEHbNxud3qozb0h,1657796594,Fotovramke,5946,5946,-35000,-35000,980,0,0,2901566,False,7B44-9MTP-4X36-0X71
-MBTnB2LZIEms1Ly,1657796222,Frankly,5814,5814,-26500,-26500,980,0,0,2936566,False,6241-303P-HCC3-B329
tePvt91oYrnQUkQl,1657792795,–ï–ª–µ–∫—Ç—Ä–æ—Å–∞–º–æ–∫–∞—Ç–∏ Bolt,7999,7999,-1840,-1840,980,0,0,2963066,False,X0XA-3C9A-67K0-EHMT
mE2NotMabN6eszsC,1657792037,Novus,5411,5411,-72600,-72600,980,0,726,2964906,False,XMP6-TXK9-886A-M6E2
tuGl7muXpJ-ZjO8J,1657779689,bwtc cafe&roasters,5814,5814,-20000,-20000,980,0,0,3037506,False,9287-P3PX-1AT5-B43T
XCiE1jC93LItwdUh,1657736292,EasyPay,4814,4814,-500,-500,980,0,0,3057506,False,15C5-2KKP-37KX-5A52
IZ78BwTSRFzY5crD,1657735119,Novapay,8999,8999,-10000,-10000,980,0,0,3058006,False,BAT3-83X1-9M41-MPXK
QZ1GeILumZ8CBRQ8,1657718800,Lesya,4829,4829,-700000,-700000,980,0,0,3068006,True,00CC-18BE-0MK2-0XBT
aTe4foyDMyGcYf0l,1657718423,–íi–¥: –ü–†–ò–•–û–î–¨–ö–û –ï.–í. –§–û–ü,4829,4829,2500000,2500000,980,0,0,3768006,True
JP6yDvceRUS9KmpL,1657707807,Bolt,4121,4121,-6200,-6200,980,0,0,1268006,False,188B-0K2P-KBM7-A9X0
l9qYwFy4faSROg_N,1657706913,magazin 7023,5411,5411,-28696,-28696,980,0,215,1274206,False,0567-PX5X-CEET-3AEX
uEtU75SzIMICfaeB,1657697385,Bolt,4121,4121,-8200,-8200,980,0,0,1302902,False,30H0-6P66-7431-41A9
4qvZ5Hs1oouE6Vhq,1657696967,–ö–æ–ª–æ,5411,5499,-14600,-14600,980,0,109,1311102,False,73X7-135T-X4XT-1EAH
_cdqehS3Kj9RT829,1657693828,bwtc cafe&roasters,5814,5814,-5000,-5000,980,0,0,1325702,False,968M-H6A7-M55K-80KP
hAMRSz23ZvLXveHU,1657693670,Kafe La Fabrique,5814,5814,-10000,-10000,980,0,0,1330702,False,X4PC-17XH-9A47-42M9
ax2IP7ube5h_PC2eRql5,1657664580,OKKO,5541,5541,-110770,-110770,980,0,0,1340702,True
938jUmMSv5bYd4WJNhJ1SVKGSg,1657664580,–°–∫–∞—Å—É–≤–∞–Ω–Ω—è. OKKO,5541,5541,97958,97958,980,0,0,1451472,False
29vrrSTLMmDjiy2DO4CnWg,1657664580,–°–∫–∞—Å—É–≤–∞–Ω–Ω—è. OKKO,5541,5541,12812,12812,980,0,0,1353514,False
2iA7MPwIxh8p8CsM,1657638521,Novapay,8999,8999,-6000,-6000,980,0,0,1340702,False,543K-M77C-MP26-5H93
Ho2P84nbjs7hcfEu,1657637839,Novapay,8999,8999,-6000,-6000,980,0,0,1346702,False,941E-XMH7-PMHP-2MAB
HntHCRUemJSL9dy5,1657633930,magazin 762597,5912,5912,-39720,-39720,980,0,0,1352702,False,X3X2-4K1C-A5X8-H5CP
1GqEJAJGO_QvyPq0,1657611113,WFP.AQUAMARKET,5411,5411,-61420,-61420,980,0,460,1392422,False,20E9-C821-H3MP-6475
HzG15aTNWMRcBV9D,1657607220,bwtc cafe&roasters,5814,5814,-9000,-9000,980,0,0,1453842,False,B93K-HM0M-M08C-9BT3
WMkx-QstxOTDUjzE,1657557456,Ponchyk Boy,5812,5812,-11601,-11601,980,0,0,1462842,True,K94A-2AK9-18X8-4CC9
iciZWdTq-YvsP1Rw,1657552593,bwtc cafe&roasters,5814,5814,-5000,-5000,980,0,0,1474443,False,2X7P-B35T-77HH-A1B7
BpDRTZmJ4UpP_yPn,1657552255,Novapay,8999,8999,-8500,-8500,980,0,0,1479443,False,3TTH-1XAM-HMM1-A82P
8vESg0w_XBdDcyZy,1657539611,Novapay,8999,8999,-3500,-3500,980,0,0,1487943,False,C426-7PH2-B317-H99A
hmZgE4aIrJd-Y8PV,1657537214,Bolt,4121,4121,-8300,-8300,980,0,0,1491443,False,920B-4P5P-A2H5-KA67
RKsuBpDUSzG7_3bn,1657532118,Bolt,4121,4121,-9100,-9100,980,0,0,1499743,False,0TKP-0K1P-736A-K1M4
eh9lIYV959H6owqS,1657529009,bwtc cafe&roasters,5814,5814,-5000,-5000,980,0,0,1508843,False,2T8X-1XCH-8B90-KPC6
0ERC_E9riCNO3Ows,1657527965,bwtc cafe&roasters,5814,5814,-5000,-5000,980,0,0,1513843,False,KPMX-874K-X3M4-HX14
hiKYZKgs1bkzmrXq,1657527788,SalonkrasotiHighFive,7230,7230,-45000,-45000,980,0,0,1518843,False,25TM-6215-57TE-5PX4
qK0j2GcmzXF2oCn7,1657459023,Novapay,8999,8999,-6000,-6000,980,0,0,1563843,False,ECX7-M88A-28XK-P1XM
GfIJyADQ3kqzCwvb,1657450775,–°–∫–∞—Å—É–≤–∞–Ω–Ω—è. OKKO,5541,5541,12812,12812,980,0,0,1569843,False
Z67YNbsyTdQJNhBC,1657450523,OKKO,5541,5541,-110770,-110770,980,0,0,1557031,False
UdcwyrAXEpqVtEUC,1657446514,–ö–æ–ª–æ,5411,5499,-10150,-10150,980,0,76,1667801,False,MX38-KH13-T6TP-98KT
Y90crzWPiEGCx__r,1657440526,zoolux,742,742,-59000,-59000,980,0,0,1677951,False,PXHM-CKE1-8HXX-E5HT
fBkKaGc5tHhIrsMi,1657439317,Bird,7999,7999,-10000,-10000,980,0,0,1736951,False,63E4-57AB-T903-3T4B
zfQLyoMz6tiEaZ30,1657438613,–°–∫–∞—Å—É–≤–∞–Ω–Ω—è. Bird,7999,7999,8500,8500,980,0,0,1746951,False
kCUjrkHqTzu_nqkZ,1657438608,Bird,7999,7999,-8500,-8500,980,0,0,1738451,False
PM5ZL7kVBd9T0433,1657435754,–ï–ª–µ–∫—Ç—Ä–æ—Å–∞–º–æ–∫–∞—Ç–∏ Bolt,7999,7999,-4933,-4933,980,0,0,1746951,False,TKM9-E63A-1CA0-PTM8
PCDfdtdWeuRYiUFj,1657435428,–í–ö –ï–∫—Å–ø—Ä–µ—Å,5411,5411,-50100,-50100,980,0,375,1751884,False,B486-6HE2-A0MC-B9AE
1db-201XlSBy32i7,1657394806,WFP.CONSULT1,7277,7277,-15000,-15000,980,0,0,1801984,False,X72M-P7M1-T3B9-MPTM
csvBt3r-vtDKgssY,1657381930,–ï–ª–µ–∫—Ç—Ä–æ—Å–∞–º–æ–∫–∞—Ç–∏ Bolt,7999,7999,-2083,-2083,980,0,0,1816984,False,MEBT-4C3H-EHKP-611K
40nAAK8ksRBrigzF,1657381930,–ï–ª–µ–∫—Ç—Ä–æ—Å–∞–º–æ–∫–∞—Ç–∏ Bolt,7999,7999,-2058,-2058,980,0,0,1819067,False,X51B-C5EX-4H9T-02XM
WLWQTJlaJtjEP1V-,1657379643,Kafe La Fabrique,5814,5814,-4500,-4500,980,0,0,1821125,False,A9M6-P229-95HK-6840
hJwtD9g37kffD_zj,1657375760,–°—ñ–ª—å–ø–æ,5411,5411,-56176,-56176,980,0,421,1825625,False,XK00-390H-M66A-EEK8
lKbt2GSuMaPqffsF,1657375500,Novapay,8999,8999,-5300,-5300,980,0,0,1881801,False,P013-MH1X-0H15-0AM6
S2tiH6ovfNT7dUz3,1657374740,–ï–ª–µ–∫—Ç—Ä–æ—Å–∞–º–æ–∫–∞—Ç–∏ Bolt,7999,7999,-1679,-1679,980,0,0,1887101,False,E7HA-EA1B-3287-1ACM
yBJ5E7-W66B3c43Y,1657368011,ZOOLYUKS,5995,5995,-41400,-41400,980,0,0,1888780,False,X62A-694M-HBM8-B702
K6jOrE4Sr51mmkl1,1657367815,ZOOLYUKS,742,742,-61000,-61000,980,0,0,1930180,False,2HK0-P7KH-1679-P1HT
DzBXfrpJ08mPOVMI,1657367793,ZOOLYUKS,742,742,-61000,-61000,980,0,0,1991180,False,EMX5-PAK6-2MT3-P0E4
fXXOhcKSPG3fL_LZ,1657365221,Novapay,8999,8999,-3000,-3000,980,0,0,2052180,False,4EXA-0BXX-TA1T-B3T8
CB09Lr1_TKL2OF9i,1657360735,Mates,5814,5814,-87500,-87500,980,0,0,2055180,False,X119-MBHK-5H49-1E0T
TTUJ8SM-Cyfo4eO_,1657355238,–Ü—Ä–∏–Ω–∞ –§.,4829,4829,-100000,-100000,980,0,0,2142680,True,PAKT-768M-T6KH-A346
AjWZAsI3fIm58pdA,1657310892,Lesya,4829,4829,-1900,-1900,980,0,0,2242680,True,888P-T9PK-5T04-P1X8
o6WvvFACdzuGnye0,1657299359,Novapay,8999,8999,-5000,-5000,980,0,0,2244580,False,K3TP-264A-5475-XH39
_ODfwRxMSeAMb5Wd,1657299328,Novapay,8999,8999,-12800,-12800,980,0,0,2249580,False,M0X5-9EM3-ECC2-C784
ho8sPr6Su-N4l8Az,1657295048,OK Wine,5411,5411,-30700,-30700,980,0,307,2262380,False,367A-46HA-HK4C-A3XX
QkbdF6nNhPPMvIvS,1657294845,Konteyner,5814,5814,-52000,-52000,980,0,0,2293080,False,87PH-8X21-13K3-A21E
vVg0jwdxWoyZXu5b,1657289852,–ù–æ–≤–∞ –ø–æ—à—Ç–∞,4214,4214,-3000,-3000,980,0,0,2345080,False,EBCM-326M-58BM-5KT8
2Jmj4oLAnUgVR2To,1657289831,–ù–æ–≤–∞ –ø–æ—à—Ç–∞,4214,4214,-29700,-29700,980,0,0,2348080,False,C31K-EE5B-23H2-TCM2
2hs6yaQX04OgOwvk,1657286438,bwtc cafe&roasters,5814,5814,-15600,-15600,980,0,0,2377780,False,EEE9-93PX-P64K-A01X
RL_pYBw5valdU0Ux,1657282397,,5812,5812,-38500,-38500,980,0,0,2393380,True,1X63-HH15-K41E-P6KC
1ySxLHHdyGV7smnS,1657271361,Lesya,4829,4829,-300000,-300000,980,0,0,2431880,True,A4A1-38CC-0X2H-C959
nMdIhbtOb6C8_mZ8,1657270964,Novapay,8999,8999,-12300,-12300,980,0,0,2731880,False,P17H-5HBK-TB6H-5T9K
kL4wV4DeeItXA2mV,1657268778,–°–≤—ñ—Ç –ö–∞–≤–∏,5814,5814,-6500,-6500,980,0,0,2744180,False,CACT-XX78-PPC4-PM78
wIP75u0-RCHQI1l7,1657265397,Best Way To Cup Coffee Company,5814,5814,-10000,-10000,980,0,0,2750680,False,XTBH-99P4-MT73-594X
sOJ3QCTrAwspQxAd,1657265189,Bolt,4121,4121,-7900,-7900,980,0,0,2760680,False,HTC0-EBMM-946B-X611
r50i6w-ddzELTqjX,1657225203,FDY*Clothing_SSL,5691,5691,-69600,-69600,980,0,0,2768580,False,5098-XT5B-82C8-TM70
mqWl83x2irZrkapH,1657205879,–ï–ª–µ–∫—Ç—Ä–æ—Å–∞–º–æ–∫–∞—Ç–∏ Bolt,7999,7999,-2949,-2949,980,0,0,2838180,False,EH59-6MH0-C556-E9X9
nLtOM308BQC8cOXS,1657198304,Novapay,8999,8999,-5000,-5000,980,0,0,2841129,False,B625-455P-02HH-02EC
qaiJSS9CwA7aJwOg,1657187063,–ï–ª–µ–∫—Ç—Ä–æ—Å–∞–º–æ–∫–∞—Ç–∏ Bolt,7999,7999,-2471,-2471,980,0,0,2846129,False,XB17-7867-AX8T-PT45
yOZBz0EDKrjQaa7R,1657186888,–ê–ø—Ç–µ–∫–∞ –ê–ù–¶,5912,5912,-28080,-28080,980,0,842,2848600,False,MB49-B412-HM99-58MP
IHfLSnZ9gN4JGcMC,1657186646,–°—ñ–ª—å–ø–æ,5411,5411,-300,-300,980,0,3,2876680,False,8B24-P13K-CM96-CM12
W3tZF7AipBPBcsDk,1657186601,–°—ñ–ª—å–ø–æ,5411,5411,-82047,-82047,980,0,820,2876980,False,23H9-850K-A4A9-365A
gFKCiiyCspTAd1sD,1657186339,–ö–æ–ª–æ,5411,5499,-29200,-29200,980,0,292,2959027,False,TPA3-P943-6C0B-E9T4
qX7fp5qY4BYhmSyg,1657184075,ITIS CAFE,5814,5814,-46100,-46100,980,0,0,2988227,False,T212-TE6A-0TMC-HK24
CBoyEnZnkA7YkjtS,1657183491,ElitZOO,5995,5995,-11900,-11900,980,0,0,3034327,False,60M3-8A5M-3195-K31P
yC7x0dW-hchXJ-P6,1657182766,Lesya,4829,4829,-100000,-100000,980,0,0,3046227,True,466T-E6T0-CBA5-P339
78s3eu168eXfzr-5,1657180162,–íi–¥: –ü–†–ò–•–û–î–¨–ö–û –ï.–í. –§–û–ü,4829,4829,1800000,1800000,980,0,0,3146227,True
foeDqPxgUX5OHbmD,1657178110,–ï–ª–µ–∫—Ç—Ä–æ—Å–∞–º–æ–∫–∞—Ç–∏ Bolt,7999,7999,-2518,-2518,980,0,0,1346227,False,TT5H-667K-6X64-9PP8
41a8KXf7OixTTqA2,1657175037,bwtc cafe&roasters,5814,5814,-10000,-10000,980,0,0,1348745,False,XPX5-BKA9-K9BT-ATPK
FJOEhK_bq7ZjhcUN,1657127646,My F*cking Gym,7941,7941,-245000,-245000,980,0,0,1358745,False,9EEM-2P5E-E63M-E067
xjjEJ6vrOn0SQOCU,1657116431,Novapay,8999,8999,-5000,-5000,980,0,0,1603745,False,HBA3-8A7B-X0HT-HBH2
mqhKmJUbTAG27uDa,1657114453,Novapay,8999,8999,-12500,-12500,980,0,0,1608745,False,H822-0KHK-K6CE-4B4P
Q0HP5TdKHbNHGJem,1657114411,Novapay,8999,8999,-10500,-10500,980,0,0,1621245,False,KBEB-T3M6-BEM9-0TC8
HpBSNHHrKsp0HMW0,1657114383,Novapay,8999,8999,-12500,-12500,980,0,0,1631745,False,60HX-H390-4AHM-49KT
zmn11LJnRNUAZYS7,1657104422,"Lifecell
+380631692598",4814,4814,-16000,-16000,980,0,0,1644245,True,KB23-HMM6-1EP9-A24X
MRi-9zFY8_UWSgYv,1657099681,Etsy,5699,5699,-12665,-360,840,0,0,1660245,False,18E8-8E2T-62C6-EXXB
roZcRNsQ-AYE7Wi_,1657095573,Ponchyk Boy,5812,5812,-18201,-18201,980,0,0,1672910,True,APKP-B31K-C16M-6688
JavsVIe3sjp1O2rU,1657095176,EasyPay,4814,4814,-11200,-11200,980,0,0,1691111,False,13B6-27ET-106A-8HXA
93d8MTbJheM-6DnO,1657094608,TURKANAGONChARA,5814,5814,-16400,-16400,980,0,0,1702311,False,1EA0-KH4C-K428-85M9
ArzgrS8umylbL1A9,1657088344,bwtc cafe&roasters,5814,5814,-7000,-7000,980,0,0,1718711,False,CABE-K59A-CB5C-1B7P
wIYkl4ZgTliLK61g,1657056874,FDY*Shops_SSL,5631,5631,-360000,-360000,980,0,0,1725711,False,C68C-M07X-6033-HPP3
6elYNUTdSJwCUJkS,1657043826,Bolt,4121,4121,-13600,-13600,980,0,0,2085711,False,504A-BA4E-28HK-X249
5FSZI6et-QHjnpCG,1657034791,Bolt Food,4215,4215,-56500,-56500,980,0,0,2099311,False,M7KX-XK9C-004X-345E
jxIdT2Lanh2C39eh,1657030628,Novapay,8999,8999,-5000,-5000,980,0,0,2155811,False,0C43-C819-513X-M2T1
M3eyZFs-edFETqKe,1657023102,OK Wine,5411,5411,-100910,-100910,980,0,1009,2160811,False,EAP0-T1TH-5PX5-H65C
u4L7D4kY261WFZdu,1657016884,Bolt,4121,4121,-6400,-6400,980,0,0,2261721,False,174P-A0X2-84M7-9T47
vFMRA8nOGYAAVdwV,1657016185,Ponchyk Boy,5812,5812,-43501,-43501,980,0,0,2268121,True,T25K-0MC9-727E-05E3
i96zriMBDgBst74U,1657002048,–ö–æ–ª–æ,5411,5499,-23800,-23800,980,0,238,2311622,False,BB45-M6CX-XCBT-CC64
30qRjVFMVcq_qvg5,1656968482,–ü–æ–ø–æ–≤–Ω–µ–Ω–Ω—è ¬´—Ç–∏–∂–¥–µ–Ω—å#3¬ª,üëçü§óüèÉ,4829,4829,-1503,-1503,980,0,0,2335422,True,2P25-BEB1-KB9M-KCC5
kgY-AIwzyExywIng,1656954431,Novapay,8999,8999,-12000,-12000,980,0,0,2336925,False,AE6E-9ACT-E6CK-A8XX
Lz3dijZaqxAckniZ,1656954378,Novapay,8999,8999,-12500,-12500,980,0,0,2348925,False,7X9P-MAHH-31P2-K3B5
qE67q7zuU1hxexn2,1656954316,Novapay,8999,8999,-10500,-10500,980,0,0,2361425,False,AP68-X8E0-P889-XX8E
AACGHC8HMQgz1uaZ,1656954257,Novapay,8999,8999,-8000,-8000,980,0,0,2371925,False,HK76-1565-3X58-HK8A
JTU8E_CLJEl0XxfI,1656954150,Novapay,8999,8999,-14000,-14000,980,0,0,2379925,False,90A4-MXH4-0X35-P23M
NiACheljUVsc6bcZ,1656944430,Bolt,4121,4121,-7300,-7300,980,0,0,2393925,False,CK9E-4342-148A-6641
8VtggNZPD-uJcGtR,1656939924,–ï–ª–µ–∫—Ç—Ä–æ—Å–∞–º–æ–∫–∞—Ç–∏ Bolt,7999,7999,-6214,-6214,980,0,0,2401225,False,EE10-9635-8XX2-B4XX
ZGyOHVZeIskB_TYk,1656939347,KANTsTOVARi PENSILVANI,5943,5943,-156200,-156200,980,0,0,2407439,False,3H7M-A561-HB5E-BCE1
25luaSsCyPtUkDtm,1656938121,EVA,5977,5977,-6897,-6897,980,0,0,2563639,False,P55B-A648-0BA7-4MPX
DMO9Zzy284wtz0Vz,1656928796,LIQPAY*Keep Style,5651,5651,-54900,-54900,980,0,0,2570536,False,3324-H5X5-P5MX-2052
McB60Dr8ussXoPXT,1656921496,414943****8043,4829,4829,-100000,-100000,980,0,0,2625436,True,XAPX-M01H-0X75-1EA3
_bV4sJVRurSzPXK5,1656915806,bwtc cafe&roasters,5814,5814,-10000,-10000,980,0,0,2725436,False,18P1-0M54-2M81-PAA5
-sGbFjpU4pnmktI4,1656886610,Pethouse,5995,5995,-62500,-62500,980,0,0,2735436,False,807E-1197-M3E2-CBA9
rRpjvMxPkdh8AomI,1656878075,–ü–æ–ø–æ–≤–Ω–µ–Ω–Ω—è ¬´—Ç–∏–∂–¥–µ–Ω—å#2¬ª,üèÉ,4829,4829,-3140,-3140,980,0,0,2797936,True,C6AX-A96T-M3K6-C3E9
SaZqcwKPlS_06uT0,1656869178,bwtc cafe&roasters,5814,5814,-21500,-21500,980,0,0,2801076,False,952X-P4K6-T3E8-4M2T
ZzUWQ2RjYKGUrjK2,1656865713,DelviMag146,5499,5499,-15000,-15000,980,0,150,2822576,False,8PXB-K3K0-T3MX-1B5E
W2_fWjhQcHc_PFD5,1656865024,KapheMates,5814,5814,-9000,-9000,980,0,0,2837576,False,5064-MAB3-XH06-3X25
JHlxBijwP7FYYtpf,1656865011,Mates,5814,5814,-69700,-69700,980,0,0,2846576,False,07P2-2A3E-6PTE-2CM2
nHTxiam8c8y2MgfY,1656861810,–ï–ª–µ–∫—Ç—Ä–æ—Å–∞–º–æ–∫–∞—Ç–∏ Bolt,7999,7999,-2050,-2050,980,0,0,2916276,False,BK5X-XC89-XMMP-C6TC
WMjvu6vd34OcLxqX,1656833060,5045Kavjarnja,5814,5814,-4000,-4000,980,0,0,2918326,False,B617-6453-X7P8-CTX3
MvTwRmis1FI-qaIg,1656770437,–°—ñ–ª—å–ø–æ,5411,5411,-10700,-10700,980,0,107,2922326,False,1901-6HC3-HPAA-7H9H
EGDyqVj0F09L_GNw,1656770408,–°—ñ–ª—å–ø–æ,5411,5411,-132636,-132636,980,0,1326,2933026,False,K6TC-5794-T153-03T9
XOfuLk8KEtMZGHnS,1656762861,–ö–æ–ª–æ,5411,5499,-13050,-13050,980,0,130,3065662,False,59MP-27HA-P6EB-X6B8
tuWNBDqWD76MEAho,1656691413,–ê–ø—Ç–µ–∫–∞ –ê–ù–¶,5912,5912,-16180,-16180,980,0,0,3078712,False,P9A8-6KB1-6M33-K131
AIepMoOBtnRfzZFB,1656691255,–ö–æ–ª–æ,5411,5499,-21900,-21900,980,0,0,3094892,False,4PMK-91X4-M6K2-978K
8_vCzHu-gNxr6bDR,1656673096,–°–∫–∞—Å—É–≤–∞–Ω–Ω—è. Bird,7999,7999,8500,8500,980,0,0,3116792,False
DipMPbae8gjM9KsG,1656673093,Bird,7999,7999,-8500,-8500,980,0,0,3108292,False
XQquKeqZoVp0feah,1656666962,DigitalOcean,5734,5734,-39240,-1200,840,0,0,3116792,False,TPP1-2B3P-2988-4E0B
81W9ssJEbi7XDJpo,1656665787,PureNaive,5814,5814,-31500,-31500,980,0,0,3156032,False,08EB-98H5-32H4-P7M8
eTxXbI7RqQDz7cLr,1656657707,bwtc cafe&roasters,5814,5814,-5000,-5000,980,0,0,3187532,False,622P-5735-040X-78T6
bso9rZldIkDqNgVc,1661876460,OK Wine,5411,5411,-11300,-11300,980,0,0,775311,False,769M-1A36-CAAE-7C3P
57RCqn5L9wFTBhuo,1661874271,5045Kavjarnja,5814,5814,-15400,-15400,980,0,0,786611,False,96AK-AATB-K4KP-T422
yvdKbEQr25aC3D8d,1661872979,answear.ua,5651,5651,-131061,-127800,980,0,0,802011,False,5B03-KX89-XT74-4BET
i9VtN-I6i8YvruMO,1661860734,–ü–∏—Ä—ñ–∂–∫–æ–≤–∞ ¬´–¢—ñ—Ç–∫–∞ –ö–ª–∞—Ä–∞¬ª,5814,5814,-38600,-38600,980,0,0,933072,False,333E-3EAA-0TE2-HP9P
4LH0xU9jvKn3czqN,1661858261,Yaroslaviv Val 37-1,5499,5499,-3000,-3000,980,0,0,971672,False,TK9H-4PA2-HXMB-KXB1
4-gWFSFRj-5UETP5,1661856178,–ö–∏—ó–≤—Å—å–∫–µ –º–µ—Ç—Ä–æ,4111,4111,-800,-800,980,0,0,974672,False,PC4X-KB51-EB87-EP4B
d4mbyt346xsxGnlx,1661847939,Bolt,4121,4121,-19600,-19600,980,0,0,975472,False,62K1-TK86-9978-5HCH
nzFTOknTarkdVqN2,1661843206,–ö–æ–ª–æ,5411,5499,-21900,-21900,980,0,0,995072,False,H611-7565-939H-81MB
AdzJchvODs5wHh5O,1661840982,Bwtc cafe&roasters,5814,5814,-25000,-25000,980,0,0,1016972,False,T947-KC9C-XTX8-6CC4
o5qXl9li2laXF-f-,1661840911,–ï–ª–µ–∫—Ç—Ä–æ—Å–∞–º–æ–∫–∞—Ç–∏ Bolt,7999,7999,-1700,-1700,980,0,0,1041972,False,853C-A7PX-B7TH-H883
e1P-C9KbGM-8Lucd,1661840520,Novapay,6538,6538,-112919,-112919,980,3819,0,1043672,False,97B9-AT6A-TB0X-EAMC
hNh4V2GzDJYln8pB,1661840214,Novapay,8999,8999,-5500,-5500,980,0,0,1156591,False,K625-8C97-167C-6KCM
6cpoJG3v4ixKgnNl,1661836886,KapheDragomanovfood,5814,5814,-3000,-3000,980,0,0,1162091,False,X366-4C8P-XCX3-CT05
4Mzh9dKOKZ6z7nJH,1661792285,Kitaika,5814,5814,-48300,-48300,980,0,0,1165091,False,7077-99BP-9KKK-9C51
afz-8usA3uGjjk-k,1661792120,Konteyner,5814,5814,-15000,-15000,980,0,0,1213391,False,CT08-K4EB-9T5K-16T9
BhZJM_Cdy32JKeMG,1661787493,–°–∫–∞—Å—É–≤–∞–Ω–Ω—è. Bird,7999,7999,8500,8500,980,0,0,1228391,False
k-TGs4EmXMtEDK2n,1661787489,Bird,7999,7999,-8500,-8500,980,0,0,1219891,False
KU5zoym-7mENG6UL,1661787396,SALON KRASY BACKSTAGE,7230,7230,-290000,-290000,980,0,0,1228391,False,C862-C1K7-94KM-PKEK
04AouyTbLHk_cExY,1661787117,Bolt,4121,4121,-8500,-8500,980,0,0,1518391,False,9P23-7XH4-54MX-CP7M
IcFUK5jmj7aY8yEX,1661769430,Bird,7999,7999,-30000,-30000,980,0,0,1526891,False,T950-7BA0-6TC3-28CP
IbmSzUmFActbpR7b,1661769026,Dubler,5814,5814,-45000,-45000,980,0,0,1556891,False,2MHC-121E-0EHB-5196
m_WO_4g71VVkYcWy,1661765451,–°–∫–∞—Å—É–≤–∞–Ω–Ω—è. Bird,7999,7999,8500,8500,980,0,0,1601891,False
ORUAASUuTY1cEr_J,1661765448,Bird,7999,7999,-8500,-8500,980,0,0,1593391,False
OmNXKxstwmCMWF_7,1661759250,WFP.AQUAMARKET,5411,5411,-53980,-53980,980,0,0,1601891,False,30XH-TP12-EHAT-3B51
P4jtbNH-KP5gPzjD,1661755637,Bolt,4121,4121,-10100,-10100,980,0,0,1655871,False,K8XT-A589-TXAP-7M80
ebKCczYlcbrR-hSE,1661753492,–û–±—Å–ª—É–≥–æ–≤—É–≤–∞–Ω–Ω—è –ø–ª–∞—Ç–∏–Ω–æ–≤–æ—ó –∫–∞—Ä—Ç–∫–∏,4829,4829,-30000,-30000,980,0,0,1665971,True
c5EPH148U7nC8Qes,1661712891,Uklon,4121,4121,-8800,-8800,980,0,0,1695971,False,MKX7-8415-8X3M-EC9A
_36x7V3G7cGXTQn7,1661709620,Bolt,4121,4121,-16800,-16800,980,0,0,1704771,False,PCBH-MKEC-HH9H-KK43
Co93OQqR4UpwP26o,1661701298,FDY*FOOD,5499,5499,-46200,-46200,980,0,0,1721571,False,ATTC-C1A9-79C2-T7XK
xbEAM_FXF83q56k5,1661680521,Korovai,5462,5462,-9350,-9350,980,0,0,1767771,False,A423-A93B-X67H-TH74
g0pliwW842UFktgJ,1661680187,–ê–ø—Ç–µ–∫–∞ –ö–æ–ø–µ–π–∫–∞,5912,5912,-1500,-1500,980,0,0,1777121,False,MAA7-637T-M030-041T
SpEA6TYRSMdjBLOk,1661679904,Pochatok,5814,5814,-8500,-8500,980,0,0,1778621,False,2H60-857X-31KM-91E0
2v8yDtAQRP0Sh7kg,1661677255,Kavun,5814,5814,-16000,-16000,980,0,0,1787121,False,P0KT-06B6-B1AT-5M53
pWOf9S7MnZlXHqGW,1661674196,APTEKA 299,5912,5912,-8334,-8334,980,0,0,1803121,False,0X32-9CA6-TME7-36HH
R9JTDZ4fi4R7aBF8,1661613477,–û–±–∂–æ—Ä–∞,5411,5499,-8600,-8600,980,0,0,1811455,False,502X-PBXM-3PCP-P8XB
TJN2SdVuMkd3_6sN,1661604436,–ö—É–ø—ñ–≤–ª—è –æ–¥—è–≥—É wayforpay,5651,5651,-90000,-90000,980,0,0,1820055,False,P7TX-M1T5-T975-140P
p7-OtLOW3ghKlVez,1661599377,Kavun,5814,5814,-4500,-4500,980,0,0,1910055,False,EXP6-2EXE-6C69-4PP9
pHC7NtFWtX_lbeQ-,1661598518,Kavun,5814,5814,-21500,-21500,980,0,0,1914555,False,5X8T-7377-M7M0-X44A
eoDyQL3VAUwdpl_9,1661597759,G COFFEE,5814,5814,-7400,-7400,980,0,0,1936055,False,6H25-AP7P-0807-15BH
VMy9sB72FI23Rc1c,1661581434,Kavun,5814,5814,-11000,-11000,980,0,0,1943455,False,7BKA-6XPM-8KE6-5214
ylfExZFL9Zqe79hh,1661580880,Kavun,5814,5814,-21500,-21500,980,0,0,1954455,False,BX64-6E6X-K5B3-5CPT
iYjOy121RmpiSr3X,1661580426,"Vodafone
+380978495150",4814,4814,-14500,-14500,980,0,0,1975955,True,5984-287K-MA70-MC72
WUXq5geAHYlD5_YV,1661529451,Novapay,8999,8999,-6000,-6000,980,0,0,1990455,False,603T-X80X-4P7T-0K38
syFlRsdza6BWDHZo,1661528272,–°–∫–∞—Å—É–≤–∞–Ω–Ω—è. WOGPAY_G,5541,5541,53499,53499,980,0,0,1996455,False
UPEz1QiP4Hx4chXf,1661528172,WOGPAY_G,5541,5541,-239700,-239700,980,0,0,1942956,False
18Pd4hKmfvGxy8XH,1661521052,RestoranHuterec,5814,5814,-2000,-2000,980,0,0,2182656,False,C9M6-K28B-CP1K-E2AB
4WzSNPlmMr8sebcj,1661507912,–ü–∏—Ä—ñ–∂–∫–æ–≤–∞ ¬´–¢—ñ—Ç–∫–∞ –ö–ª–∞—Ä–∞¬ª,5814,5814,-17900,-17900,980,0,0,2184656,False,2HPB-8B59-PA0B-EKTT
0ed22p3l8cY_dagS,1661504042,Bird,7999,7999,-10000,-10000,980,0,0,2202556,False,CXMA-K9XH-H8MP-K9C5
S5alKmpEIa5IA_Wm,1661503196,–°–∫–∞—Å—É–≤–∞–Ω–Ω—è. Bird,7999,7999,8500,8500,980,0,0,2212556,False
qgZjSYkIrCfbgrX4,1661503191,Bird,7999,7999,-8500,-8500,980,0,0,2204056,False
WponcOhaGyrq7nBJ,1661502873,SALON KRASY BACKSTAGE,7230,7230,-60000,-60000,980,0,0,2212556,False,4CC6-2MBA-A7K8-96AP
QydwRD73I_jZhoYO,1661500561,–ï–ª–µ–∫—Ç—Ä–æ—Å–∞–º–æ–∫–∞—Ç–∏ Bolt,7999,7999,-2300,-2300,980,0,0,2272556,False,3HA4-M97A-T474-4X4K
VJDpzOCwmeYkKLa9,1661498172,Bwtc cafe&roasters,5814,5814,-12000,-12000,980,0,0,2274856,False,2T86-1XH3-5BMK-BETE
_UC6xn_wUwCfAgy-,1661495890,Bwtc cafe&roasters,5814,5814,-23000,-23000,980,0,0,2286856,False,14B6-6X6P-9PBT-H8BM
gnjc9f2XarrV6Pv0,1661495739,–ï–ª–µ–∫—Ç—Ä–æ—Å–∞–º–æ–∫–∞—Ç–∏ Bolt,7999,7999,-1592,-1592,980,0,0,2309856,False,X0B1-8MBH-T68K-9073
9ji0rxpB1loKQ3cu,1661495643,Bwtc cafe&roasters,5814,5814,-17500,-17500,980,0,0,2311448,False,6E71-0AE9-9AXB-3H4X
CVAHYxHqPYmWRL2U,1661495513,–ö–æ–ª–æ,5411,5499,-101050,-101050,980,0,0,2328948,False,EAC8-66T6-1T31-E6M9
WLhzXWK5nrgPgLQ6,1661495501,–ï–ª–µ–∫—Ç—Ä–æ—Å–∞–º–æ–∫–∞—Ç–∏ Bolt,7999,7999,-1983,-1983,980,0,0,2429998,False,HE8E-57H2-118K-PXEK
3mpwS0_TBq3hlCR1,1661491208,KapheDragomanovfood,5814,5814,-3000,-3000,980,0,0,2431981,False,18PC-2168-15P2-8TBC
HIihDRAb81NyQzNS,1661443510,5045Kavjarnja,5814,5814,-15500,-15500,980,0,0,2434981,False,72B4-0E81-7579-872T
g8vI-xYKKyutPJ8o,1661441150,Novapay,8999,8999,-6000,-6000,980,0,0,2450481,False,526C-P8T5-H151-B961
b_iodoXJ_ygzGiEZ,1661433698,Novus,5411,5411,-119533,-119533,980,0,0,2456481,False,7PCM-1CPX-M35K-BP9E
Snogzb9Fj0uYTJLh,1661409083,Novus,5411,5411,-21996,-21996,980,0,0,2576014,False,2A87-796A-B0A6-CBPE
reAxMI5cUbtaPIXs,1661353650,OK Wine,5411,5411,-11100,-11100,980,0,0,2598010,False,BA57-X9HM-H6TT-5129
WdgTYnkLy7qNOYay,1661351234,5045Kavjarnja,5814,5814,-17000,-17000,980,0,0,2609110,False,BM5B-M41M-8692-7BT8
PNQEJTiJPH_iAmv1,1661350063,Portmone,5942,5942,-45600,-45600,980,0,0,2626110,False,KBC1-PH4B-16K9-KPH4
nlPjCTJhqv-eOxX2,1661345581,Konteyner,5814,5814,-19000,-19000,980,0,0,2671710,False,26EK-EEP1-570E-E863
NzIFn7Z1d9emG6xd,1661345239,MasterZoo,5995,5995,-42700,-42700,980,0,0,2690710,False,6AC9-7C65-K16E-6M6M
RLyUqDU8iW2Q1nin,1661345093,Beer Market,5921,5921,-20857,-20857,980,0,0,2733410,False,HC06-77M5-AAP7-BB2T
by6tSWX5ZiJg8vpE,1661338916,Novapay,8999,8999,-48800,-48800,980,0,0,2754267,False,6T4B-2A7C-KCH6-BH3M
WZfdU55jkS8SggIr,1661336678,–Æ—Ä—ñ–π –î.,–ó –î–Ω–µ–º –ù–µ–∑–∞–ª–µ–∂–Ω–æ—Å—Ç—ñ üá∫üá¶,4829,4829,-5000,-5000,980,0,0,2803067,True,P6CX-5MB5-5KA6-4974
pVaKjZzPor1UcN9c,1661336630,–Æ—Ä—ñ–π –î.,4829,4829,-42000,-42000,980,0,0,2808067,True,93PT-258M-CH2B-P85E
ig4IWNfV_FiMXJ08,1661335894,–ï–ª–µ–∫—Ç—Ä–æ—Å–∞–º–æ–∫–∞—Ç–∏ Bolt,7999,7999,-4983,-4983,980,0,0,2850067,False,AA48-9BKE-B5MT-0B20
dfwk9GrG9mclUcrg,1661335876,–ï–ª–µ–∫—Ç—Ä–æ—Å–∞–º–æ–∫–∞—Ç–∏ Bolt,7999,7999,-5100,-5100,980,0,0,2855050,False,C6CC-P3MP-7A03-XK5A
WD04Li_kYq0n4hyN,1661334843,–ï–ª–µ–∫—Ç—Ä–æ—Å–∞–º–æ–∫–∞—Ç–∏ Bolt,7999,7999,-2208,-2208,980,0,0,2860150,False,AB2A-PEM1-AHC3-AC7E
iEWma3il__5HT6fy,1661324291,Bwtc cafe&roasters,5814,5814,-36000,-36000,980,0,0,2862358,False,B449-4HCC-X00X-A84P
ecNIEOH63UWqRqz8,1661271812,Produkti,5499,5499,-3200,-3200,980,0,0,2898358,False,X39K-EP5K-6303-M2B3
tQNthoUwATg2pxNf,1661266893,Bolt,4121,4121,-17200,-17200,980,0,0,2901558,False,2ET8-6ECP-P617-T902
DmnykD8WuWVPnl0i,1661263466,KopheKorner,5814,5814,-8000,-8000,980,0,0,2918758,False,531C-9C63-P3P8-P34C
LtU72KA4581E0pkO,1661260427,–í–∏–¥–∞—á–∞ –≥–æ—Ç—ñ–≤–∫–∏ KYIVSKE MIS VIDD 8 KAS,6010,6010,-35020,-35020,980,0,0,2926758,False,C4CK-847C-31P2-77T6
47adn-Buj5YTEvyC,1661254543,Bolt,4121,4121,-16400,-16400,980,0,0,2961778,False,E2C7-212P-6B8E-7MH0
tpI-EOWd6z5Dpy56,1661253826,–ü–∏—Ä—ñ–∂–∫–æ–≤–∞ ¬´–¢—ñ—Ç–∫–∞ –ö–ª–∞—Ä–∞¬ª,5814,5814,-22600,-22600,980,0,0,2978178,False,KM21-16H7-A617-M4H5
bcJpeeHCm3LhIMzC,1661253595,–ê–ø—Ç–µ–∫–∞ –ê–ù–¶,5912,5912,-48290,-48290,980,0,0,3000778,False,34HE-K324-88KK-T2T7
enfDTFf8TI_lislI,1661253415,–ö–æ–ª–æ,5411,5499,-31450,-31450,980,0,0,3049068,False,8M4M-HT9C-P46X-CX07
Y2U41e1jIf9ABd1D,1661251245,414943****6278,4829,4829,-100000,-100000,980,0,0,3080518,True,CA23-H52A-K5P2-ECH4
MaRMl7NKkTZPPzPt,1661237568,La fabrique,5814,5814,-9500,-9500,980,0,0,3180518,False,7574-8C7H-XMM6-E10K
LnWYnWYTB89vc4vW,1661237085,Bwtc cafe&roasters,5814,5814,-10000,-10000,980,0,0,3190018,False,31MH-2HCB-6A9A-BCA0
JaOMYtf8rYc20jrH,1661183188,Bolt,4121,4121,-9300,-9300,980,0,0,3200018,False,91EE-A3A7-63H4-18PX
gOTA4EpM3xyAjEMc,1661170565,–ü–∏—Ä—ñ–∂–∫–æ–≤–∞ ¬´–¢—ñ—Ç–∫–∞ –ö–ª–∞—Ä–∞¬ª,5814,5814,-16900,-16900,980,0,0,3209318,False,KMP5-TCP8-XB13-C2MP
YeEuUY561g8IuW-b,1661170446,–ï–ª–µ–∫—Ç—Ä–æ—Å–∞–º–æ–∫–∞—Ç–∏ Bolt,7999,7999,-2263,-2263,980,0,0,3226218,False,7EB4-HB46-M7KX-9CM8
XMV-BGwHOdQw8FQj,1661165611,Kharms,5814,5814,-8500,-8500,980,0,0,3228481,False,E1MX-B6CC-2544-54K3
AyIM1Lt4G-fps9OR,1661164757,–ï–ª–µ–∫—Ç—Ä–æ—Å–∞–º–æ–∫–∞—Ç–∏ Bolt,7999,7999,-2313,-2313,980,0,0,3236981,False,3TX7-79X7-T755-P20X
EvsQcVCkx1E6cBP0,1661163831,–íi–¥: –ü–†–ò–•–û–î–¨–ö–û –ï.–í. –§–û–ü,"–î–ª—è –ø–æ–ø–æ–≤–Ω–µ–Ω–Ω—è –∫–∞—Ä—Ç–∫–∏ 5375414101190360, –ü—Ä–∏—Ö–æ–¥—å–∫–æ –ï—Ä–Ω–µ—Å—Ç –íi–∫—Ç–æ—Ä–æ–≤–∏—á, 3487403339",4829,4829,3100000,3100000,980,0,0,3239294,True
3OZ1fbcXzOUdNdHU,1661162485,–°—ñ–ª—å–ø–æ,5411,5411,-12250,-12250,980,0,0,139294,False,47A8-C25K-A02M-BBET
e6_owiKqDPH2NsuB,1661146760,–í—ñ–¥: –û–ª–µ—Å—è –°–∞—á–µ–Ω–∫–æ,4829,4829,150000,150000,980,0,0,151544,True
fFj-ij1ud7VWRVBM,1661146302,Bwtc cafe&roasters,5814,5814,-5500,-5500,980,0,0,1544,False,5BE7-KTH2-77T8-CEB0
8akz-MO-9RRs25dM,1661098655,Frankly,5814,5814,-19000,-19000,980,0,0,7044,False,CB93-9TP6-TEK0-KE2X
88tbrJoRPcBXEVvl,1661098323,–û–ø–ª–∞—Ç–∞ –∫–æ–Ω—Å—É–ª—Ç–∞—Ü–∏–æ–Ω–Ω—ã—Ö —É—Å–ª—É–≥ wayforpay,7277,7277,-15000,-15000,980,0,0,26044,False,CC5C-C0HC-MPX2-PE32
HaKEI0iv8tQ3WTYp,1661093537,Novus,5411,5411,-191777,-191777,980,0,0,41044,False,4A15-6M93-T9H4-B9KB
zgh6srTnpL8BWDfV,1661091488,Fresh Dzhus end Babl T,5812,5812,-11500,-11500,980,0,0,232821,False,C417-8735-8E26-TC14
mD771ShQLv_H7J0T,1661090335,GREMIO GRILL,5814,5814,-21300,-21300,980,0,0,244321,False,5P3X-4APH-P1HE-7259
kW3xD0cLMWBq9jj7,1661089090,OKKO,5541,5541,-109200,-109200,980,0,0,265621,False,6E16-2790-11MC-B6EP
gYSU1CyuPFkkuGlU,1661088150,–í—ñ–¥: –û–ª–µ—Å—è –°–∞—á–µ–Ω–∫–æ,4829,4829,135000,135000,980,0,0,374821,True
vas2INi9xRF2gVK8,1661087215,–ï–ª–µ–∫—Ç—Ä–æ—Å–∞–º–æ–∫–∞—Ç–∏ Bolt,7999,7999,-3650,-3650,980,0,0,239821,False,41M9-3CBK-BTAA-K9KC
Rbn9yOsYs13HVvij,1661087209,–ï–ª–µ–∫—Ç—Ä–æ—Å–∞–º–æ–∫–∞—Ç–∏ Bolt,7999,7999,-3313,-3313,980,0,0,243471,False,2103-6PAM-X87X-7H83
2SmBZs_Toi-qw8v0,1661070036,OK Wine,5411,5411,-24500,-24500,980,0,0,246784,False,03C7-K94P-7XCX-BXX1
beQr0CWRTxbdwsC6,1661068716,5045Kavjarnja,5814,5814,-15000,-15000,980,0,0,271284,False,BAT7-APC2-7X2B-6BAH
h49-16KcXr3i1fSx,1661066730,LyaFabrk,5814,5814,-10000,-10000,980,0,0,286284,False,P1EH-X1XP-P43P-567B
L-31MMU7q4uYDb10,1661024791,LIQPAY*Prosto Mykolka,5947,5947,-135000,-135000,980,0,0,296284,False,T640-E6E7-EP09-E372
avD39KAaSbOxEk9m,1661016011,Konteyner,5814,5814,-16000,-16000,980,0,0,431284,False,HH4H-E206-127K-BM99
Gl0nqZ9kpGrTyHyu,1661014964,Bolt Food,4215,4215,-58500,-58500,980,0,0,447284,False,BP80-E85C-HE9K-A7A7
OUUlhQgRul_vze9j,1661014681,–°–∫–∞—Å—É–≤–∞–Ω–Ω—è. FDY*Food_SSL,5499,5499,54075,54075,980,0,0,505784,False
jtByEgMRI2ttiB2T,1661014433,FDY*Food_SSL,5499,5499,-54075,-54075,980,0,0,451709,False
vD4DvuWndrnOTcbi,1661011002,TOVPARKENDGO1,7523,7523,-3000,-3000,980,0,0,505784,False,4A7H-5X1T-HP17-9790
rPm1PByqku7Xk-bH,1660994401,PROMIN,5651,5651,-30000,-30000,980,0,0,508784,False,2X7K-59XE-M1CM-C1B9
l5z79qILQFrPqE2h,1660994007,–°–∫–∞—Å—É–≤–∞–Ω–Ω—è. Bird,7999,7999,8500,8500,980,0,0,538784,False
8mvbGFWpD9NpcYAP,1660994003,Bird,7999,7999,-8500,-8500,980,0,0,530284,False
GouzF7Jc3eOaMczL,1660993846,Mates,5812,5812,-64900,-64900,980,0,0,538784,True,K3BB-0607-5C7P-6025
inX3GvzYMopdTylX,1660978623,Bwtc cafe&roasters,5814,5814,-9000,-9000,980,0,0,603684,False,3TH0-9490-E930-KMTH
BwSKATRKQCFoT2Wl,1660977318,Bwtc cafe&roasters,5814,5814,-34400,-34400,980,0,0,612684,False,677H-6K89-9MPX-A07A
9TXE988KFQnikyA0,1660938700,Novapay,8999,8999,-5000,-5000,980,0,0,647084,False,TBA4-1MX3-XP3B-3A0E
zOBKw5PCnENCHk15,1660935930,Bird,7999,7999,-10000,-10000,980,0,0,652084,False,9H3H-M958-41MH-CCTT
zQtcMPLhBYewmYXT,1660935358,FDY*Clothing_SSL,5691,5691,-140000,-140000,980,0,0,662084,False,1THB-096T-C596-5HX1
15S2XKlEuNncHDLR,1660934868,–°–∫–∞—Å—É–≤–∞–Ω–Ω—è. Bird,7999,7999,8500,8500,980,0,0,802084,False
t5X94KP3xEsKPe1o,1660934865,Bird,7999,7999,-8500,-8500,980,0,0,793584,False
NqUBPxXVtSi3XEx4,1660933434,BAR AMBAR,5812,5812,-40000,-40000,980,0,0,802084,False,4XHM-378M-TXHC-996C
WV70SzfpuFeFt1b3,1660924807,Ponchyk Boy,5812,5812,-13200,-13200,980,0,0,842084,True,6E5B-1631-AEXH-2TC8
Q4GDEVlwPE0nbPFY,1660924677,–ï–ª–µ–∫—Ç—Ä–æ—Å–∞–º–æ–∫–∞—Ç–∏ Bolt,7999,7999,-4054,-4054,980,0,0,855284,False,5A78-MEM3-X728-P213
GO01_WlxBph2KVf4,1660916541,5045Kavjarnja,5814,5814,-6900,-6900,980,0,0,859338,False,0P56-MBE3-B80K-6HKB
A3p2cZLqM_CWN5sq,1660915680,Bwtc cafe&roasters,5814,5814,-3000,-3000,980,0,0,866238,False,8H6A-B50X-8KBH-K334
iEt0yBLHn3a4ZFfZ,1660897966,Bwtc cafe&roasters,5814,5814,-8000,-8000,980,0,0,869238,False,0BXP-PT4H-5EEC-28H2
amv5Gl1bTlD-ZyB-,1660894216,Bwtc cafe&roasters,5814,5814,-26800,-26800,980,0,0,877238,False,MMK0-B7PB-3155-B663
63gT9A2wv5op_xow,1660893619,DragomanovFit,7997,7997,-6000,-6000,980,0,0,904038,False,T7H6-59PT-MPX8-1928
iX5NLlKWusaloXVs,1660893407,DragomanovFit,7997,7997,-81000,-81000,980,0,0,910038,False,CAP6-B2E6-5XP9-0AB2
EgymHKNwmeNY6kig,1660891532,–í—ñ–¥: –û–ª–µ–≥ –ü–∞—Ü–µ–ª—è,4829,4829,30000,30000,980,0,0,991038,True
4UVKCiICEXesvCu8zxiGtSk,1660861268,"–°–∫–∞—Å—É–≤–∞–Ω–Ω—è. PRTMN  *AUTO W,KYV,UA",5533,5533,43600,43600,980,0,0,961038,True
sbkiYonG1OLHHlx7,1660840453,"MAGAZIN""PRODUKTOVAYaLAVKA",5499,5499,-55870,-55870,980,0,0,917438,False,X1A7-4326-2HMX-B911
avz_WZsfHqZiZgDY,1660840163,MAGAZIN,5399,5399,-32100,-32100,980,0,0,973308,False,XKK0-3H4T-KCXK-3CHH
JF7vR5pPnLVnHjw-,1660839402,Bolt Food,4215,4215,-47300,-47300,980,0,0,1005408,False,MXPT-669K-789M-TEXK
IwRKKPYnlSygDCj4,1660835420,Bwtc cafe&roasters,5814,5814,-5500,-5500,980,0,0,1052708,False,E7H7-5A66-X0BX-HT7E
qAGnZyNWq7ISIUFZ,1660832189,Kharms,5814,5814,-6000,-6000,980,0,0,1058208,False,10MK-KBKT-MXAX-94B3
kFWXWtYNYbL1FBXz,1660830423,–ï–ª–µ–∫—Ç—Ä–æ—Å–∞–º–æ–∫–∞—Ç–∏ Bolt,7999,7999,-2213,-2213,980,0,0,1064208,False,CX4X-PHC9-T4HE-XXC8
sAyyHqOrKb7CZJ7K,1660829472,Mates,5812,5812,-34100,-34100,980,0,0,1066421,True,T7A1-6K35-C2KM-PKH1
om1DjPuYUmGIv2o3,1660825313,–ï–ª–µ–∫—Ç—Ä–æ—Å–∞–º–æ–∫–∞—Ç–∏ Bolt,7999,7999,-1979,-1979,980,0,0,1100521,False,KM6E-E702-MC45-5X67
hpWwwFaed1jmvqk_,1660819165,LIQPAY*Pethouse,5995,5995,-424800,-424800,980,0,0,1102500,False,616T-5EAX-CH7P-01C2
7gU4Wx8QzFV2OKYL,1660814347,Kharms,5814,5814,-4800,-4800,980,0,0,1527300,False,CH4B-P1CP-0H7M-46H0
8niP5kAKh9N3qGLc,1660813495,Bolt,4121,4121,-9400,-9400,980,0,0,1532100,False,C8BP-387E-M40C-7917
3F-FbdVIJ-0qTCLL,1660807091,–ö–æ–ª–æ,5411,5499,-4500,-4500,980,0,0,1541500,False,5AH6-3378-6631-H369
iE_W4Pf6kEG8V9nK,1660806344,Bolt,4121,4121,-12500,-12500,980,0,0,1546000,False,38KX-M37C-0CB7-761C
ZqMN-MRVPBCR_mnX,1660803909,Bwtc cafe&roasters,5814,5814,-22500,-22500,980,0,0,1558500,False,866H-M7MC-EH0P-3HP2
kB24LLo8ioqix2vY,1660755349,Novapay,8999,8999,-6000,-6000,980,0,0,1581000,False,K6CK-PETX-3CH0-49H0
GdEsXFBvu14lrRfH,1660753987,–ï–ª–µ–∫—Ç—Ä–æ—Å–∞–º–æ–∫–∞—Ç–∏ Bolt,7999,7999,-3225,-3225,980,0,0,1587000,False,1AKK-0187-H385-6163
6ftdNb0_IZ3TugR8,1660744799,Kharms,5814,5814,-6000,-6000,980,0,0,1590225,False,4X2P-H7E5-EKA0-9MH5
dpl1K0V5EAkwZrWZ,1660743413,The blue cup coffee shop,5814,5814,-98500,-98500,980,0,0,1596225,False,3885-KM2K-TB2E-E385
Hk6cNx-FdbQ-rOsw,1660741025,–ï–ª–µ–∫—Ç—Ä–æ—Å–∞–º–æ–∫–∞—Ç–∏ Bolt,7999,7999,-2938,-2938,980,0,0,1694725,False,CAT3-X1P8-AEP6-1HH0
NTElTwvuQs_JlD9B,1660739454,–ü—Ä–æ–¥–º–∞—Ä–∫–µ—Ç,5499,5499,-14600,-14600,980,0,0,1697663,False,E51X-A4H9-C78X-MC65
08oZDBUAQNR4VQ7b,1660721712,–ï–ª–µ–∫—Ç—Ä–æ—Å–∞–º–æ–∫–∞—Ç–∏ Bolt,7999,7999,-1746,-1746,980,0,0,1712263,False,XH5T-28PC-AAK0-14CB
mi5lvlHQ3JL1wWJN,1660721698,–ï–ª–µ–∫—Ç—Ä–æ—Å–∞–º–æ–∫–∞—Ç–∏ Bolt,7999,7999,-1708,-1708,980,0,0,1714009,False,AMC2-H9XB-XEBE-6PEK
gjl3URaVA_vgaMuC,1660720788,t.c.pizza,5812,5812,-81400,-81400,980,0,0,1715717,True,0P51-7X1M-9E8A-HC3A
aFGe2K7R9e1bqAmS,1660718590,–ï–ª–µ–∫—Ç—Ä–æ—Å–∞–º–æ–∫–∞—Ç–∏ Bolt,7999,7999,-2167,-2167,980,0,0,1797117,False,H2H2-CBXP-2K3A-K914
PyeS3Ybqxv4K3-q-,1660718590,–ï–ª–µ–∫—Ç—Ä–æ—Å–∞–º–æ–∫–∞—Ç–∏ Bolt,7999,7999,-2175,-2175,980,0,0,1799284,False,0XBE-7M57-K8A4-KMB3
gNh5LjgVvai9n3rM,1660669249,TOV MFG,7941,7941,-8000,-8000,980,0,0,1801459,False,7514-7BK9-4X2H-E5B9
HPKJRmoV3Bx1Q9R7,1660665227,Bird,7999,7999,-10000,-10000,980,0,0,1809459,False,7H29-674X-82K4-001T
gKtC5f4IGpmkh88G,1660664988,–°–∫–∞—Å—É–≤–∞–Ω–Ω—è. Bird,7999,7999,8500,8500,980,0,0,1819459,False
Te5vls7llvSWQQHO,1660664985,Bird,7999,7999,-8500,-8500,980,0,0,1810959,False
1IvVVgvJ3ngQApvV,1660653499,–°—ñ–ª—å–ø–æ,5411,5411,-67626,-67626,980,0,0,1819459,False,8290-AP90-B9MP-7X43
2IKadTfOfd02vJ1j,1660651953,Vodafone,4814,4814,-3500,-3500,980,0,0,1887085,False,BK80-9PC9-4TTM-P8K8
6Hs4s1ClOS9ioglV,1660634800,PureNaive,5814,5814,-5000,-5000,980,0,0,1890585,False,0758-1765-89KT-9CBM
BEfBgZitehu9hhL4,1660634629,PureNaive,5814,5814,-24000,-24000,980,0,0,1895585,False,XM3T-TH9E-33HB-268T
gEI-SdOat3vgbFSi,1660630832,Bwtc cafe&roasters,5814,5814,-11000,-11000,980,0,0,1919585,False,X6E7-B32E-CX5E-2866
Fz43pbrFnJXCex4F,1660585873,–ï–ª–µ–∫—Ç—Ä–æ—Å–∞–º–æ–∫–∞—Ç–∏ Bolt,7999,7999,-3633,-3633,980,0,0,1930585,False,106C-EP29-93AH-33T7
zJGhJvZ9x7R7xsjx,1660585676,–°—ñ–ª—å–ø–æ,5411,5411,-3899,-3899,980,0,0,1934218,False,TKP8-THXE-T342-5XKA
wiQzUCRPDTkKlE4I,1660580850,Bwtc cafe&roasters,5814,5814,-5000,-5000,980,0,0,1938117,False,0494-9APT-1XTE-6P7K
KTMvA1DdlMJvmvWw,1660576993,Bolt,4121,4121,-11000,-11000,980,0,0,1943117,False,T18E-C1TE-0H89-K60A
bxl6kzUCEiN1I6Ik,1660573081,Novapay,8999,8999,-4500,-4500,980,0,0,1954117,False,A9E8-K12M-5H7P-BT00
rxKYIXvJ-kGSXLYx,1660561551,Kafe Right Coffee Bar,5814,5814,-5500,-5500,980,0,0,1958617,False,79BA-3E0X-T700-2BT7
x8NQ3DdIBFup_MaZ,1660561462,–ü–∏—Ä—ñ–∂–∫–æ–≤–∞ ¬´–¢—ñ—Ç–∫–∞ –ö–ª–∞—Ä–∞¬ª,5814,5814,-12200,-12200,980,0,0,1964117,False,75X0-MBX5-8CPC-120P
mCopMZZ4CtWUhciU,1660561329,–ê–ø—Ç–µ–∫–∞ –ê–ù–¶,5912,5912,-27000,-27000,980,0,0,1976317,False,C5AP-715C-TM61-52A0
kTPA8hq1-ultizRb,1660561186,–ö–æ–ª–æ,5411,5499,-23550,-23550,980,0,0,2003317,False,1H0B-541M-657T-583M
o4FHFZ0OR2Tw8BQg,1660560657,Lesya,4829,4829,-250000,-250000,980,0,0,2026867,True,AP20-A5HK-7556-E992
fIgXHqLlEuseLCER,1660556199,–ü–æ–ø–æ–≤–Ω–µ–Ω–Ω—è ¬´–ù–∞ –∞–≤—Ç–æ –¥–ª—è –ó–°–£¬ª,–ù–∞ —Ç–∞—á–∫—É –≤—ñ–¥ –ñ–µ–Ω—ñ,4829,4829,-150000,-150000,980,0,0,2276867,True,31MX-HH0H-97HK-K5B3
kq8ZSprd1oDOaxlN,1660555206,–°—ñ–ª—å–ø–æ,5411,5411,-15381,-15381,980,0,0,2426867,False,P5A8-KBHT-HA74-8A07
1pEIhrzm0Nn_NyVe,1660554537,–íi–¥: –ü–†–ò–•–û–î–¨–ö–û –ï.–í. –§–û–ü,"–î–ª—è –ø–æ–ø–æ–≤–Ω–µ–Ω–Ω—è –∫–∞—Ä—Ç–∫–∏ 5375414101190360, –ü—Ä–∏—Ö–æ–¥—å–∫–æ –ï—Ä–Ω–µ—Å—Ç –íi–∫—Ç–æ—Ä–æ–≤–∏—á, 3487403339",4829,4829,1200000,1200000,980,0,0,2442248,True
SWsL8Zlnbn2k_Gf3,1660547136,Bolt,4121,4121,-10400,-10400,980,0,0,1242248,False,3BP5-5K61-01KP-K24E
xAvs63SPRajujQQv,1660542853,Bwtc cafe&roasters,5814,5814,-16500,-16500,980,0,0,1252648,False,6T79-C3HA-HE24-A1CC
h0bksBo7Oko7Y8u0,1660499220,Bolt,4121,4121,-16700,-16700,980,0,0,1269148,False,B83H-5467-2764-5AKT
e0n0akS_H35nPv89,1660493010,5045Kavjarnja,5814,5814,-9000,-9000,980,0,0,1285848,False,973E-5X5X-745M-EBCX
OMHgXhubxqgaRvLb,1660490773,–°—ñ–ª—å–ø–æ,5411,5411,-43151,-43151,980,0,0,1294848,False,5KT3-812T-16AK-H1C4
IlWoL6YIMwT1iuVE,1660489966,DOWNTOWNNAILS,7230,7230,-53000,-53000,980,0,0,1337999,False,XHM5-763K-8APM-4320
8sxS7AxmEcp13JJs,1660489825,–°–∫–∞—Å—É–≤–∞–Ω–Ω—è. Bird,7999,7999,8500,8500,980,0,0,1390999,False
PxxiAoKtol0QTvxd,1660489821,Bird,7999,7999,-8500,-8500,980,0,0,1382499,False
VhzstYBvpmd6MCcq,1660483340,Uklon,4121,4121,-11500,-11500,980,0,0,1390999,False,AAE1-7XT3-PE38-P75A
ovMjZn1cMVI2yYZr,1660458618,Bwtc cafe&roasters,5814,5814,-4500,-4500,980,0,0,1402499,False,H604-8P01-9KB5-PH8K
mEaKSg586i_L7iaW,1660458294,Bwtc cafe&roasters,5814,5814,-13500,-13500,980,0,0,1406999,False,B03X-713T-H615-P007
Bje8qUU-JqVkdR5P,1660413901,V REBRO,5812,5812,-81500,-81500,980,0,0,1420499,False,P6CB-853K-E2HK-XCH9
e7BoWWJhUuOWLxZP,1660408648,Konteyner,5814,5814,-33000,-33000,980,0,0,1501999,False,7P58-725M-6X41-ABK6
-HtMUDOKuTfbOEyW,1660408419,5045Kavjarnja,5814,5814,-14500,-14500,980,0,0,1534999,False,PKH5-A23A-XXBB-KT7C
rz7RiMLIFFDHEuSn,1660397730,Fresh Dzhus end Babl T,5812,5812,-3000,-3000,980,0,0,1549499,False,9PB5-87M6-MT6K-81H5
sUpyIEb8PBH4srQY,1660397564,Fresh Dzhus end Babl T,5812,5812,-28000,-28000,980,0,0,1552499,False,4PM8-7PM1-EPCC-CPEH
j5Yv6qfWf2twSs5v,1660397539,YuDZhINBURGER,5814,5814,-12900,-12900,980,0,0,1580499,False,P8H7-BPB1-3195-8P96
DXlLCio8BDuetWKB,1660391677,Uklon,4121,4121,-13300,-13300,980,0,0,1593399,False,1EP2-7EA7-X3EE-CXP6
QP3t5xo50doOvmgN,1660384565,Bolt,4121,4121,-6700,-6700,980,0,0,1606699,False,243P-K050-B15A-31E2
ph0WdNoLB4U5Y67k,1660384319,OK Wine,5411,5411,-5500,-5500,980,0,0,1613399,False,M3MM-4M6B-73TA-B5XK
4QIKX8qWQ5QnANWp,1660375048,FOP Udala IaM,5814,5814,-28000,-28000,980,0,0,1618899,False,MK66-7HXE-BBEP-8BEH
13-S-QTtEXZtCN6r,1660326153,Novapay,8999,8999,-5000,-5000,980,0,0,1646899,False,X3T5-6MX9-EB34-7TA0
KlYrnJEY-IsBVXkN,1660324402,Konteyner,5814,5814,-17500,-17500,980,0,0,1651899,False,2307-69HE-K3A0-A5CP
b7MU7vVOqSrpWNMD,1660318841,–ï–ª–µ–∫—Ç—Ä–æ—Å–∞–º–æ–∫–∞—Ç–∏ Bolt,7999,7999,-2308,-2308,980,0,0,1669399,False,44EX-A25P-3PTK-67X4
Ud_wI7YRJKB_uVnj,1660309670,Bwtc cafe&roasters,5814,5814,-5500,-5500,980,0,0,1671707,False,BE2B-XPCX-K204-08T4
1ZityZvA8Vv2621y,1660308718,Kharms,5814,5814,-15800,-15800,980,0,0,1677207,False,B4BB-9T88-0T31-KAHH
iwLB4Mfsa54rizQm,1660307759,Bwtc cafe&roasters,5814,5814,-8500,-8500,980,0,0,1693007,False,KA5C-9K08-20CT-C76X
iJ2I7_0E7XmlCNHD,1660307730,Bwtc cafe&roasters,5814,5814,-10000,-10000,980,0,0,1701507,False,ET2M-1BT1-9HT6-HA36
BzXtZlzoIB9ME_UB,1660307607,–ï–ª–µ–∫—Ç—Ä–æ—Å–∞–º–æ–∫–∞—Ç–∏ Bolt,7999,7999,-1988,-1988,980,0,0,1711507,False,1EX8-432E-P3E0-98MX
NgXtvWEAJUyfjEbf,1660307446,–°—Ç–µ–π–∫—Ö–∞—É—Å,5814,5814,-15500,-15500,980,0,0,1713495,False,399P-TKK5-E5M4-502C
OsEsQzOsr2IjQv6X,1660307250,EVA,5977,5977,-399,-399,980,0,0,1728995,False,2HB4-4EK3-KP0P-BBAH
W6YtVXTXLam5Hn2U,1660306916,–§–ö –ï–í–û,5399,5399,-36300,-36300,980,0,0,1729394,False,76P3-H5C1-29AX-M86E
lmsEYp0VYblgoNki,1660301176,Novapay,8999,8999,-5000,-5000,980,0,0,1765694,False,4072-39X7-T702-9651
ZFPypdYpuzPph4xK,1660293162,Kharms,5814,5814,-4800,-4800,980,0,0,1770694,False,MC86-H31K-MHBX-XT4C
hWIshvORmfaCEZyX,1660291857,Ponchyk Boy,5814,5814,-36000,-36000,980,0,0,1775494,False,B2K0-KTCH-9K7E-E1EM
tMhSpFfJXAK-o6Cv,1660291099,Bolt Food,4215,4215,-32975,-32975,980,0,0,1811494,False,E756-A9HH-8328-T1PT
mShfyaKkG9M4787V,1660288891,Bolt,4121,4121,-11600,-11600,980,0,0,1844469,False,51T0-9X78-85M9-EB17
bOtdcMxyxeNiU4to,1660287903,Bolt,4121,4121,-6000,-6000,980,0,0,1856069,False,8TA9-X322-APME-0TE0
6ZSGFEJfucLT-Tuu,1660283540,Bolt,4121,4121,-11200,-11200,980,0,0,1862069,False,20XC-HEXB-9X73-8309
OkMhaNnbiTcIgHX4,1660243475,Kimera,7230,7230,-100000,-100000,980,0,0,1873269,False,38EB-B4A2-4H44-HPE9
4jRX1H2jWKKSR6pw,1660243412,MIKSMART,5499,5499,-30800,-30800,980,0,0,1973269,False,0K7E-A6C1-3BT8-00PH
vAuaTFxvF00ACqeg,1660234208,Bwtc cafe&roasters,5814,5814,-5500,-5500,980,0,0,2004069,False,5CPX-66T1-TBB9-09T1
lqTpHfz0fD9GadKZ,1660225851,Lesya,4829,4829,-30000,-30000,980,0,0,2009569,True,H048-2KX0-M4H3-7131
Z8Ab8hWEumng3NwZ,1660208314,FOP Udala IaM,5814,5814,-38500,-38500,980,0,0,2039569,False,96XA-E41B-XT2H-P6M8
X-iSH9dkcF-uvGec,1660207637,–ü–æ–ø–æ–≤–Ω–µ–Ω–Ω—è ¬´–ù–∞ —Ç–µ–ø–ª–æ–≤—ñ–∑–æ—Ä 242–±–∞—Ç¬ª,‚úä,4829,4829,-50000,-50000,980,0,0,2078069,True,CTXC-1918-6B42-0173
uShWhMKVGsiXhH0y,1660205470,Zygzag,5812,5812,-5000,-5000,980,0,0,2128069,False,AK5B-2P84-C96A-X591
JKeNt-cVqGoUy4NB,1660205408,Zygzag,5812,5812,-37500,-37500,980,0,0,2133069,False,7H07-0K8M-1AE8-E94C
-pcAIT4dsErcM9LU,1660198308,Ponchyk Boy,5812,5812,-19800,-19800,980,0,0,2170569,True,627E-P3E4-P81E-31X8
22flW5Ynb91bBeER,1660150376,BWTC,5814,5814,-30000,-30000,980,0,0,2190369,False,K53X-B467-M22T-51CB
1fXlTIRbCZgLmalu,1660149631,Bwtc cafe&roasters,5814,5814,-10000,-10000,980,0,0,2220369,False,8HAT-9A93-6CXT-X2K7
ck_0AORBkXu-Rfx2,1660146153,Lesya,4829,4829,-600000,-600000,980,0,0,2230369,True,A722-7390-5843-9C43
_FVsXjx8uNoiwKZF,1660136222,–ï–ª–µ–∫—Ç—Ä–æ—Å–∞–º–æ–∫–∞—Ç–∏ Bolt,7999,7999,-1783,-1783,980,0,0,2830369,False,51AB-081A-9992-1H1C
7IYOZURxhxcSrour,1660134933,OG BURGER,5812,5812,-66000,-66000,980,0,0,2832152,False,H17B-X8C6-PCTA-40CH
3UPCG-5vr9hgiVrG,1660134851,–ï–ª–µ–∫—Ç—Ä–æ—Å–∞–º–æ–∫–∞—Ç–∏ Bolt,7999,7999,-6038,-6038,980,0,0,2898152,False,0T0H-757E-1C02-CCM1
JmG8HpH5sEJyIlQa,1660134614,NUGA,5621,5621,-160000,-160000,980,0,0,2904190,False,2TPX-T35T-EK9X-CCBB
R2NzKHThOACQ7vUx,1660131942,EVA,5977,5977,-80600,-80600,980,0,0,3064190,False,4448-X937-42TB-426A
uVsiz8ZKfhDJBG0I,1660131481,Konteyner,5814,5814,-16000,-16000,980,0,0,3144790,False,H48C-8HTA-CBC1-5T67
qiwiNyzIgK-yqi0V,1660114660,Mates,5812,5812,-46800,-46800,980,0,0,3160790,True,E8T3-10CA-48PA-8KC0
PRheK6Wzjcr92XOB,1660112090,–ù–æ–≤–∞ –ø–æ—à—Ç–∞,7399,7399,-2000,-2000,980,0,0,3207590,False,P0C6-040P-323H-9T10
QLSeo3Gk0YD_yQgyFYccKA,1660085671,–ë—É–¥–∏–Ω–æ–∫ –Ü–≥—Ä–∞—à–æ–∫,5945,5945,-84400,-84400,980,0,0,3209590,True
29VxfQD9Kv9aLejKDE6UmXnnTQ,1660085671,–°–∫–∞—Å—É–≤–∞–Ω–Ω—è. –ë—É–¥–∏–Ω–æ–∫ –Ü–≥—Ä–∞—à–æ–∫,5945,5945,90400,90400,980,0,0,3293990,False
mxoNZR7BGuus8mKk,1660052485,IBOXBANK 17,4814,4814,-1000,-1000,980,0,0,3203590,False,P34X-9CBT-M27B-85P5
w3q5pv2UDz6ljveB,1660040186,–°—ñ–ª—å–ø–æ,5411,5411,-7007,-7007,980,0,0,3204590,False,KM37-9TTE-5559-17X1
2t1tlxaZtggrhdBb,1660036695,Novapay,8999,8999,-38500,-38500,980,0,0,3211597,False,789H-7841-2CA0-55EA
0Q0SicnUFxJkLW4R,1660025807,5045Kavjarnja,5814,5814,-12400,-12400,980,0,0,3250097,False,0C1X-7424-3MM7-08XP
__l9qVLK5GqMrS_I,1659977843,Bwtc cafe&roasters,5814,5814,-17000,-17000,980,0,0,3262497,False,T1BX-8710-0109-71H1
O40vDZuzCA4y8WrG,1659975383,Yaroslaviv Val 37-1,5499,5499,-59200,-59200,980,0,0,3279497,False,MC4M-T02X-5PAK-B199
FR1OIypRAuBriRk_,1659972855,–ö–∏—ó–≤—Å—å–∫–µ –º–µ—Ç—Ä–æ,4111,4111,-800,-800,980,0,0,3338697,False,PAMM-HTTH-TA4H-BK0A
7K5M-cuoBo6K4oM7,1659955696,–°—ñ–ª—å–ø–æ,5411,5411,-24407,-24407,980,0,0,3339497,False,944C-1BAA-8XXK-HK69
k8aygkB2k9z19h89,1659948846,Lesya,4829,4829,-500000,-500000,980,0,0,3363904,True,HP0E-MA5X-CB45-6B3M
Ub2IaCPfuPBx_If2,1659948828,–¢–µ—Ç—è–Ω–∞ –°.,500,4829,4829,-1950000,-1950000,980,0,0,3863904,True,1M1B-MAP4-C7ET-89TC
M3exb1Q3c9dLS6Kf,1659948707,–íi–¥: –ü–†–ò–•–û–î–¨–ö–û –ï.–í. –§–û–ü,"–î–ª—è –ø–æ–ø–æ–≤–Ω–µ–Ω–Ω—è –∫–∞—Ä—Ç–∫–∏ 5375414101190360, –ü—Ä–∏—Ö–æ–¥—å–∫–æ –ï—Ä–Ω–µ—Å—Ç –íi–∫—Ç–æ—Ä–æ–≤–∏—á, 3487403339",4829,4829,5100000,5100000,980,0,0,5813904,True
8Qbx7U4PMoqoksnc,1659942154,Bolt,4121,4121,-10500,-10500,980,0,0,713904,False,62C4-0X2M-HA0M-6KAC
v2WxH21-RBA5tAnX,1659940046,WFP.AQUAMARKET,5411,5411,-61780,-61780,980,0,0,724404,False,339T-CAP5-37T6-TK67
Bzbddl_PEC62VOHN,1659937095,Bwtc cafe&roasters,5814,5814,-26000,-26000,980,0,0,786184,False,2C16-A41P-7AEB-B6TM
AyyF6TIePyGacUvr,1659903705,–ë—É–¥–∏–Ω–æ–∫ –Ü–≥—Ä–∞—à–æ–∫,5945,5945,-90400,-90400,980,0,0,812184,False
ffZWfe21_iVUJ-Vn,1659901119,LIQPAY*Pethouse,5995,5995,-107200,-107200,980,0,0,902584,False,M7M7-TEXP-K8B1-3TBX
6Le4XtvvxAXg_nUc,1659889124,BACKSTAGE SALON,7230,7230,-60000,-60000,980,0,0,1009784,False,MA9M-A0A8-H6KH-T55K
Z1XE5WYx9MwSBxPF,1659887468,HANH cafe & market,5812,5812,-85000,-85000,980,0,0,1069784,False,3T4B-8CPK-H5B9-1M7H
s_yzFh-98mmH8oTJ,1659865946,–ö–æ–ª–æ,5499,5499,-21900,-21900,980,0,0,1154784,False,T38C-7KM2-0E5H-1979
4o68_jcC7YsQfuIm,1659865603,AVANGARDENGaleryandwi1,5814,5814,-13000,-13000,980,0,0,1176684,False,5K03-BP24-4X2T-8T58
RXO9dup01j8cJk2F,1659865174,Novapay,8999,8999,-8000,-8000,980,0,0,1189684,False,M4AP-9201-T805-21P8
_P81tx8bxz1NsW7N,1659856150,–°—ñ–ª—å–ø–æ,5411,5411,-28393,-28393,980,0,0,1197684,False,KP67-4H89-5CBE-E0T3
-iWOCoU4l0O4V1RJ,1659803600,OK Wine,5411,5411,-48400,-48400,980,0,0,1226077,False,8HHM-8B6P-6TH7-95E9
UrY4IgCaCZdTP6Ix,1659802789,Konteyner,5814,5814,-15000,-15000,980,0,0,1274477,False,B5H7-6641-TXEM-3A60
q9VT4_Tf9Ii1l5tz,1659794904,–°–≤—ñ—Ç –ö–∞–≤–∏,5814,5814,-6500,-6500,980,0,0,1289477,False,53H8-B4AX-T5BH-TPCP
PvuHFZxy_fyEjczQ,1659790506,Bwtc cafe&roasters,5814,5814,-23900,-23900,980,0,0,1295977,False,6E41-2X88-M4PX-ABE8
hOYE3vHWff4-zV3i,1659787099,WOG_MG,5541,5541,-26000,-26000,980,0,0,1319877,False,MKB6-H208-MXBK-68H4
OFeosjhWf019i16N,1659779062,–°–∫–∞—Å—É–≤–∞–Ω–Ω—è. WOGPAY_G,5541,5541,52000,52000,980,0,0,1345877,False
arGbOMGXK1ISPbN5,1659778936,WOGPAY_G,5541,5541,-234000,-234000,980,0,0,1293877,False
Bn5lBr8WBB1kOAMi,1659778254,JYSK,5712,5712,-95000,-95000,980,0,0,1527877,False,5M9P-6265-7T06-8B8K
GPog5XvPVlBwgbQ0,1659777600,Novapay,8999,8999,-17000,-17000,980,0,0,1622877,False,3CB9-K70B-EC50-9481
Vfc_kk3vHj6d-4IH,1659777524,Novapay,8999,8999,-5000,-5000,980,0,0,1639877,False,5BP4-9107-BE91-0T0A
dy55x5TwJlVOdxnz,1659776819,magazin 762597,5912,5912,-51020,-51020,980,0,0,1644877,False,X73X-C52B-KXKX-0A1E
okQdEniG_w5JbV6m,1659770164,Mates,5812,5812,-38900,-38900,980,0,0,1695897,True,5051-EA9C-BXA5-T9EP
17eCBSbooySViH3e_CNtAw,1659749154,–°–∫–∞—Å—É–≤–∞–Ω–Ω—è. Novapay,8999,8999,13000,13000,980,0,0,1734797,True
Fja6vXapBfRQyzPbYAz30w,1659749154,–°–∫–∞—Å—É–≤–∞–Ω–Ω—è. Novapay,8999,8999,3500,3500,980,0,0,1721797,True
ChkH4ukR8WR8OFpb,1659713729,Produkti,5499,5499,-7000,-7000,980,0,0,1718297,False,89TA-9K69-8A61-47EK
0QfevnL5g-8SYZab,1659710947,–ù–æ–≤–∞ –ø–æ—à—Ç–∞,7399,7399,-20500,-20500,980,0,0,1725297,False,B9PK-KP07-X08P-CKM0
lAXw0G0BpXZZHjaS,1659710590,–ù–æ–≤–∞ –ø–æ—à—Ç–∞,4214,4214,-8500,-8500,980,0,0,1745797,False,A2B7-E034-2T51-A594
s-BOntVPHubnNgzy,1659709403,Bwtc cafe&roasters,5814,5814,-15500,-15500,980,0,0,1754297,False,ETPC-A2M7-1M7C-PHHT
SYgTTNKuE5pNwgKw,1659709326,–ï–ª–µ–∫—Ç—Ä–æ—Å–∞–º–æ–∫–∞—Ç–∏ Bolt,7999,7999,-1758,-1758,980,0,0,1769797,False,E97B-6H2B-T939-0B2B
kcznMgbJlOq-oRHi,1659709285,Bird,7999,7999,-10000,-10000,980,0,0,1771555,False,7CT4-70B0-1AB0-TA33
sqqOhqKO_zhGNYuJ,1659709146,–°–∫–∞—Å—É–≤–∞–Ω–Ω—è. Bird,7999,7999,8500,8500,980,0,0,1781555,False
S2tiHa4hf9T_dkX3,1659709143,Bird,7999,7999,-8500,-8500,980,0,0,1773055,False
s9DX_Fs9RIH4OcMD,1659708462,Simona,5814,5814,-29400,-29400,980,0,0,1781555,False,EXBP-29PC-X809-X55E
4pC21rDJRyR7dBNA,1659708458,Simona,5814,5814,-70500,-70500,980,0,0,1810955,False,1360-KM42-HP59-MMB9
de5yWqOARFD1SEki,1659696337,Fotovramke,5946,5946,-63000,-63000,980,0,0,1881455,False,H9C6-5549-83X9-X3B3
_gH5xhxM52d00Ikh,1659684761,SUPERMARKET,5411,5411,-6000,-6000,980,0,0,1944455,False,KPK2-3CB9-T7E8-HE98
bRzjX-8f86cI329a,1659684137,Novapay,8999,8999,-170000,-170000,980,0,0,1950455,False,12K1-TAA1-MX8K-BC59
5tYz_ST2RBd7jzHW,1659684102,Novapay,8999,8999,-33300,-33300,980,0,0,2120455,False,T0E8-7CTK-2702-EMBM
ntZshlFUBriGo1-k,1659684058,Novapay,8999,8999,-22500,-22500,980,0,0,2153755,False,6T42-4KC0-TMK6-C7E2
adMcKaBkg4diXS0M,1659676351,LIQPAY*PALMIRA,5411,5411,-33000,-33000,980,0,0,2176255,False,58X6-0M94-P8C7-0HT6
3Is96WJClqHcAfGX2tsm_w,1659565443,–°–∫–∞—Å—É–≤–∞–Ω–Ω—è. Novapay,8999,8999,12500,12500,980,0,0,2209255,True
ux5_oWG1d0uc6nU3,1659519362,Lesya,4829,4829,-250000,-250000,980,0,0,2196755,True,05P8-H9AK-K87K-9E7B
Lot7q6AxPQTPqHOV,1659514586,"Lifecell
+380631692598",4814,4814,-18000,-18000,980,0,0,2446755,True,C27K-AA31-KE85-6B05
4HMf3hxtHsqwFyyY,1659511422,–ö–æ–ª–æ,5499,5499,-12100,-12100,980,0,0,2464755,False,BX6B-X608-1BTK-HHB1
GXIwmbsBEP6TPq1i,1659511135,–ï–ª–µ–∫—Ç—Ä–æ—Å–∞–º–æ–∫–∞—Ç–∏ Bolt,7999,7999,-1492,-1492,980,0,0,2476855,False,5AP6-2HKK-8259-TPAM
F1AVzb4eypuW12cM,1659511129,–ï–ª–µ–∫—Ç—Ä–æ—Å–∞–º–æ–∫–∞—Ç–∏ Bolt,7999,7999,-1463,-1463,980,0,0,2478347,False,X9A1-BME6-B5C2-BH7H
UmfnqmXwzZocO9Nh,1659510928,Novus,5411,5411,-64898,-64898,980,0,0,2479810,False,MB01-0XHA-70K2-T9XH
uX1xce76GzlkMTD1,1659510757,–ï–ª–µ–∫—Ç—Ä–æ—Å–∞–º–æ–∫–∞—Ç–∏ Bolt,7999,7999,-2142,-2142,980,0,0,2544708,False,TM23-EP9H-066X-59P1
NmJDjOnADQPhVfqI,1659510667,–ï–ª–µ–∫—Ç—Ä–æ—Å–∞–º–æ–∫–∞—Ç–∏ Bolt,7999,7999,-1788,-1788,980,0,0,2546850,False,EM3H-34BM-AK6X-ET99
IT3JQY7GPiZ87UBz,1659509931,–ï–ª–µ–∫—Ç—Ä–æ—Å–∞–º–æ–∫–∞—Ç–∏ Bolt,7999,7999,-2063,-2063,980,0,0,2548638,False,X0T9-0HP8-A9T0-9MB9
e6nD_ryQa4dqc-n0,1659509925,–ï–ª–µ–∫—Ç—Ä–æ—Å–∞–º–æ–∫–∞—Ç–∏ Bolt,7999,7999,-2042,-2042,980,0,0,2550701,False,85KE-P89B-6P83-EP4C
ZAcaeWEwM6fD2ck9,1659509567,–°—ñ–ª—å–ø–æ,5411,5411,-23544,-23544,980,0,0,2552743,False,A088-EE3E-7TEM-1CKC
vxI6m74SoRbsk4Pv,1659506724,Bwtc cafe&roasters,5814,5814,-19500,-19500,980,0,0,2576287,False,0139-5A4E-715K-34PK
DoMER37kkDsn3Rzy,1659459497,zoolux,742,742,-119430,-119430,980,0,0,2595787,False,61EA-E4B5-M997-6C90
1718MtPHYdvQ7X2h,1659459416,zoolux,742,742,-64000,-64000,980,0,0,2715217,False,4TX0-3E28-CTB4-899M
Nu4P2tpZnqnUQ8mL,1659459156,WINETIME,5921,5921,-23600,-23600,980,0,0,2779217,False,H6XT-2702-280H-AMCA
IL4-V6T52FIt6CL1,1659457789,Flagman,5499,5499,-21900,-21900,980,0,0,2802817,False,13PK-925A-46KM-3E30
-TKghGhRszKk_1SR,1659457598,"TOV ""Flagman Stor"" Magazi",5499,5499,-272880,-272880,980,0,0,2824717,False,ETHT-B799-992E-PKC4
4DVY9H8M6LLfQXRD,1659445781,OK Wine,5411,5411,-19350,-19350,980,0,0,3097597,False,3B3M-2P7K-771C-5XEK
2pvBwFqcloqvoUxo,1659445004,Novus,5411,5411,-20099,-20099,980,0,0,3116947,False,74H6-8P03-A4B8-7K0T
frjVE9IxBCvLwPwY,1659444427,–ù–æ–≤–∞ –ø–æ—à—Ç–∞,7399,7399,-4300,-4300,980,0,0,3137046,False,CEM0-P24B-58M2-3B4C
F3roidhTF2SiQJ6i,1659444052,Fotovramke,5946,5946,-34000,-34000,980,0,0,3141346,False,C55H-7B88-3T8A-29A7
YLSZ8oQWhkWzVoff,1659443552,–°–∫–∞—Å—É–≤–∞–Ω–Ω—è. Bird,7999,7999,8500,8500,980,0,0,3175346,False
ESU0pQ8sCBU7gggT,1659443548,Bird,7999,7999,-8500,-8500,980,0,0,3166846,False
FLT7BWeL5Si6Bkxa,1659438482,–°—ñ–ª—å–ø–æ,5411,5411,-260636,-260636,980,0,0,3175346,False,80E0-051H-C6K8-6TT5
NmEByt_r7Ub6A8CG,1659427056,Novapay,8999,8999,-13000,-13000,980,0,0,3435982,False,K59P-XEB7-7MK4-CB22
6H-cyoUbOsTS_9hs,1659422518,La fabrique,5814,5814,-17000,-17000,980,0,0,3448982,False,340M-B1P4-89EC-MM60
vt8HlUY6D2cxrCta,1659422512,Bwtc cafe&roasters,5814,5814,-16000,-16000,980,0,0,3465982,False,HBCT-C296-X3XE-8K84
vIquMGnLUngwpdlR,1659371241,Novapay,8999,8999,-12500,-12500,980,0,0,3481982,False
G_PI6qCClxNF15TL,1659369247,5045Kavjarnja,5814,5814,-16000,-16000,980,0,0,3494482,False,H313-9516-K47C-24X5
cRLc9xW9QTYos3XY,1659367868,Bolt,4121,4121,-11100,-11100,980,0,0,3510482,False,B81H-7M10-9C9A-EAM7
9bkn9VZvBbyT8Y06,1659366124,–°—ñ–ª—å–ø–æ,5411,5411,-59757,-59757,980,0,0,3521582,False,K466-XHBC-16M5-4040
tNatGfZqzTntROv0,1659352710,–°—ñ–ª—å–ø–æ,5411,5411,-11966,-11966,980,0,0,3581339,False,1M30-XHT6-796E-1AE0
3gE5wK05UuVh0fEG,1659351185,–ö–æ–ª–æ,5411,5499,-1900,-1900,980,0,0,3593305,False,7C37-6P04-AK99-C10A
cbnX1mzuql46tuaV,1659350960,–ê–ø—Ç–µ–∫–∞ –ê–ù–¶,5912,5912,-44780,-44780,980,0,0,3595205,False,C9M6-2986-7388-51K5
QbThvhB6xgvGxW-Z,1659350794,–ü–∏—Ä—ñ–∂–∫–æ–≤–∞ ¬´–¢—ñ—Ç–∫–∞ –ö–ª–∞—Ä–∞¬ª,5814,5814,-11400,-11400,980,0,0,3639985,False,1AA2-HAPE-41K7-1C71
lDVPcX4qh3K3caNE,1659348890,DigitalOcean,5734,5734,-53323,-1440,840,0,0,3651385,False,X460-5XA2-HPH8-KX40
YSDUWyO8HtGC_AZO,1659343989,–íi–¥: –ü–†–ò–•–û–î–¨–ö–û –ï.–í. –§–û–ü,"–î–ª—è –ø–æ–ø–æ–≤–Ω–µ–Ω–Ω—è –∫–∞—Ä—Ç–∫–∏ 5375414101190360, –ü—Ä–∏—Ö–æ–¥—å–∫–æ –ï—Ä–Ω–µ—Å—Ç –íi–∫—Ç–æ—Ä–æ–≤–∏—á, 3487403339",4829,4829,3300000,3300000,980,0,0,3704708,True
-w4iQNlcccvMKZSL,1659337240,Bolt,4121,4121,-10600,-10600,980,0,0,404708,False,8XC9-1CXP-39HX-3PKC
ZKcRhXc9MCBJL2T2,1659333545,bwtc cafe&roasters,5814,5814,-9900,-9900,980,0,0,415308,False,M60E-EX3M-772C-X57P
06J_Ha2vShENcjYx,1664466049,Bwtc cafe&roasters,5814,5814,-9000,-9000,980,0,0,2041803,False,6X58-BAK2-8394-4BHM
1oRQzivUTD9EkPZO,1664464755,–ï–ª–µ–∫—Ç—Ä–æ—Å–∞–º–æ–∫–∞—Ç–∏ Bolt,7999,7999,-2263,-2263,980,0,0,2050803,False,5KTM-1K2X-4K1K-H237
Qy3_LyJHqHNmQTfk,1664461193,–í—ñ—Ç–∞–ª—ñ–Ω–∞ –ö.,4829,4829,-55000,-55000,980,0,0,2053066,True,7XK2-5K4T-EM23-1CMK
VQ3tGXWHh4SVmAY7,1664458810,–°—ñ–ª—å–ø–æ,5411,5411,-62426,-62426,980,0,624,2108066,False,HAX3-A6TC-XC5A-CEX6
xKpHhVBa6SA3Z9fy,1664452528,–ü–æ–ø–æ–≤–Ω–µ–Ω–Ω—è ¬´–ü—ñ–∫–∞–ø –Ω–∞ –ø–µ—Ä–µ–¥–æ–∫¬ª,4829,4829,-100000,-100000,980,0,0,2170492,True,6XAK-35PM-MEM4-4M47
1nIINdHHXXd6VYoM,1664450983,Novapay,8999,8999,-6000,-6000,980,0,0,2270492,False,M54B-2B80-0165-T1MM
2Nq_4lw1NA1Boug8,1664450747,Kharms,5814,5814,-4800,-4800,980,0,0,2276492,False,1HC4-PPC5-HCM8-H90T
Z-ivGbwlk-cmxFC8,1664449637,–ï–ª–µ–∫—Ç—Ä–æ—Å–∞–º–æ–∫–∞—Ç–∏ Bolt,7999,7999,-2246,-2246,980,0,0,2281292,False,37KK-M085-MK2A-97MK
sLXY5ldrdHVt_KjJ,1664449283,–ö–æ–ª–æ,5411,5499,-22500,-22500,980,0,225,2283538,False,8CC7-X688-1072-A91P
Brvr134yo4mi9UXW,1664440765,Master Zoo,5995,5995,-57500,-57500,980,0,2875,2306038,False,5HAE-0EMX-HBAT-AC7H
pmCM9AAoPa67ym36,1664434855,Bird,7999,7999,-10000,-10000,980,0,0,2363538,False,M14H-3MMB-77BA-2KCK
kAImd-DMuEGNX2CW,1664434453,HUMANS COFFEE IN TECH,5814,5814,-11000,-11000,980,0,0,2373538,False,8781-K9P8-3TA8-8042
TkNHfSupCduDskuA,1664434032,–°–∫–∞—Å—É–≤–∞–Ω–Ω—è. Bird,7999,7999,8500,8500,980,0,0,2384538,False
2EL_rLUEP-T5mL95,1664434028,Bird,7999,7999,-8500,-8500,980,0,0,2376038,False
TAptqg-BwSRueCCH,1664433138,Bwtc cafe&roasters,5814,5814,-5500,-5500,980,0,0,2384538,False,P8K2-2H5B-C3XT-EMA8
xath74w1KJcAp8yl,1664433113,Bolt,4121,4121,-6000,-6000,980,0,0,2390038,False,ACK9-TXC8-ECXX-9736
RLPvDs2HqAi2Ioyw,1664431893,–û–±—Å–ª—É–≥–æ–≤—É–≤–∞–Ω–Ω—è –ø–ª–∞—Ç–∏–Ω–æ–≤–æ—ó –∫–∞—Ä—Ç–∫–∏,4829,4829,-30000,-30000,980,0,0,2396038,True
YMrtOGOK0yLXM5wC,1664396167,LIQPAY*Fonarik.ua,5941,5941,-203000,-203000,980,0,0,2426038,False,5M11-T403-5MAK-K4T0
jdGNPXi-ssHfww8V,1664385460,–ï–ª–µ–∫—Ç—Ä–æ—Å–∞–º–æ–∫–∞—Ç–∏ Bolt,7999,7999,-1467,-1467,980,0,0,2629038,False,K027-T0B3-69TK-9X9C
02D3yW-F6cPslwEw,1664385247,–°—ñ–ª—å–ø–æ,5411,5411,-37212,-37212,980,0,372,2630505,False,XMKA-B20H-04M9-9B4H
LEDxQyycLufhlqPM,1664384354,–ï–ª–µ–∫—Ç—Ä–æ—Å–∞–º–æ–∫–∞—Ç–∏ Bolt,7999,7999,-1579,-1579,980,0,0,2667717,False,TTH9-E7KK-E38H-1MHH
etCht20XuExWoyCh,1664380461,"Lifecell
+380631692598",4814,4814,-25000,-25000,980,0,0,2669296,True,36XC-0EMB-2164-TX58
pw7m_ma1o6aDrFNR,1664375266,–ì–∞–Ω–Ω–∞ –ü.,4829,4829,-81600,-81600,980,0,0,2694296,True,1CA4-H0H1-P1M2-7BMK
EeTjSiOF4dXBPnuk,1664369385,Bolt,4121,4121,-6200,-6200,980,0,0,2775896,False,PCM7-M1HM-5BK1-6KE6
1Br7exOcMIkH6QiE,1664352265,ProduktiJArVal19,5499,5499,-17200,-17200,980,0,172,2782096,False,3PP3-1HH4-A93K-09H6
it8F80GcoggRNeN4,1664351060,–ü–æ–ø–æ–≤–Ω–µ–Ω–Ω—è ¬´–ù–∞ —Ç–µ–ø–ª–∞–∫–∏¬ª,4829,4829,-150000,-150000,980,0,0,2799296,True,CA26-MX81-C8A5-84K5
KxWO9KzB1tVKcV3E,1664346533,Kafe Right Coffee Bar,5814,5814,-17800,-17800,980,0,0,2949296,False,E3P5-H2BK-EP4T-EP6P
GrmNCIHWnFGo9zmX,1664293930,Novus,5411,5411,-20773,-20773,980,0,207,2967096,False,5BH0-TA6X-6MMP-CBP5
ssDPozK2nWJL0CtO,1664291390,–ï–ª–µ–∫—Ç—Ä–æ—Å–∞–º–æ–∫–∞—Ç–∏ Bolt,7999,7999,-4821,-4821,980,0,0,2987869,False,XC35-8294-6TE9-P1HK
cNGr-KgMJHHXoEO8,1664291079,–û–ª–µ–≥ –°.,4829,4829,-60000,-60000,980,0,0,2992690,True,751E-4P76-34A4-6ECT
BoYGY5Navwjq3kKq,1664280822,–ü–æ–ø–æ–≤–Ω–µ–Ω–Ω—è ¬´–ù–∞ 2 —É–¥–∞—Ä–Ω–∏—Ö –¥—Ä–æ–Ω–∏¬ª,4829,4829,-200000,-200000,980,0,0,3052690,True,HE69-B8P6-74P8-53A7
xbb4u973nO6Upy-f,1664276441,Kharms,5814,5814,-4800,-4800,980,0,0,3252690,False,0948-4BT7-M178-2MPE
im-DaFyHRQ0lWUB1,1664275572,–ï–ª–µ–∫—Ç—Ä–æ—Å–∞–º–æ–∫–∞—Ç–∏ Bolt,7999,7999,-4888,-4888,980,0,0,3257490,False,HB0A-TC3H-5AKA-KT83
KD7DFnAdl2goEe0t,1664275199,Fotovramke,5946,5946,-3500,-3500,980,0,0,3262378,False,0896-1ATA-K57P-B9M8
3NoW8TYRr2UlyEbU,1664272734,–û–ø–ª–∞—Ç–∞ –∫–æ–Ω—Å—É–ª—å—Ç–∞—Ü—ñ–π–Ω–∏—Ö –ø–æ—Å–ª—É–≥ wayforpay,7277,7277,-15000,-15000,980,0,0,3265878,False,H028-PPA2-H287-808C
e0oZWAaESsuUArox,1664272212,Novapay,8999,8999,-10500,-10500,980,0,0,3280878,False,7T63-7CHK-91X2-HCT9
Liqyg5JRkXJRQGy_,1664271654,–ü–∏—Ä—ñ–∂–∫–æ–≤–∞ ¬´–¢—ñ—Ç–∫–∞ –ö–ª–∞—Ä–∞¬ª,5814,5814,-10200,-10200,980,0,0,3291378,False,1860-9CCA-MTP1-0M58
tlbL5uPTPU727PtE,1664271470,–ö–æ–ª–æ,5411,5499,-7350,-7350,980,0,73,3301578,False,TTH3-AAA3-4CEA-2X1C
XYuLF5yVkn6hCc12,1664266835,–ü–æ–ø–æ–≤–Ω–µ–Ω–Ω—è ¬´—Ç–µ–ø–ª–æ –¥–ª—è –≤–ø–æ¬ª,–í—ñ–¥ –Æ–ª—ñ—ó –ê,4829,4829,-300000,-300000,980,0,0,3308928,True,0TA8-8AA5-TMMP-PET0
1WEj8_tNhkRQsBaZ,1664266280,–íi–¥: –ü–†–ò–•–û–î–¨–ö–û –ï.–í. –§–û–ü,"–î–ª—è –ø–æ–ø–æ–≤–Ω–µ–Ω–Ω—è –∫–∞—Ä—Ç–∫–∏ 5375414101190360, –ü—Ä–∏—Ö–æ–¥—å–∫–æ –ï—Ä–Ω–µ—Å—Ç –íi–∫—Ç–æ—Ä–æ–≤–∏—á, 3487403339",4829,4829,3100000,3100000,980,0,0,3608928,True
C9yrsjd3RMjI4hbX,1664260787,Bwtc cafe&roasters,5814,5814,-13500,-13500,980,0,0,508928,False,40C0-TT1H-8CK8-90XT
SOFmq2XROgyI6X_q,1664218171,–ï–ª–µ–∫—Ç—Ä–æ—Å–∞–º–æ–∫–∞—Ç–∏ Bolt,7999,7999,-3292,-3292,980,0,0,522428,False,6E67-E04K-01H8-283C
hPtLL7lNQ3KEeIdn,1664215993,Varvar Bar,5812,5812,-238000,-238000,980,0,0,525720,True,70E9-T483-57H0-HEMC
U0498rJWPXKy7zeV,1664208140,–ï–ª–µ–∫—Ç—Ä–æ—Å–∞–º–æ–∫–∞—Ç–∏ Bolt,7999,7999,-3375,-3375,980,0,0,763720,False,383A-X6PX-HE3T-KK27
g2Rty6ZxZMcB-ZCT,1664206024,magazin 726008,5912,5912,-13180,-13180,980,0,0,767095,False,H2E8-5T4M-H4C5-93T4
9C983KZPSJO7E69E,1664205414,OkvajnSichovih,5399,5399,-50850,-50850,980,0,381,780275,False,XK06-K3M6-2H00-3CHK
yssyR4CjmDQw3qR7,1664199661,Novapay,8999,8999,-4500,-4500,980,0,0,831125,False,HKB5-M8KE-018T-C219
Qy3_LydHrHdoRjLi,1664192735,Novapay,8999,8999,-10500,-10500,980,0,0,835625,False,8T42-M3KM-157H-5P1M
CcO5ljyW8H04Gdz2,1664192646,Novapay,8999,8999,-8500,-8500,980,0,0,846125,False,M130-CXT5-MHEX-K232
K2zZYxZoWn_oYsnZ,1664191443,–°—ñ–ª—å–ø–æ,5411,5411,-65389,-65389,980,0,490,854625,False,M55H-P8M8-B8C8-9EPB
-ywXcRAAyk12W_A4,1664174344,La fabrique,5814,5814,-18000,-18000,980,0,0,920014,False,33B6-0MAH-51KB-C6BH
vR5JkkSv6dVuKGL3,1664174064,Bwtc cafe&roasters,5814,5814,-9900,-9900,980,0,0,938014,False,3KT4-4TX2-APE6-C51K
7i-CO5SZ7ax8XHEI,1664126014,WFP.AQUAMARKET,5411,5411,-64180,-64180,980,0,481,947914,False,EE65-04PB-C8MT-882X
rNVpFzo1bNwpYJ2y,1664120887,–ï–ª–µ–∫—Ç—Ä–æ—Å–∞–º–æ–∫–∞—Ç–∏ Bolt,7999,7999,-1367,-1367,980,0,0,1012094,False,M05M-HEKP-H2X7-M7X3
B3eFy7ypG-eqrUw4,1664119072,5045Kavjarnja,5814,5814,-10800,-10800,980,0,0,1013461,False,H15P-045C-MK0E-6EXA
OhS4SB9uP5qJi0R4,1664114994,–°–∫–∞—Å—É–≤–∞–Ω–Ω—è. Bolt Food,4215,4215,100,100,980,0,0,1024261,False
AdFsadOtC9X1iT0r,1664110739,Varvar bar,5812,5812,-16500,-16500,980,0,0,1024161,False,HPAE-76H0-019X-P44A
7aI26dVtqaogeC6t,1664110415,Varvar bar,5812,5812,-85500,-85500,980,0,0,1040661,False,598X-2MK6-7103-AE6A
745NxvIepe4Hzdk4,1664093731,FOP Udala IaM,5814,5814,-93500,-93500,980,0,0,1126161,False,M8T0-TXP1-6HT8-A54T
-BqrRV9eKvc0l6NP,1664089282,Kafe Right Coffee Bar,5814,5814,-5000,-5000,980,0,0,1219661,False,53H5-HT73-A60M-E3CK
JHEhlpcaGVGbfrEH,1664040436,FDY*Food_SSL,5499,5499,-73500,-73500,980,0,551,1224661,False,0TMX-K6CK-9KPP-7TK8
nx4gMSOYi7PCXs00,1664035799,ZOOLYUKS,5995,5995,-27500,-27500,980,0,0,1298161,False,E602-5E99-0E8E-35EM
4txDcpW82aihgQSc,1664026633,Fresh Dzhus end Babl T,5812,5812,-15800,-15800,980,0,0,1325661,False,P907-5B08-KKEM-KA13
01inUZ8GGCcbWIx0,1664025521,Fresh Dzhus end Babl T,5812,5812,-26000,-26000,980,0,0,1341461,False,X3B4-95B8-HB0H-8TPA
-iyq3oZLsVWJ4dYa,1664025236,MasterBurger,5814,5814,-7000,-7000,980,0,0,1367461,False,14M0-CEAK-A524-BT44
o5XsCYNWpeDRptmE,1664025121,GREMIO GRILL,5814,5814,-25300,-25300,980,0,0,1374461,False,M737-88E8-54HX-7C76
6l_XhKu3mDmZafts,1664024809,ITIS CAFE,5814,5814,-75300,-75300,980,0,0,1399761,False,AX52-M4HA-M8MC-1958
a46ZiKMZPwkUQ7m3,1664020040,–£–∫—Ä–ø–æ—à—Ç–∞,9402,9402,-7809,-7809,980,0,0,1475061,False,256B-2B9C-3HMT-C12T
bc_SsqyFymyABD6S,1664001339,Bwtc cafe&roasters,5814,5814,-18500,-18500,980,0,0,1482870,False,K7P5-8C2E-XA37-T8E7
_w81iUOHhUKDaEE0,1663952751,–ù–æ–≤–∞ –ø–æ—à—Ç–∞,7399,7399,-18000,-18000,980,0,0,1501370,False,EA14-H4P7-4PK6-9372
C7Po46ATGVCuazxx,1663952064,–ï–ª–µ–∫—Ç—Ä–æ—Å–∞–º–æ–∫–∞—Ç–∏ Bolt,7999,7999,-3833,-3833,980,0,0,1519370,False,493P-2C07-3A6T-TM4K
0bpwuSGKHYVSjNdv,1663951861,Zolotii Vk,5944,5944,-112900,-112900,980,0,0,1523203,False,8XCK-314M-HB0H-42BK
cxwzjOkNBsK6uOoF,1663945318,Novapay,8999,8999,-43900,-43900,980,0,0,1636103,False,2PHM-AEB5-B4PB-HXKK
gqDEtuHUmr0Wf4wv,1663943493,–ö–æ–ª–æ,5411,5499,-25600,-25600,980,0,192,1680003,False,2757-K0P4-892A-TXKC
W7ZQ2tDwJqOSr8xc,1663940404,Bolt Food,4215,4215,-54500,-54500,980,0,0,1705603,False,7XCM-M43E-T2TA-0EBH
O-L432Bk4CJ7EWtH,1663940382,Portmone,5944,5944,-69000,-69000,980,0,0,1760103,False,5394-ABB9-2CK9-X81T
OxsvZ4D5S4XWUDsc,1663940331,Bolt Food,4215,4215,-100,-100,980,0,0,1829103,False
ryu6id0Gu4lGC0k1,1663930131,Novapay,8999,8999,-6000,-6000,980,0,0,1829203,False,P717-X6MP-TXEP-P0KE
bIx9KLH6UPWzEtki,1663925384,CAFE,5812,5812,-3500,-3500,980,0,0,1835203,False,58XP-M4C4-H889-6MAX
jEM-hwAsae3nkXXQ,1663922092,Novapay,8999,8999,-5000,-5000,980,0,0,1838703,False,2M00-0C0E-8HH5-9ABT
mRjTCEM5tcikLXRD,1663918097,Bolt,4121,4121,-14700,-14700,980,0,0,1843703,False,26H4-694A-HB00-9TAC
eT1sQosw4y3Mq12R,1663873485,Novapay,8999,8999,-18500,-18500,980,0,0,1858403,False,9BM4-45E7-3T83-CKX3
9KGjWVzH-RK8w-d4,1663864986,Bolt,4121,4121,-10600,-10600,980,0,0,1876903,False,4055-CC96-63BH-ABX7
5TcVMiM4wBKDDGm_,1663863903,Integral Fitness Studio,7997,7997,-36000,-36000,980,0,0,1887503,False,T6A8-MT56-6464-MXEP
YXPmI2uuK77ZTI9l,1663857270,Novapay,8999,8999,-6000,-6000,980,0,0,1923503,False,C34K-0C49-0CHH-M2P1
OD-6i7pyyRzmMjwE,1663849905,–°—ñ–ª—å–ø–æ,5411,5411,-57269,-57269,980,0,429,1929503,False,1169-BE79-03E1-7MMP
P3wCcXnl7SNw6wep,1663849502,SECHST,5912,5912,-30123,-30123,980,0,0,1986772,False,EM65-HT5M-0TK1-4KPA
bD3Tv5uMjm5ac_HR,1663849008,–ï–ª–µ–∫—Ç—Ä–æ—Å–∞–º–æ–∫–∞—Ç–∏ Bolt,7999,7999,-1717,-1717,980,0,0,2016895,False,H5A6-EEEB-694T-5H34
3CU4JrGSjAP3y2Ah,1663841272,–°—ñ–ª—å–ø–æ,5411,5411,-12843,-12843,980,0,128,2018612,False,7HM6-2H49-310H-59E9
-JKLCWmlkgRGaiuT,1663838536,–ü–æ–ø–æ–≤–Ω–µ–Ω–Ω—è ¬´—Ç–µ–ø–ª–æ –¥–ª—è –≤–ø–æ¬ª,–í—ñ–¥ –Æ–ª—ñ –ê–Ω—Ñ—å–æ—Ä–æ–≤–æ—ó,4829,4829,-250000,-250000,980,0,0,2031455,True,7MK8-10AC-4862-4K90
pge5i4j1on9DZLf2,1663838359,–ü–æ–ø–æ–≤–Ω–µ–Ω–Ω—è ¬´—Ç–µ–ø–ª–æ –¥–ª—è –≤–ø–æ¬ª,–†–æ–º–∞–Ω —è–∫–∏–π –∂–∏–≤ –≤ –æ—Ñ—ñ—Å—ñ,4829,4829,-50000,-50000,980,0,0,2281455,True,P8H4-HAPK-91AC-BEK7
fxZNiec6Ym2zkgy-,1663837592,–ü–æ–ø–æ–≤–Ω–µ–Ω–Ω—è ¬´—Ç–µ–ø–ª–æ –¥–ª—è –≤–ø–æ¬ª,–í—ñ–¥ –ñ–µ–Ω—ñ –ú–∞–ª–æ–≤–∞,4829,4829,-200000,-200000,980,0,0,2331455,True,H1TM-4011-HBM5-0400
tZJzMGUIe4dIi9UO,1663837555,–ü–æ–ø–æ–≤–Ω–µ–Ω–Ω—è ¬´—Ç–µ–ø–ª–æ –¥–ª—è –≤–ø–æ¬ª,–í—ñ–¥ –ù–∞—Ç–∞–ª—ñ—ó –í,4829,4829,-30000,-30000,980,0,0,2531455,True,HBK9-AXTH-1620-T4H6
MJ2cSug5VDW8MUU4,1663833433,LIQPAY*FOP Bidyuk Dmit,5399,5399,-50000,-50000,980,0,500,2561455,False,56EX-C351-XE62-M2TH
dMGXhAODCYG-uJk5,1663827797,Bwtc cafe&roasters,5814,5814,-28000,-28000,980,0,0,2611455,False,HXC9-4A42-AK75-K5H7
-E4FJLel1aiI4_FF,1663778904,OK Wine,5411,5411,-59130,-59130,980,0,591,2639455,False,734B-4AX2-19K8-C7K8
u9dzimsUX8b-kcdi,1663777698,Bolt Food,4215,4215,-66500,-66500,980,0,0,2698585,False,KEB2-T903-CTKX-3A6E
gQyaVAgpwVSsxniw,1663775639,–ï–ª–µ–∫—Ç—Ä–æ—Å–∞–º–æ–∫–∞—Ç–∏ Bolt,7999,7999,-2921,-2921,980,0,0,2765085,False,508X-KC1K-TBEA-P52H
8Nae0xZuJEmdioWf,1663775053,–Ü–≤–∞–Ω –°.,üêï,4829,4829,-50000,-50000,980,0,0,2768006,True,H04T-T24T-07B8-AT9E
O40vCZqyDw0882fC,1663765076,Kharms,5814,5814,-4800,-4800,980,0,0,2818006,False,81XA-AEC4-4KX7-231X
n7CH4JFCiBTauKlI,1663762550,–ï–ª–µ–∫—Ç—Ä–æ—Å–∞–º–æ–∫–∞—Ç–∏ Bolt,7999,7999,-2513,-2513,980,0,0,2822806,False,CHAH-CXHT-XE7M-C6M0
ZMEq_5KjkQlIv2W4,1663762041,Lesya,4829,4829,-300000,-300000,980,0,0,2825319,True,E667-1540-XA1K-C4E6
mFXiH2gMUoUDWGBK,1663762023,–ü–æ–ø–æ–≤–Ω–µ–Ω–Ω—è ¬´—Ç–µ–ø–ª–æ –¥–ª—è –≤–ø–æ¬ª,4829,4829,-120000,-120000,980,0,0,3125319,True,TC19-KE7K-ABPH-A75K
-QrxREuZ2-io4Ls8,1663754803,APTEKA7,5912,5912,-76640,-76640,980,0,0,3245319,False,E7HB-3KC1-PE3B-8614
1bBfxM2IpyH5Pvkt,1663754407,–§–ö –ï–í–û,5399,5399,-14900,-14900,980,0,149,3321959,False,686A-K482-M4CE-A711
YhGStkjCEHbQe7jS,1663754100,–ï–ª–µ–∫—Ç—Ä–æ—Å–∞–º–æ–∫–∞—Ç–∏ Bolt,7999,7999,-2196,-2196,980,0,0,3336859,False,3B3H-406H-1A1X-0690
a29z_FuCpUvwGLBY,1663753048,Novapay,8999,8999,-8500,-8500,980,0,0,3339055,False,38A6-4472-E773-MAX6
L-UJ5LmxJH_zoyC4,1663751101,–íi–¥: –ü–†–ò–•–û–î–¨–ö–û –ï.–í. –§–û–ü,"–î–ª—è –ø–æ–ø–æ–≤–Ω–µ–Ω–Ω—è –∫–∞—Ä—Ç–∫–∏ 5375414101190360, –ü—Ä–∏—Ö–æ–¥—å–∫–æ –ï—Ä–Ω–µ—Å—Ç –íi–∫—Ç–æ—Ä–æ–≤–∏—á, 3487403339",4829,4829,1700000,1700000,980,0,0,3347555,True
byUiRZwpyiBWmR6s,1663750674,APTEKA1,5912,5912,-52740,-52740,980,0,0,1647555,False,0H3X-AC6K-5KK7-8P24
TGxl6iSG2k15cbmf,1663749073,–ö–∏—ó–≤—Å—å–∫–µ –º–µ—Ç—Ä–æ,4111,4111,-800,-800,980,0,0,1700295,False,HAKP-3H9T-0CK2-A28E
P8T2nA2R18_5NngM,1663743367,Bwtc cafe&roasters,5814,5814,-4050,-4050,980,0,0,1701095,False,AK64-P85B-MH0E-2556
tVSD28gytGZQ9PHJ,1663742994,Bolt,4121,4121,-7500,-7500,980,0,0,1705145,False,X77X-KP28-EMT3-2A4A
SyFC28cdXUdMx-HE,1663739420,Novapay,8999,8999,-8500,-8500,980,0,0,1712645,False,MTK4-4EMM-TAX8-P4X2
co3ivuHBbhMleVsn,1663698073,Novapay,8999,8999,-10500,-10500,980,0,0,1721145,False,1K62-M8AH-2T4T-A74M
d2QCtfnTxhGMw9Wj,1663683023,–ï–ª–µ–∫—Ç—Ä–æ—Å–∞–º–æ–∫–∞—Ç–∏ Bolt,7999,7999,-1825,-1825,980,0,0,1731645,False,P320-8M2A-H6BB-9B9K
QCAV7eoFxcB_T2Fv,1663683023,–ï–ª–µ–∫—Ç—Ä–æ—Å–∞–º–æ–∫–∞—Ç–∏ Bolt,7999,7999,-1821,-1821,980,0,0,1733470,False,XCTA-96B0-276B-M5T7
PdPVcxcF9p_WnkGW,1663682718,–°—ñ–ª—å–ø–æ,5411,5411,-69376,-69376,980,0,520,1735291,False,16HX-H7T0-44MA-E7X5
QGmsx9k4ZuSIRkC0,1663681573,–ï–ª–µ–∫—Ç—Ä–æ—Å–∞–º–æ–∫–∞—Ç–∏ Bolt,7999,7999,-1404,-1404,980,0,0,1804667,False,B5HM-158X-K575-XKBE
CaXpcrbs0XvlA3A8,1663664339,–ï–ª–µ–∫—Ç—Ä–æ—Å–∞–º–æ–∫–∞—Ç–∏ Bolt,7999,7999,-3213,-3213,980,0,0,1806071,False,TK5C-K8C4-EBH4-X682
crG26_0YYomlxR1e,1663661665,Bwtc cafe&roasters,5814,5814,-8000,-8000,980,0,0,1809284,False,7C82-MA1A-P2C8-EKXA
wx0t0BJtcrPV2-gU,1663661339,La fabrique,5814,5814,-9000,-9000,980,0,0,1817284,False,B49X-8KT4-1MA8-BM6A
gv60IIuuobw4T-2h,1663656646,DragomanovFit,7997,7997,-3000,-3000,980,0,0,1826284,False,TAM3-A6XT-HCT3-57AM
LtimAfLhKxuWlNzl,1663656510,Bwtc cafe&roasters,5814,5814,-15950,-15950,980,0,0,1829284,False,0C2H-H829-C84E-4PH1
Bmj1QA01E8da7H61,1663614594,Novapay,8999,8999,-10900,-10900,980,0,0,1845234,False,A705-86MH-PT55-9X2M
yoqsKLjBBa4d46qU,1663614550,Novapay,8999,8999,-43900,-43900,980,0,0,1856134,False,5HT4-CM8C-49X1-AA80
sMrojKY9n4ZrLv3Q,1663614532,Novapay,8999,8999,-6000,-6000,980,0,0,1900034,False,1917-836C-6P05-X7PM
gKtC4PwLEZiggM8C,1663614498,Novapay,8999,8999,-5300,-5300,980,0,0,1906034,False,T030-0ET3-380T-CAP6
TCga6JnXNr3qIbCO,1663605138,–°—ñ–ª—å–ø–æ,5411,5411,-33303,-33303,980,0,249,1911334,False,1KC4-EH96-1C16-X425
5XKrRFMkEgObEQcP,1663600822,tisipi,5814,5814,-38000,-38000,980,0,0,1944637,False,3955-B7A6-C4EE-A54M
Eou4OlO_SGcWeFio,1663594684,Bolt,4121,4121,-11500,-11500,980,0,0,1982637,False,12KH-6MCE-5XX6-561T
AeV6xN597ZRPOrGn,1663591442,Kharms,5814,5814,-4800,-4800,980,0,0,1994137,False,0PEA-9CBA-HMEA-TAPC
RzZiANzgd_QzIhZV,1663590894,–ï–ª–µ–∫—Ç—Ä–æ—Å–∞–º–æ–∫–∞—Ç–∏ Bolt,7999,7999,-1621,-1621,980,0,0,1998937,False,17X1-738C-H19A-A9TP
TQdXXv0y2_1L5dxn,1663588769,KAFE LYPA,5812,5812,-27500,-27500,980,0,0,2000558,False,19EE-A93H-486B-90H2
WbV6QKeTNAh8Ryab,1663580907,–°—ñ–ª—å–ø–æ,5411,5411,-13198,-13198,980,0,131,2028058,False,4090-1BXC-47AB-8TB6
zl3IyG0ocnqDMLnP,1663576086,Comfy,5722,5722,-100000,-100000,980,0,0,2041256,False,871E-PC22-B063-9KE6
MpXbnwSoZQ_IjCzu,1663573208,–ö–æ–ª–æ,5411,5499,-30000,-30000,980,0,300,2141256,False,B092-K5MH-B5E7-96CH
6ZAJtQGKU9vTsIKl,1663569096,MKULTRA CORPORATION,5732,5732,-51937,-1385,840,0,0,2171256,False,992P-PM40-859T-1C81
pAQ42qTIu6OMfm4o,1663567852,Bwtc cafe&roasters,5814,5814,-13500,-13500,980,0,0,2223193,False,3K06-EBE7-CBM6-6E28
KvwYA5RGElfE5ZCv,1663516671,Novus,5411,5411,-116900,-116900,980,0,1169,2236693,False,XB6P-12B3-21C8-MAAT
uDxQY98Z5jIIxhdh,1663514976,Bwtc cafe&roasters,5814,5814,-13000,-13000,980,0,0,2353593,False,C414-8AEA-MK4A-82XB
egT9vZZhJKH_WIQc,1663503881,Novapay,8999,8999,-12000,-12000,980,0,0,2366593,False,B8X5-H3CK-794T-T7A3
oPcrcSGjMO41kFmt,1663502918,Novapay,8999,8999,-10500,-10500,980,0,0,2378593,False,19K1-0M4B-P9E9-P40P
C2DUqF_IOXr2oLmN,1663492841,PIDZEMNYY PARKING,7523,7523,-3000,-3000,980,0,0,2389093,False,TBMH-A9PM-2E5A-AX47
fm-gST-2ypCp9CEc,1663488593,Mates,5812,5812,-73500,-73500,980,0,0,2392093,True,B7B7-KM7H-E64K-8TMC
hMIQiavGJ3gDNkCb,1663433203,–ï–ª–µ–∫—Ç—Ä–æ—Å–∞–º–æ–∫–∞—Ç–∏ Bolt,7999,7999,-1596,-1596,980,0,0,2465593,False,8H73-T158-KAA5-P8A5
ErT5EKCxEUbCxmVl,1663430752,Bwtc cafe&roasters,5814,5814,-9500,-9500,980,0,0,2467189,False,8BMC-AC01-45C1-H8M0
2qL3ehI0KoXggvAf,1663425428,–°–æ—Ñ—ñ—è –ë.,4829,4829,-9000,-9000,980,0,0,2476689,True,420P-62H8-PM1X-A63B
_Deh2UudM9CyDx2K,1663425380,Tin tin,5814,5814,-9900,-9900,980,0,0,2485689,False,1716-TTM0-TM62-CT24
O-bhawHn_271JYca,1663425361,Tin tin,5814,5814,-67500,-67500,980,0,0,2495589,False,HX7X-PB3C-AT11-1X79
eykNaAD2zu680Bul,1663417431,Novus,5411,5411,-14599,-14599,980,0,145,2563089,False,9A49-78AM-0CC6-B1M9
XjiTJOWol6psuNyi,1663415553,WOG_MG,5541,5541,-78000,-78000,980,0,0,2577688,False,9T6H-PXBP-CEET-EEE3
8TdBMwtJeJdqNWJ8,1663414851,Fresh Dzhus end Babl T,5812,5812,-33900,-33900,980,0,0,2655688,False,20XH-3AKT-BKC1-13CC
qI5u8WU2XyM9Catn,1663408873,BALCONYKASA1,5651,5651,-13500,-13500,980,0,303,2689588,False,EH08-1KCM-BAK1-KX85
Z5E-6sox6um8uddw,1663407253,KNYZHKOVYI LEV,5942,5942,-32000,-32000,980,0,0,2703088,False,P22T-B315-MC5E-C61A
vmQXY6kXdzdKhOmH,1663399904,Bwtc cafe&roasters,5814,5814,-25000,-25000,980,0,0,2735088,False,0HC7-2759-5221-EEA5
y6B6BsxG1JJ9YlnibqueQg,1663366341,"–°–∫–∞—Å—É–≤–∞–Ω–Ω—è. LIQPAY*Pethouse,LIQPAY*Pethouse,DN-SK,UA,DN-SK,UA",5995,5995,14400,14400,980,0,0,2760088,True
BG8bpJt_Wl5uLtap,1663340695,Bowl,5814,5814,-23000,-23000,980,0,0,2745688,False,TP45-EEBM-7X1A-20PK
YYkyvk-9fcpArp5T,1663335838,–ï–ª–µ–∫—Ç—Ä–æ—Å–∞–º–æ–∫–∞—Ç–∏ Bolt,7999,7999,-2342,-2342,980,0,0,2768688,False,M5PK-XC01-696P-6167
s9hR-Tkz-9Q-QMt6,1663335343,365Studio1,7230,7230,-109500,-109500,980,0,0,2771030,False,CETA-2M72-M42K-P58B
fsstaXDlJnDNGOLy,1663335319,SKULPTOR,7298,8999,-155000,-155000,980,0,0,2880530,False,CBKP-15H8-KA7P-2M6K
QWxQS5EwXCTondo6,1663331253,–ü–æ–ø–æ–≤–Ω–µ–Ω–Ω—è ¬´–ø–∞—Ü–∏–∫–∞–º –Ω–∞ –∫–∞–ø—Ü—ñ¬ª,–ù–∞ –ª–∞–±—É—Ç–µ–Ω–∏ üë†,4829,4829,-100000,-100000,980,0,0,3035530,True,XT72-E8KP-X0AE-BM70
5bxtBoW8svPzWNLZ,1663326086,Bolt,4121,4121,-9000,-9000,980,0,0,3135530,False,PMX1-22CX-2T43-HM91
T1Fl6i7RNG_h3iLm,1663317480,Bolt,4121,4121,-6000,-6000,980,0,0,3144530,False,083E-T519-33XM-CTA3
0u7p05Z4lOHP3bCn,1663314696,Bolt,4121,4121,-6300,-6300,980,0,0,3150530,False,E2ET-0CXC-K00X-BHX2
vHO1obNyI6AgzT0V,1663309647,Kafe Right Coffee Bar,5814,5814,-10500,-10500,980,0,0,3156830,False,8432-KTHH-XEA0-199E
O4VT8-7JDe_i0Q6H,1663269244,–ü–æ–ø–æ–≤–Ω–µ–Ω–Ω—è ¬´–ù–∞ –∞–≤—Ç–æ –¥–ª—è –ó–°–£¬ª,4829,4829,-100000,-100000,980,0,0,3167330,True,4M41-94XH-9HA5-PXA0
A00IufnIJPJKQ872,1663262344,–°—ñ–ª—å–ø–æ,5411,5411,-76393,-76393,980,0,763,3267330,False,X66P-B5CB-AP2X-2XMT
9D45n8RrcXj7nAxH,1663252988,–ü–æ–ø–æ–≤–Ω–µ–Ω–Ω—è ¬´—Ç–µ–ø–ª–æ –¥–ª—è –≤–ø–æ¬ª,–î—ñ—Ç–æ—á–∫—î –Ω–∞ –¥–æ–ø–æ–º–æ–≥—É –í–ü–û,4829,4829,-100000,-100000,980,0,0,3343723,True,3501-2P52-XK59-K219
BEVnfz284m60ZCns,1663247876,–ü–æ–ø–æ–≤–Ω–µ–Ω–Ω—è ¬´—Ç–µ–ø–ª–æ –¥–ª—è –≤–ø–æ¬ª,–í—ñ–¥ –Ø–Ω–∏,4829,4829,-30000,-30000,980,0,0,3443723,True,4K06-THKB-MHM0-AKP2
Q8TLdh9v6MKiG-34,1663246675,–°–∫–∞—Å—É–≤–∞–Ω–Ω—è. Bird,7999,7999,8500,8500,980,0,0,3473723,False
HbZmkdSt-UfCN22b,1663246672,Bird,7999,7999,-8500,-8500,980,0,0,3465223,False
5zLfHNfdBPczx3qY,1663238428,Bolt,4121,4121,-15900,-15900,980,0,0,3473723,False,KC4P-8M12-X45H-TKE2
Qabs7SyiV3ycJrve,1663236040,OK Wine,5411,5411,-14600,-14600,980,0,146,3489623,False,77M4-0H0T-E53P-C729
uYn3Enxtmpw1d12Y,1663235000,–°–µ—Ä–≥—ñ–π –¶.,–û–ª–µ—Å—è,4829,4829,-10000,-10000,980,0,0,3504223,True,PCAC-603B-2MAX-AATE
80AGqq2DyDSUt5xs,1663234906,Suite13,5814,5814,-55500,-55500,980,0,0,3514223,False,7X95-MKKM-MH36-T916
K8mrI3q3MhAv9eqD,1663226595,CHARITY,8398,8398,-100,-100,980,0,0,3569723,False,0X39-24BX-5T2C-1CMA
O7ld-qHgZb8CkZNj,1663224261,Bwtc cafe&roasters,5814,5814,-23000,-23000,980,0,0,3569823,False,KKX1-1TE5-3A9K-28CA
paSVNLI9BwAP7N1F,1663223871,Novapay,8999,8999,-5000,-5000,980,0,0,3592823,False,040K-8A3M-6MBK-9K13
Fu0YXbQudjPeh2nA,1663223091,CEH 1,7216,7216,-51000,-51000,980,0,0,3597823,False,2CH8-X60T-53EE-X8P6
gNGKCwTQBvWGcI4s,1663221902,LIQPAY*Pethouse,5995,5995,-205400,-205400,980,0,0,3648823,False,H53X-4C7B-BX22-M5CP
z-H2BibXesYkDsMy,1663188584,Novapay,8999,8999,-25600,-25600,980,0,0,3854223,False,K463-EP03-MA3X-4T7K
-KgWTBg57tnvCGJG,1663176727,Beer Market,5921,5921,-18297,-18297,980,0,182,3879823,False,62HM-14AM-M54C-7P01
A61LXWSOzax3fn3X,1663176289,Grin13,5814,5814,-24800,-24800,980,0,0,3898120,False,MX09-M477-59T8-2P3H
aGILKgAK7P19GXeK,1663168048,SP MINOKEYS,5732,5732,-128211,-3419,840,0,0,3922920,False,P950-H8A9-043B-TMPC
_7DW1IC9IxIFfqaG,1663164818,Novapay,8999,8999,-5000,-5000,980,0,0,4051131,False,C50T-4M9B-05H9-M14K
_bCqdb48iJBwdHlX,1663163215,Novapay,8999,8999,-5000,-5000,980,0,0,4056131,False,A5HT-B0C5-H0MK-5BTB
HTbMWVvQzKTBGMu9,1663163175,Novapay,8999,8999,-5000,-5000,980,0,0,4061131,False,898C-A46H-46MH-PP43
MLsypt9kMpJmQ5C5,1663157877,Bwtc cafe&roasters,5814,5814,-24500,-24500,980,0,0,4066131,False,0BBA-H80K-4HC7-3BPM
andamiiDe0lnHE9V,1663157276,FOP Ianchuk OV,5814,5814,-67500,-67500,980,0,0,4090631,False,EHXA-EE93-H24H-K7K1
p8_D2ASOpzoPD3ig,1663141030,SALON KRASY BACKSTAGE,7230,7230,-41000,-41000,980,0,0,4158131,False,7X00-2487-1A0K-T720
5vRV1zYAtzeEXwr3,1663139220,–ï–ª–µ–∫—Ç—Ä–æ—Å–∞–º–æ–∫–∞—Ç–∏ Bolt,7999,7999,-3000,-3000,980,0,0,4199131,False,4TCC-KK6E-5218-367P
oUh-iZL6tUfRRL3q,1663138647,La fabrique,5814,5814,-14500,-14500,980,0,0,4202131,False,3A9M-CX05-016B-PAKT
WymcAkmQefpF_1rq,1663138255,Bwtc cafe&roasters,5814,5814,-19500,-19500,980,0,0,4216631,False,AK23-T53E-HAMM-7E48
d5dVqfN7OyPq9NN0,1663097844,–ü–æ–ø–æ–≤–Ω–µ–Ω–Ω—è ¬´–ö–Ω–∏–∂–∫–æ–≤–∏–π Punisher¬ª,4829,4829,-5000,-5000,980,0,0,4236131,True,K29P-7M43-T5KA-0BMC
MW7kduL0S0K33q4Q,1663096999,–î–∞—Ä'—è –Ü.,4829,4829,-29900,-29900,980,0,0,4241131,True,5423-CH95-0X16-AX34
uevDlKdyQK6S-Cvo,1663082529,Novapay,8999,8999,-5000,-5000,980,0,0,4271031,False,PAKB-K57A-CHE0-5EM8
GqCGciYjUSlnB9O9,1663077426,Lagomcoffee,5814,5814,-16800,-16800,980,0,0,4276031,False,PCE2-P2A3-63CP-828T
t1l7rHPXwA98Abz0,1663077070,–£–∫—Ä–ø–æ—à—Ç–∞,9402,9402,-3395,-3395,980,0,0,4292831,False,9BB3-EBP4-11K9-E7B4
qphjSbI1RRy-KLp7,1663059427,Novus,5411,5411,-47002,-47002,980,0,470,4296226,False,5H3B-3CPT-3509-X90T
oNbyuF6Diu1CxcYo,1663058062,–ö–æ–ª–æ,5411,5499,-21900,-21900,980,0,219,4343228,False,P88X-X81X-H10C-94PP
6kXU_oBNFsnB2ZIw,1663056872,Bwtc cafe&roasters,5814,5814,-21900,-21900,980,0,0,4365128,False,6M7P-3KMT-T77C-1B51
8lF0rI6p2pr_EAiC,1663055412,–íi–¥: –ü–†–ò–•–û–î–¨–ö–û –ï.–í. –§–û–ü,"–î–ª—è –ø–æ–ø–æ–≤–Ω–µ–Ω–Ω—è –∫–∞—Ä—Ç–∫–∏ 5375414101190360, –ü—Ä–∏—Ö–æ–¥—å–∫–æ –ï—Ä–Ω–µ—Å—Ç –íi–∫—Ç–æ—Ä–æ–≤–∏—á, 3487403339",4829,4829,3700000,3700000,980,0,0,4387028,True
A4TqLgqFLsfIXBp0,1663052496,DragomanovFit,7997,7997,-3000,-3000,980,0,0,687028,False,4840-6PM0-74CA-K252
Ric6ujhF2Z3eLeZ2,1663051467,Bwtc cafe&roasters,5814,5814,-15500,-15500,980,0,0,690028,False,H55E-309T-0K71-6KHK
LeiWBfcTHUXkt6ue,1663001906,Bolt,4121,4121,-14600,-14600,980,0,0,705528,False,3TP1-ABPB-KE33-AE5B
c6pGTHT7gazulTUV,1663000222,Integral Fitness Studio,7997,7997,-36000,-36000,980,0,0,720128,False,9KB9-TMT0-H5PP-8BC9
MbJ1VBRuZXzbRGuk,1662996557,Bolt,4121,4121,-6600,-6600,980,0,0,756128,False,TE0E-ACKA-4K82-5K5C
o4vY3U1qSVrvEJcV,1662980229,–ü–∏—Ä—ñ–∂–∫–æ–≤–∞ ¬´–¢—ñ—Ç–∫–∞ –ö–ª–∞—Ä–∞¬ª,5814,5814,-14800,-14800,980,0,0,762728,False,59H1-95CX-X94E-M106
LPSxw1WYj3OoczTC,1662977075,–°—ñ–ª—å–ø–æ,5411,5411,-12499,-12499,980,0,93,777528,False,66C9-K3KC-7B2K-62HT
4PCuDd24b11ohjPt,1662965768,Bolt,4121,4121,-10800,-10800,980,0,0,790027,False,CB11-63C9-60TP-H2BC
9-nXJWMbBTNHjAQ1,1662963383,Bwtc cafe&roasters,5814,5814,-13800,-13800,980,0,0,800827,False,93CA-2P26-3K58-57K5
x8NQ2TNLB1Kl_cKb,1662963150,Bwtc cafe&roasters,5814,5814,-25000,-25000,980,0,0,814627,False,9T04-XE95-254A-9APB
c_WhSYojQtkfEJpC,1662903679,Novapay,8999,8999,-5000,-5000,980,0,0,839627,False,0P35-PM9M-3H32-3M13
0SDWX5lj4FTnlv2o,1662898092,byMe,5621,5621,-179100,-179100,980,0,1343,844627,False,EAT3-4B9H-2M86-HX00
QGvF17Yhm_MESSXt,1662890426,Vodafone,4814,4814,-6000,-6000,980,0,0,1023727,False,M3MA-8BC0-568M-9281
LpAyz12-5uJoYqlR,1662887971,Vodafone,4814,4814,-11500,-11500,980,0,0,1029727,False,6CT4-84XB-KBEX-45K9
AmIePPnIZ_AJRFCR,1662886744,ProduktiJArVal19,5499,5499,-25800,-25800,980,0,193,1041227,False,815H-15H2-410B-EE65
chok_Qz-nq3dsS2q,1662886442,–ê–ø—Ç–µ–∫–∞ –ê–ù–¶,5912,5912,-48750,-48750,980,0,0,1067027,False,780B-H39M-M960-C6MC
zY42W1lLhVJibslW,1662885137,FOP Udala IaM,5814,5814,-35000,-35000,980,0,0,1115777,False,8CK0-9TE6-XKB4-A0TM
bdeLkZD0oS0rK_2a,1662825041,Bwtc cafe&roasters,5814,5814,-16000,-16000,980,0,0,1150777,False,1B2A-6ATT-EKX5-43EE
ZMVoBiEVBVh5obEY,1662819957,–ú–Ü–ù–Ü–°–¢–ï–†–°–¢–í–û –®–ê–£–†–ú–ò,5814,5814,-56500,-56500,980,0,0,1166777,False,P01C-A252-8EXX-KEBH
w8AKOKz3ySGZhMxA,1662818928,Goodwine,5921,5921,-213000,-213000,980,0,1597,1223277,False,X19A-BEAA-EMX2-2MX1
3z5xyWf5A6T56Ptn,1662809886,Fresh Dzhus end Babl T,5812,5812,-13100,-13100,980,0,0,1436277,False,KBKH-6HCA-02AB-0E8H
gxXboarZSEfQREVm,1662809244,Fresh Dzhus end Babl T,5812,5812,-9500,-9500,980,0,0,1449377,False,XH4M-MB4B-987B-CXB6
YZeUaU_onzJWkzER,1662808732,Cinnabon,5812,5812,-13400,-13400,980,0,0,1458877,False,E659-3BE9-8PCH-HMC5
REKhl_f9YJfcLH83,1662808405,Fresh Dzhus end Babl T,5812,5812,-21700,-21700,980,0,0,1472277,False,MMA9-4E68-C320-BE03
60Lyq7Pewo_I9iVR,1662806091,–£–∫—Ä–ø–æ—à—Ç–∞,9402,9402,-6700,-6700,980,0,0,1493977,False,2M89-CH94-7AT8-B0B9
NzjwJ_Klw10fxlyn,1662795614,WFP.EDA,5811,5811,-8000,-8000,980,0,0,1500677,False,49E6-3HBC-5KE1-70X0
Nx_9MBafvEYZhBwL,1662795455,SOPHIA HOTEL KYIV,7011,7011,-64500,-64500,980,0,0,1508677,False,45HX-4641-4KXB-C4E2
NUUaC88VMkzEeaWm,1662727028,Kafe Right Coffee Bar,5814,5814,-16200,-16200,980,0,0,1573177,False,AM5B-B18K-5HB3-MB82
8K_iNWYvxe1OxHsE,1662726697,EVA,5977,5977,-9990,-9990,980,0,0,1589377,False,AP3A-101H-M9KA-H6PP
b4TwCyDkQ408qMKk,1662726494,Beer Market,5921,5921,-29982,-29982,980,0,224,1599367,False,EAPP-X9ET-K0C3-3EPK
KIYK42Pyci3XB3Dy,1662712440,Bolt,4121,4121,-6500,-6500,980,0,0,1629349,False,0H90-43KC-2C7H-8KPK
sH2ylDC_cHhvnnoL,1662711702,TOV ROZMARI,5814,5814,-26400,-26400,980,0,0,1635849,False,C8AK-KPXK-PXKT-E22T
k9V7U90dgajbGF_N,1662704169,Bwtc cafe&roasters,5814,5814,-11000,-11000,980,0,0,1662249,False,08XT-X7AX-CMXT-10T2
64mNveYGGzKCICqF,1662703189,Bolt,4121,4121,-8800,-8800,980,0,0,1673249,False,APBE-1PEB-4BTP-XBH1
hreyp-72XYvza66A,1662664757,Etsy,5699,5699,-23475,-626,840,0,176,1682049,False,36A8-B5E2-B0C0-3TMP
v3oH2Q7bII4UKTLN,1662663243,–í—ñ–¥: –û–ª–µ—Å—è –°–∞—á–µ–Ω–∫–æ,4829,4829,100,100,980,0,0,1705524,True
1j70VriCDFewyp-d,1662663188,Lesya,4829,4829,-104,-104,980,4,0,1705424,True,PEPB-HAE1-XC29-5953
HF3IGniT_Jf3VbPE,1662663163,WFP.AQUAMARKET,5411,5411,-81880,-81880,980,0,614,1705528,False,X2P6-16AM-X496-KCK7
q5eYHFnj5-9uB6jx,1662654931,Bwtc cafe&roasters,5814,5814,-8000,-8000,980,0,0,1787408,False,1KBA-EABE-7P04-6HKT
etPBY-L-hGcPhsLy,1662644064,IDEALIST COFFEE CO,5814,5814,-8900,-8900,980,0,0,1795408,False,ME7A-X230-EP81-689H
AySHHmtFAPUhCUs_,1662642299,–ö–∏—ó–≤—Å—å–∫–µ –º–µ—Ç—Ä–æ,4111,4111,-800,-800,980,0,0,1804308,False,AEET-XH9B-486T-08A8
d-94Py9IU6HTbCKt,1662639202,–°–∫–∞—Å—É–≤–∞–Ω–Ω—è. Novapay,8999,8999,5000,5000,980,0,0,1805108,False
OhGmvEYDko89e3sg,1662636903,–ü–∏—Ä—ñ–∂–∫–æ–≤–∞ ¬´–¢—ñ—Ç–∫–∞ –ö–ª–∞—Ä–∞¬ª,5814,5814,-21100,-21100,980,0,0,1800108,False,X6CP-83BP-9M7P-C7P5
_FAchXVEIiTyc-kF,1662630065,Novapay,8999,8999,-5000,-5000,980,0,0,1821208,False
QWLurGHLMJlLd-PM,1662624832,Novapay,8999,8999,-11000,-11000,980,0,0,1826208,False,386T-PM3M-A6EX-ET36
WU7z7nK3WCrn-B2k,1662621085,Bolt,4121,4121,-10700,-10700,980,0,0,1837208,False,1154-0C9A-319K-45AK
YBcvIL6FAGT0KMmq,1662620171,LIQPAY*ibis.net.ua_Ver,5941,5941,-295200,-295200,980,0,0,1847908,False,KM9K-7MAP-XTP9-BT2E
nM0AA8d6X9XWOK0l,1662617096,5045Kavjarnja,5814,5814,-3900,-3900,980,0,0,2143108,False,A366-01X7-PAA9-H84H
8pci3EDJFMyVBUm8,1662558981,FOP Kokashinska AO,5814,5814,-8500,-8500,980,0,0,2147008,False,2C1C-093M-37H8-12T1
TBNYYHk8Sid0VNzS,1662556790,LIQPAY*Namelaka,5812,5812,-55000,-55000,980,0,0,2155508,False,2827-3B24-8CKK-2CPE
_jxtDx3kA1_8p2gC,1662552920,Bwtc cafe&roasters,5814,5814,-22900,-22900,980,0,0,2210508,False,3EEH-ECKK-0T3H-TMA0
9DKDToxExMHQ_jyK,1662552414,–ö–æ–ª–æ,5411,5499,-66950,-66950,980,0,669,2233408,False,6T6C-91CC-810B-9AAK
2T5hgXRZlpnGDWrS,1662550764,–ö—ñ–Ω–æ—Ç–µ–∞—Ç—Ä –ñ–æ–≤—Ç–µ–Ω—å,7832,7832,-9000,-9000,980,0,0,2300358,False,1832-685M-MMAT-P9CK
WJEHNelr6BX6tITn,1662549040,FOP Kokashinska AO,5814,5814,-23000,-23000,980,0,0,2309358,False,8TE9-5794-1MP2-278M
pNXbCYt5tx7mz7nl,1662547287,–ï–ª–µ–∫—Ç—Ä–æ—Å–∞–º–æ–∫–∞—Ç–∏ Bolt,7999,7999,-15571,-15571,980,0,0,2332358,False,T68C-TB19-EM26-EEE3
gTldjhXknxETu0rv,1662545773,FOP Kokashinska AO,5814,5814,-12000,-12000,980,0,0,2347929,False,5EX5-3B8T-77KH-7X3E
dswCcTLI6qOnl_Lh,1662545063,KNYZHKOVYI LEV,5942,5942,-21000,-21000,980,0,0,2359929,False,X8K9-36X0-2X5M-8214
gUIO05HP0BU00SW_,1662544515,VVal_ROZA,5691,5691,-11800,-11800,980,0,265,2380929,False,EXMT-M916-1AC3-1T3P
raFKS39n9MQzexdY,1662543737,–ï–ª–µ–∫—Ç—Ä–æ—Å–∞–º–æ–∫–∞—Ç–∏ Bolt,7999,7999,-1571,-1571,980,0,0,2392729,False,25B3-6581-4HPM-H391
hkgKh0ZteP0P52P5,1662533279,zakaz.ua,7278,7278,-90908,-90908,980,0,0,2394300,False,760E-H8X3-K35B-04EK
qIvRv2X6Jc0WYwlp,1662532121,Bwtc cafe&roasters,5814,5814,-5500,-5500,980,0,0,2485208,False,7MK8-H11B-12HE-HE82
54WGEuCFNGhoLpo5,1662531802,Bwtc cafe&roasters,5814,5814,-5500,-5500,980,0,0,2490708,False,PEK6-8096-4A5K-KXA7
3cEriR9Cek31sOyJ,1662531255,Bwtc cafe&roasters,5814,5814,-19300,-19300,980,0,0,2496208,False,30EX-1EM0-M6P9-E49E
PNZ6wk-2yHKVZ0_D,1662530984,Bwtc cafe&roasters,5814,5814,-12000,-12000,980,0,0,2515508,False,CH76-467B-K9XX-898H
ZpHj_lx-blUYjBvv,1662493093,MasloTOM,5411,5411,-64600,-64600,980,0,646,2527508,False,A4C4-AC1B-99CC-K2E1
XxFJJ294yOn4VWfT,1662488186,–ü–æ–ø–æ–≤–Ω–µ–Ω–Ω—è ¬´–ù–∞ –ó–°–£¬ª,4829,4829,-150000,-150000,980,0,0,2592108,True,B43K-T32X-MMXH-C0H9
aid5prbWoOxUh4tX,1662481511,Bwtc cafe&roasters,5814,5814,-16500,-16500,980,0,0,2742108,False,PEHB-B660-9041-MC3X
ImWIGHkVTfMY3JCq,1662470948,–¢–µ—Ç—è–Ω–∞ –°.,4829,4829,-400000,-400000,980,0,0,2758608,True,P015-KP5M-2P05-CHB2
JD6sbklVNJR66CU6,1662467068,–ü–∏—Ä—ñ–∂–∫–æ–≤–∞ ¬´–¢—ñ—Ç–∫–∞ –ö–ª–∞—Ä–∞¬ª,5814,5814,-16900,-16900,980,0,0,3158608,False,KH27-A0MM-4H76-X4AE
5fjw84-cJkBkrpHN,1662467013,Bolt,4121,4121,-13100,-13100,980,0,0,3175508,False,CXBH-65XT-P4X4-29T6
HS9AgRpF4LvZMAn-,1662462192,Bolt,4121,4121,-12200,-12200,980,0,0,3188608,False,1CH9-0X52-3052-TM20
yHN9eEbbLRnEL0KO,1662461843,–ü–æ–ø–æ–≤–Ω–µ–Ω–Ω—è ¬´–ö–≤–∞–¥—Ä–∞–∫–æ–ø—Ç–µ—Ä¬ª,4829,4829,-100000,-100000,980,0,0,3200808,True,PX45-63X1-85P8-H06M
NR0-96Df51x3Lt62,1662460128,–°—É–≤–µ–Ω—ñ—Ä–∏ –ø–æ–¥–∞—Ä—É–Ω–∫–∏ —ñ–≥—Ä–∞—à–∫–∏ wayforpay,5947,5947,-5000,-5000,980,0,0,3300808,False,BH37-M93E-4AC0-M6K2
qfEIfdfo2TJRVV1M,1662449897,Lesya,4829,4829,-500000,-500000,980,0,0,3305808,True,7TH4-220A-EHM4-2KT3
gGKqmZBYTHVg-jtH,1662446070,Mates,5812,5812,-42900,-42900,980,0,0,3805808,True,8A61-XXC6-976P-72A0
0pTnlKSmhUy6GeXx,1662393383,–ï–ª–µ–∫—Ç—Ä–æ—Å–∞–º–æ–∫–∞—Ç–∏ Bolt,7999,7999,-2767,-2767,980,0,0,3848708,False,P0HB-2ACM-X779-7420
Lhk2r3bJIdywhSiA,1662391890,–ö–∏—ó–≤—Å—å–∫–µ –º–µ—Ç—Ä–æ,4111,4111,-800,-800,980,0,0,3851475,False,XA15-AM1A-A0M8-AK2X
5zAjrzbPkuqAaFWR,1662381004,KAFE,5812,5812,-7000,-7000,980,0,0,3852275,False,X023-4B47-5017-C031
b3SPnmXsbq_3WtK1,1662379396,Kafe Right Coffee Bar,5814,5814,-17300,-17300,980,0,0,3859275,False,01MH-54ME-17EP-AP2M
L4KKnXHtGkR2pwT2,1662379234,Simona,5814,5814,-27500,-27500,980,0,0,3876575,False,XBA6-B463-A890-586T
H6dNMq3tOKGFCQ3y,1662379036,–ö–æ–ª–æ,5411,5499,-5100,-5100,980,0,51,3904075,False,664M-8C30-6EH8-30AH
zzU_0JIStc0n47cV,1662371306,–°—ñ–ª—å–ø–æ,5411,5411,-17699,-17699,980,0,176,3909175,False,HBAA-ABBA-ECC9-1BC2
HNvK5miso_T_BXQM,1662365378,–ö–æ–ª—è –û–≥–æ–π–∫–æ,4829,4829,-57500,-57500,980,0,0,3926874,True,BCCM-962C-4TA3-2T35
neafIeqd46VRGDLT,1662365290,–íi–¥: –ü–†–ò–•–û–î–¨–ö–û –ï.–í. –§–û–ü,"–î–ª—è –ø–æ–ø–æ–≤–Ω–µ–Ω–Ω—è –∫–∞—Ä—Ç–∫–∏ 5375414101190360, –ü—Ä–∏—Ö–æ–¥—å–∫–æ –ï—Ä–Ω–µ—Å—Ç –íi–∫—Ç–æ—Ä–æ–≤–∏—á, 3487403339",4829,4829,3500000,3500000,980,0,0,3984374,True
hJHIDuDvnZ0HOn-8,1662361272,Bwtc cafe&roasters,5814,5814,-5500,-5500,980,0,0,484374,False,8MX4-8855-7C17-9HAT
pDRfDVg2spIuxU9A,1662360829,Bolt,4121,4121,-9400,-9400,980,0,0,489874,False,652M-3XE9-90A5-KTP8
kVV4tNpgnkqa7wI2,1662356745,–ö–æ–ª–æ,5411,5499,-23750,-23750,980,0,178,499274,False,857X-TBBP-2A25-1KHK
QBH7IWRPeIsFljai,1662356374,–ê–ø—Ç–µ–∫–∞ –ê–ù–¶,5912,5912,-246450,-246450,980,0,0,523024,False,78K4-X80X-8CM2-H29K
f3A_ppyYZZRB9eXg,1662303809,–ï–ª–µ–∫—Ç—Ä–æ—Å–∞–º–æ–∫–∞—Ç–∏ Bolt,7999,7999,-1808,-1808,980,0,0,769474,False,HKBX-K003-3K29-558M
U-dJUbkMabWEBYCm,1662303656,–ï–ª–µ–∫—Ç—Ä–æ—Å–∞–º–æ–∫–∞—Ç–∏ Bolt,7999,7999,-1729,-1729,980,0,0,771282,False,3H6H-X8T7-AP5C-5XET
iT2b-mxpyDHAmuws,1662303386,SALON KRASY BACKSTAGE,7230,7230,-53000,-53000,980,0,0,773011,False,5K7M-87BX-0EA9-10PX
Bu5RqSa61h6wr25I,1662296509,–ï–ª–µ–∫—Ç—Ä–æ—Å–∞–º–æ–∫–∞—Ç–∏ Bolt,7999,7999,-2167,-2167,980,0,0,826011,False,C791-38P1-952C-0XM3
eTqPK6Ud2aG7ErSS,1662285743,Goodwine,5921,5921,-44900,-44900,980,0,336,828178,False,M42T-5788-B08M-XXMK
gdmqcMx_9XIAQA96,1662230919,SP ZEAL GENERATION,5045,5045,-449807,-11995,840,0,0,873078,False,3ABP-14H9-6B36-7TP6
eAI1Lim4Ujpnbhmy,1662223930,OK Wine,5411,5411,-79720,-79720,980,0,597,1322885,False,CC20-0937-HBP1-KEEA
KAVWi5n6JwNewthj,1662214881,SavageFood,5814,5814,-6000,-6000,980,0,0,1402605,False,0HC3-MCBA-BCX7-0H1T
UatHJxcOMfeb55h8,1662214780,SavageFood,5814,5814,-13000,-13000,980,0,0,1408605,False,BEX4-2K70-68PA-43M2
yFBaHUGQpwRL7O9E,1662207963,–°–∫–∞—Å—É–≤–∞–Ω–Ω—è. WOGPAY_G,5541,5541,73542,73542,980,0,0,1421605,False
7VbRx1h5Mo7m5qmH,1662207878,WOGPAY_G,5541,5541,-239700,-239700,980,0,0,1348063,False
-V-RDAgsjfSvwOs7,1662206628,–ú–æ–πcar,7542,7542,-5000,-5000,980,0,0,1587763,False,67P1-A209-T8CM-5384
E6hwVCN688Q4Cs8A,1662206388,–ú–æ–πcar,7542,7542,-5000,-5000,980,0,0,1592763,False,4E72-9927-4EBB-5H8C
M_wjVACVAYEMBfIN,1662205179,Fresh Dzhus end Babl T,5812,5812,-12200,-12200,980,0,0,1597763,False,T5E1-T369-9A3C-E859
75rN70G5zCAi_B4a,1662204172,Fresh Dzhus end Babl T,5812,5812,-36100,-36100,980,0,0,1609963,False,H2BC-CMHK-17MX-2X50
37UQWAb533Wmh6Q-,1662204037,YuDZhINBURGER,5814,5814,-19300,-19300,980,0,0,1646063,False,2AXX-MTC8-9612-EMEA
KnyUBdYFcL0Ja49X,1662203333,STORE J060 KYIV RETROV,5200,5200,-152000,-152000,980,0,0,1665363,False,0MT5-68X0-804X-98M7
28sG5uUT2bM4-vtJ,1662193283,Parasolja,8299,8299,-5000,-5000,980,0,0,1817363,False,HMAX-68E5-MA0K-0M37
34QRSoZE9ChgcLa-,1662192805,FOP Udala IaM,5814,5814,-30000,-30000,980,0,0,1822363,False,AHPM-0H07-6K5H-ATPB
Ingf0bPTJEyFHRzJ,1662190100,–°–∫–∞—Å—É–≤–∞–Ω–Ω—è. Bird,7999,7999,8500,8500,980,0,0,1852363,False
3dpOeIfY0JfMu5bq,1662190098,Bird,7999,7999,-8500,-8500,980,0,0,1843863,False
eizKvoJasGbcrr4R,1662186249,FOP Udala IaM,5814,5814,-50000,-50000,980,0,0,1852363,False,C02T-3C04-K0A6-943P
0P9yabltQ6KvQEjQ,1662149815,–ü–æ–ø–æ–≤–Ω–µ–Ω–Ω—è ¬´–ù–∞ —Ç–µ–ø–ª–æ–≤—ñ–∑–æ—Ä–∏¬ª,4829,4829,-10350,-10350,980,350,0,1902363,True,PHET-0445-M55C-9KA6
d7wzrbo_WR4FueOT,1662139817,Bird,7999,7999,-10000,-10000,980,0,0,1912713,False,A36E-PK0H-C1H2-KEXM
AXQOLGh-_Zv_M87a,1662139575,–°–∫–∞—Å—É–≤–∞–Ω–Ω—è. Bird,7999,7999,8500,8500,980,0,0,1922713,False
AGH2Pr0jbMMPD67v,1662139572,Bird,7999,7999,-8500,-8500,980,0,0,1914213,False
Ui0vObLKLuswm_FV,1662135977,–°–∫–∞—Å—É–≤–∞–Ω–Ω—è. Bird,7999,7999,8500,8500,980,0,0,1922713,False
J2-mVvDHZs3b1Agp,1662135973,Bird,7999,7999,-8500,-8500,980,0,0,1914213,False
PNrnKr5Jm2bbCO5e,1662132764,Bolt,4121,4121,-9600,-9600,980,0,0,1922713,False,15CB-E90E-3E9P-B54H
CW9nyaZElkXdoa5i,1662123050,–ü–∏—Ä—ñ–∂–∫–æ–≤–∞ ¬´–¢—ñ—Ç–∫–∞ –ö–ª–∞—Ä–∞¬ª,5814,5814,-16900,-16900,980,0,0,1932313,False,EP3K-CKM5-EPXE-9121
4gdVgqOv8yDAe_Lb,1662122874,–ö–æ–ª–æ,5411,5499,-23550,-23550,980,0,176,1949213,False,HC72-CETH-0378-MM2P
OGyzbNlSatIqVuGj,1662112026,KAFE,5812,5812,-8500,-8500,980,0,0,1972763,False,6TBA-3TP9-X61M-1034
-ectGHitTqaIaA6D,1662104389,SOPHIA HOTEL KYIV,7011,7011,-39000,-39000,980,0,0,1981263,False,3CHP-9A25-KB54-MABK
o7Zy59Fa4k9RcvUO,1662100781,Bwtc cafe&roasters,5814,5814,-7500,-7500,980,0,0,2020263,False,23PB-88E8-6T0H-6ABT
Ke4pR9eplY5LRWkE,1662100618,–ù–æ–≤–∞ –ø–æ—à—Ç–∞,4214,4214,-9000,-9000,980,0,0,2027763,False,E755-6P3H-0TEA-13HX
jqxlI2SS8fkv_fir,1662097633,FOP Udala IaM,5814,5814,-19500,-19500,980,0,0,2036763,False,0AT1-3BCH-P8XB-9A86
DAV2LUrTnKFKUmzI,1662051658,–ö–æ–ª—è –û–≥–æ–π–∫–æ,4829,4829,-85000,-85000,980,0,0,2056263,True,K26H-PEAM-6TX3-P8BX
_XZdPz5lDZWiIfpL,1662051614,–í–∏–≤–µ–¥–µ–Ω–Ω—è –∫–µ—à–±–µ–∫—É 2030.68‚Ç¥,4829,4829,163468,163468,980,0,0,2141263,True
jIxyVX6gF9qa3csa,1662050805,Bolt Food,4215,4215,-64100,-64100,980,0,0,1977795,False,E82A-C18A-P5T5-8E93
pf71NyIXISinDXN0,1662049101,–§–ö –ï–í–û,5399,5399,-93900,-93900,980,0,0,2041895,False,A2K9-X1BH-816X-8K24
UEajQoNIHz1_1ghN,1662046460,–°–∫–∞—Å—É–≤–∞–Ω–Ω—è. Bird,7999,7999,8500,8500,980,0,0,2135795,False
Y4ckWxwxC1jAPUz0,1662046457,Bird,7999,7999,-8500,-8500,980,0,0,2127295,False
jqDmRpIzZgQD10D_,1662033893,–°—Ç–µ–π–∫—Ö–∞—É—Å,5814,5814,-15500,-15500,980,0,0,2135795,False,XB1M-85B4-P8CH-MM4B
W9RbwBZrhah3RG-C,1662033878,–ü–æ–ø–æ–≤–Ω–µ–Ω–Ω—è ¬´—Ñ–æ–Ω–¥ UTL¬ª,4829,4829,-50000,-50000,980,0,0,2151295,True,208M-3863-P179-29PE
HFBZD15kW3RbxBgG,1662024610,Kharms,5814,5814,-6000,-6000,980,0,0,2201295,False,XP1H-A512-7X53-X327
-KNfloB77LMW10aM,1662024068,–ï–ª–µ–∫—Ç—Ä–æ—Å–∞–º–æ–∫–∞—Ç–∏ Bolt,7999,7999,-2738,-2738,980,0,0,2207295,False,CT87-AAPK-CMA5-A3H0
UfgRJRam4Ezneol3,1662023468,Yaroslaviv Val 37-1,5499,5499,-28300,-28300,980,0,0,2210033,False,A2AC-864P-AC82-X1BC
SWzh5GMLLwCNGUJD,1662018916,–ï–ª–µ–∫—Ç—Ä–æ—Å–∞–º–æ–∫–∞—Ç–∏ Bolt,7999,7999,-2279,-2279,980,0,0,2238333,False,3P3T-2A1H-4P68-E80A
DOz0PgVB5YRVFYAz,1662017844,Lesya,4829,4829,-100000,-100000,980,0,0,2240612,True,M8KE-H701-8CK3-H3B7
nlk3JikHAJxNvtMX,1662017180,DigitalOcean,5734,5734,-53999,-1440,840,0,0,2340612,False,KKM5-44P8-791C-XX77
gZyapPSzWCBn6Wi4,1662016115,"Lifecell
+380631692598",4814,4814,-20000,-20000,980,0,0,2394611,True,HCP3-1XCA-7A3K-B1EX
V-yCKIlOHzQWTwBI,1662015443,–ï–ª–µ–∫—Ç—Ä–æ—Å–∞–º–æ–∫–∞—Ç–∏ Bolt,7999,7999,-1625,-1625,980,0,0,2414611,False,E81K-HB7M-XXE7-K665
rjbRLqj7Ry60oJHe,1662015173,Portmone,4814,4814,-40000,-40000,980,0,0,2416236,False,MP4M-8570-M3PX-3BPP
cYWY1SuPfHfUr_kp,1662011457,KapheDragomanovfood,5814,5814,-3000,-3000,980,0,0,2456236,False,7KT5-5084-02X8-7709
rS3PGD22wRrkdLFu,1662010625,Bwtc cafe&roasters,5814,5814,-11000,-11000,980,0,0,2459236,False,49KC-BP5A-BX48-79T8
AIz9-4Z7288C8lCU,1667160439,LIQPAY*VSL,5942,5942,-6400,-6400,980,0,0,232964,False,2KH8-9B1H-E958-BB4P
5gkpzhmEV1x9C-Zj,1667148346,parking,7523,7523,-6000,-6000,980,0,0,239364,False,H49A-X057-PA08-EH4A
9lhKoFFHzvqNtlkK,1667142589,Produkti,5499,5499,-22500,-22500,980,0,168,245364,False,3XA5-6K5P-KT45-T9EP
fHUDObEAVS0otlHo,1667139919,WINETIME,5921,5921,-112600,-112600,980,0,844,267864,False,8X6H-3KB5-1P5A-BH47
U46ifebwDMtE6KLy,1667139610,Varcab,5814,5814,-28000,-28000,980,0,210,380464,False,9BAK-3HP2-X86M-AH34
8RR2tUj7YYeyU8qY,1667131789,WOGPAY_G,5541,5541,-102000,-102000,980,0,0,408464,False,B06P-14K8-B759-4XHE
KYljjUlqgAUHzRGn,1667127506,WOG_MG,5541,5541,-153000,-153000,980,0,0,510464,False,BBE9-871K-0HK2-0K99
NKo0grmxCWjr-jDv,1667125353,GUNIA PROJECT,5719,5719,-120000,-120000,980,0,0,663464,False,T1X3-9466-7X04-P200
Dm9icCBdoCWx9-KU,1667123633,YOLO,5814,5814,-25000,-25000,980,0,187,783464,False,ECX3-6E63-MX3H-XP66
ota-qdJIwNKqYkPH,1667114864,Bwtc cafe&roasters,5814,5814,-24500,-24500,980,0,183,808464,False,1K7T-7A93-2T4A-CMT2
6ruB9rVvtsgox3HU,1667063676,MagazinProduktivozn,5499,5499,-5200,-5200,980,0,39,832964,False,163H-BM99-9E75-4P3P
skKdyPwcWl82uCHH,1667063152,–ï–ª–µ–∫—Ç—Ä–æ—Å–∞–º–æ–∫–∞—Ç–∏ Bolt,7999,7999,-6226,-6226,980,0,0,838164,False,K12A-2B0C-9H91-XAXC
G7T-OaAos1g1CAD-,1667054324,Bwtc cafe&roasters,5814,5814,-7500,-7500,980,0,56,844390,False,7874-A956-E4H3-P9HP
-4Sge9YYEF5LKWeu,1667052150,–ö–∏—ó–≤—Å—å–∫–µ –º–µ—Ç—Ä–æ,4111,4111,-800,-800,980,0,0,851890,False,20XX-2196-T83B-5E9X
yORV71ZC0-W1tBDb,1667051144,Kazhangorodok,5399,5399,-880120,-880120,980,0,6600,852690,False,B552-1TMK-A2K5-3HXA
vFw7IbaiMEH8WQIZ,1667048083,Bolt,4121,4121,-11600,-11600,980,0,0,1732810,False,7B75-H1CA-KEAA-EC0M
r-qNsZZckTvSuwbv,1667026443,FOP Udala IaM,5814,5814,-62000,-62000,980,0,465,1744410,False,B3PM-0H70-CMT4-62BP
YLv0j43IvG1j4_mL,1667023903,–û–±—Å–ª—É–≥–æ–≤—É–≤–∞–Ω–Ω—è –ø–ª–∞—Ç–∏–Ω–æ–≤–æ—ó –∫–∞—Ä—Ç–∫–∏,4829,4829,-30000,-30000,980,0,0,1806410,True
oJqjXf0FM2oeqciG,1666982824,FDY*Shops_SSL,5631,5631,-150000,-150000,980,0,0,1836410,False,4EK1-P2E8-696C-9309
jZSH78Wr52mhPl7P,1666979928,Restoran,5814,5814,-10500,-10500,980,0,78,1986410,False,80MC-1T56-K68K-8KP9
eHSvVj8kZ4Ykg8I-,1666965748,Mates,5812,5812,-56700,-56700,980,0,1095,1996910,True,E459-E8E9-49B2-7E6P
v269dCgNrcgsMrr6,1666961692,–°—ñ–ª—å–ø–æ,5411,5411,-10900,-10900,980,0,109,2053610,False,691T-TMC5-HK1M-226P
66VwjYC4jqnx3N6H,1666959301,Salateira,5814,5814,-38400,-38400,980,0,768,2064510,False,68X3-9H15-9123-BPK7
gg0gXWcQB_e5aRly,1666951602,–ü–µ—Ä–µ–∫–∞–∑ –Ω–∞ –∫–∞—Ä—Ç–∫—É,4829,4829,-430000,-430000,980,0,0,2102910,True
qBfqRMgjbNID8Nhj,1666951427,–íi–¥: –ü–†–ò–•–û–î–¨–ö–û –ï.–í. –§–û–ü,"–î–ª—è –ø–æ–ø–æ–≤–Ω–µ–Ω–Ω—è –∫–∞—Ä—Ç–∫–∏ 5375414101190360, –ü—Ä–∏—Ö–æ–¥—å–∫–æ –ï—Ä–Ω–µ—Å—Ç –íi–∫—Ç–æ—Ä–æ–≤–∏—á, 3487403339",4829,4829,2100000,2100000,980,0,0,2532910,True
OUKY4ra2bhUIzn2b,1666940671,La fabrique,5814,5814,-15800,-15800,980,0,118,432910,False,2XK8-BHEM-E651-EME8
l6XBPranb1aXxTH9,1666940399,Bwtc cafe&roasters,5814,5814,-13500,-13500,980,0,101,448710,False,C7H4-BC3P-32BB-E7KE
wyN-ARb4p50OI3kX,1666889517,Produkti,5499,5499,-30000,-30000,980,0,225,462210,False,C4E6-94KB-192T-4PA2
XmkiBfn1AQScLtP7,1666876904,Novus,5411,5411,-54168,-54168,980,0,406,492210,False,C8A9-4M96-392C-PT2H
4ecWhLDhoS7mqO4J,1666874680,LIQPAY*BL-14 FOP Uzeny,5812,5812,-79600,-79600,980,0,597,546378,False,B4EP-AT2A-43M3-BHBA
zCEcICAG-WPt4Iun,1666874064,Sinsay,5699,5651,-15900,-15900,980,0,0,625978,False,499M-X8CK-XK54-C4AT
lqiwcZgAcEKt7Jdy,1666868720,–°—ñ–ª—å–ø–æ,5411,5411,-7198,-7198,980,0,53,641878,False,A1KC-4760-9X9C-C7BM
9iB7xHiQQS31J9VO,1666851803,ZOOLYUKS,5995,5995,-27500,-27500,980,0,0,649076,False,706C-XE6E-BM84-AH6C
sjLZmzr9edh5hKjx,1666850954,zoolux,742,742,-20430,-20430,980,0,0,676576,False,51M3-2A59-M4KC-3BHM
dyQL8VczFd3PXTe9,1666814578,Novapay,8999,8999,-37900,-37900,980,0,0,697006,False,H2EK-07B3-022H-C590
Fj0C5RWd3Lnb9_9p,1666795640,Novapay,8999,8999,-25600,-25600,980,0,0,734906,False,CMEA-P6K9-5H3T-XHK8
v1BtRgZvsDkGaxsi,1666785548,EVA,5977,5977,-26388,-26388,980,0,0,760506,False,8HB3-1783-BCPA-449B
PYiY9dFji-1ApLLM,1666782271,FOP Kokashinska AO,5814,5814,-12000,-12000,980,0,90,786894,False,97BP-K04H-M6T8-H357
JhW3N_DdsQJokM8r,1666778636,BURGER FARM,8999,8999,-26250,-26250,980,0,0,798894,False,E78M-THE4-K0A6-E0B0
5EMJojJE-xev3Oud,1666772676,UNIVERSUMCLINIK,8099,8099,-180000,-180000,980,0,0,825144,False,P8PA-50TE-KE19-2EA2
jHV32YKYowqqsIJP,1666771327,Novapay,8999,8999,-5100,-5100,980,0,0,1005144,False,EM59-9EK5-KX15-C518
NBcPjBSaN7Q1ZWyO,1666771315,Novapay,4829,4829,-227286,-227286,980,7686,0,1010244,False,X7B0-2A3E-8XA7-B6M1
yT6gWi1GO5_WPtz_,1666768993,zakaz.ua,7278,7278,-350790,-350790,980,0,0,1237530,False,M787-TP3E-9KE0-8X6B
wJOoWjqgLXPPvKeb,1666764637,Bwtc cafe&roasters,5814,5814,-13500,-13500,980,0,101,1588320,False,6021-KP9P-7XCC-1CH2
CAgt6ESkODU44c-r,1666725254,–°–∫–∞—Å—É–≤–∞–Ω–Ω—è. VANQUEST TOUGH-BUILT GEAR,5941,5941,346325,9250,840,0,0,1601820,False
ZxKhjyHhSZXiXzPc,1666723292,Novapay,8999,8999,-6000,-6000,980,0,0,1255495,False,EXKP-X224-61H3-47B3
Yq5BUh2gNzkU-LcB,1666711799,Yaroslaviv Val 37-1,5499,5499,-3590,-3590,980,0,26,1261495,False,E50P-61B1-14E9-8134
s_CPsNDb6HImHEOV,1666705298,OkvajnSichovih,5399,5399,-137370,-137370,980,0,1030,1265085,False,K5T9-H36E-C50E-EKXA
5nSAZMb6-TZ36XIu,1666702414,–ï–ø—ñ—Ü–µ–Ω—Ç—Ä,5200,5200,-356261,-356261,980,0,0,1402455,False,HBBA-CH64-A938-E49M
o4o54jXsjMwxgza8,1666698750,–°–∫–∞—Å—É–≤–∞–Ω–Ω—è. Bird,7999,7999,8500,8500,980,0,0,1758716,False
_mgvZq796Kfrw_Wb,1666698745,Bird,7999,7999,-8500,-8500,980,0,0,1750216,False
GsvnNZaqVtR5tFDz,1666698741,–ê–ø—Ç–µ–∫–∞ ¬´–ë–∞–∂–∞—î–º–æ –∑–¥–æ—Ä–æ–≤‚Äô—è¬ª,5912,5912,-185440,-185440,980,0,0,1758716,False,338X-H304-K013-MBKE
AknYVH3KImj3W3Xi,1666688513,VANQUEST TOUGH-BUILT GEAR,5941,5941,-346325,-9250,840,0,0,1944156,False
c4nHU2GO6tKpaeZq,1666680290,Produkti,5499,5499,-30000,-30000,980,0,300,2290481,False,8P4P-21B6-5PEA-5EP3
rnNmMkL61zcWZ2iV,1666679625,Bwtc cafe&roasters,5814,5814,-5500,-5500,980,0,110,2320481,False,K87B-CM1T-XB5A-XC2T
q2R7_-PrZNermY4s,1666630738,Vodafone,4814,4814,-1000,-1000,980,0,0,2325981,False,00KA-024C-5P50-0E15
WXpCVzssGKvDV0GV,1666611450,–ö–æ–ª–æ,5411,5499,-11700,-11700,980,0,117,2326981,False,5H4H-0T4K-6C6X-2B87
KwYfyYcahQTA3dyC,1666611336,PershaRestoraciyaShaurmi,5814,5814,-28700,-28700,980,0,574,2338681,False,TBK5-E58H-6BAT-M4C0
0taUK54lYRL23XVS,1666608365,–ü–µ—Ä–µ–∫–∞–∑ –Ω–∞ –∫–∞—Ä—Ç–∫—É,4829,4829,-1000000,-1000000,980,0,0,2367381,True
QB2jhPAUBiPcl_bc,1666602911,–íi–¥: –ü–†–ò–•–û–î–¨–ö–û –ï.–í. –§–û–ü,"–î–ª—è –ø–æ–ø–æ–≤–Ω–µ–Ω–Ω—è –∫–∞—Ä—Ç–∫–∏ 5375414101190360, –ü—Ä–∏—Ö–æ–¥—å–∫–æ –ï—Ä–Ω–µ—Å—Ç –íi–∫—Ç–æ—Ä–æ–≤–∏—á, 3487403339",4829,4829,3000000,3000000,980,0,0,3367381,True
_kjfQvvazwKOatoX,1666598014,"Lifecell
+380631692598",4814,4814,-20000,-20000,980,0,0,367381,True,EX55-P3B9-PCBT-60T4
drEmHCCkeKG-tPOZ,1666591266,Bwtc cafe&roasters,5814,5814,-27000,-27000,980,0,202,387381,False,CH48-8355-3M78-1M58
ul-Ev3I7QDkVKwoR,1666591044,Bwtc cafe&roasters,5814,5814,-12150,-12150,980,0,91,414381,False,712X-E7H0-595B-HEP2
og1deJ3yauvP-1RM,1666533367,–°–∫–∞—Å—É–≤–∞–Ω–Ω—è. WOGPAY_G,5541,5541,30160,30160,980,0,0,426531,False
_fPkliLrgml_QXDk,1666533274,WOGPAY_G,5541,5541,-135200,-135200,980,0,0,396371,False
1fTo_dGMTcicUdyk,1666524683,–ù–æ–≤–∞ –ø–æ—à—Ç–∞,7399,7399,-9100,-9100,980,0,0,531571,False,M231-PM26-CEA4-0XTP
KPRGkPcAg8WOSs6r,1666452590,–°—ñ–ª—å–ø–æ,5411,5411,-34003,-34003,980,0,255,540671,False,T5HA-KB25-3H02-AC1X
72a2C_mlJwG3yBt6,1666448475,Novus,5411,5411,-74650,-74650,980,0,559,574674,False,EA26-TT4P-B07E-8PBX
SjttxUgDeZJAV5Af,1666445818,ITIS CAFE,5814,5814,-17800,-17800,980,0,133,649324,False,38E0-511B-E1AP-E3C8
EZaQi5ZZn95-8oON,1666443826,OK Wine,5411,5411,-96520,-96520,980,0,723,667124,False,4BCP-PAAK-E0CE-X06E
T4boBQiRcNI4am95,1666439509,Dodo Socks,5651,5651,-14000,-14000,980,0,0,763644,False,H83T-KPPA-4BA0-AEPP
VMTrVrg3JiB61viD,1666432909,Bwtc cafe&roasters,5814,5814,-19000,-19000,980,0,142,777644,False,P0HT-8A34-05C4-5HEC
ClLHJ3YUbIqxrNln,1666432359,–ù–æ–≤–∞ –ø–æ—à—Ç–∞,7399,7399,-28000,-28000,980,0,0,796644,False,7CX7-09M5-B0EK-BK63
33INq7TMW5W-ZUfm,1666424389,FOP Udala IaM,5814,5814,-28500,-28500,980,0,213,824644,False,4T0P-KH50-HHKA-MHC4
Usu6kKtXTg0GR4tv,1666422274,Novapay,8999,8999,-6000,-6000,980,0,0,853144,False,772M-X76C-465M-2HX8
7YImIHTLCk2hTRaF,1666363024,Big & small,5814,5814,-18000,-18000,980,0,135,859144,False,45B8-P638-B5K6-E8HX
JnbfO-OkGdQ5VbqH,1666360672,ZOOLYUKS,5995,5995,-42390,-42390,980,0,0,877144,False,XK88-EP1P-9K3P-5B19
lkKYO23rxpCOGhyW,1666347484,Varvar bar,5812,5812,-73400,-73400,980,0,550,919534,False,TXE6-M9T9-8PEC-C6B8
09pGbZW-wUor2znt,1666346618,BALCONY,5651,5651,-240000,-240000,980,0,0,992934,False,7210-4MEP-M02H-H2BP
nJJRphQ88abFl5si,1666335054,WFPCOSMETIC1,5977,5977,-13000,-13000,980,0,0,1232934,False,T73C-AT1C-PK7P-K0KE
MnZG0Q3oYdD_GnSZ,1666277059,WFP*CHARITY,8398,8398,-15000,-15000,980,0,0,1245934,False,5K14-5E5E-51T8-AHA7
Prqa9nmMYhuKRc7L,1666259074,Bolt,4121,4121,-6000,-6000,980,0,0,1260934,False,164B-CCAB-2659-EP41
qNRigRQhr38Auhha,1666258598,–°—ñ–ª—å–ø–æ,5411,5411,-159018,-159018,980,0,1192,1266934,False,A150-MK91-K82H-PC2M
wqkkmYrE9xkeylF_,1666247494,MIKSMART,5499,5499,-30000,-30000,980,0,225,1425952,False,TT21-956X-T44K-37TA
Wnb2W4xmqOWnD89K,1666247249,FOP Udala IaM,5814,5814,-8500,-8500,980,0,63,1455952,False,5E46-E8XT-4161-141K
05niHMODtzXdl-Ea,1666247108,FOP Udala IaM,5814,5814,-35000,-35000,980,0,262,1464452,False,060X-EBCB-X5C4-2XCA
lPsJiz8Rq4aH4Z1e,1666195540,–°—ñ–ª—å–ø–æ,5411,5411,-7899,-7899,980,0,59,1499452,False,4MAK-7522-KB9H-26B0
0VuyCRp6r7KAj56C,1666194136,OK Wine,5411,5411,-60960,-60960,980,0,457,1507351,False,6HKX-804B-T4T4-B475
5p6-GinV5H9E-N3M,1666186704,–¢–∞–±–∞–∫–µ—Ä–∫–∞,5993,5993,-7300,-7300,980,0,0,1568311,False,P5BX-6BK8-467P-78BC
nPC_MD4VQUBWpQ80,1666186594,Novus,5411,5411,-11797,-11797,980,0,88,1575611,False,37KA-33TX-K8A9-HAH2
4aHe-9jz2PzVdNHv,1666181695,LIQPAY*Fonarik.com,5941,5941,-112000,-112000,980,0,0,1587408,False,C0KC-82A3-X383-56EM
44NDUrXq5KQgJ25d,1666178031,SP STANLEY - A PMI,5999,5999,-191434,-5113,840,0,0,1699408,False,2017-2M5H-ACMB-M41M
9yKoixxZjjDoFZ8O,1666163272,magazin 762597,5912,5912,-69140,-69140,980,0,0,1890842,False,M0PM-8644-7T0A-T559
XcZjMLeekSiuRdcv,1666162452,Bwtc cafe&roasters,5814,5814,-5500,-5500,980,0,41,1959982,False,57EP-X7AC-7EMH-EE95
IVCdzuuwCVoowcGy,1666161175,Novapay,8999,8999,-14600,-14600,980,0,0,1965482,False,T0CK-2797-66PX-6KA2
Lgk23oe37_U0H340,1666115951,WFP*CHARITY,8398,8398,-20000,-20000,980,0,0,1980082,False,5PK7-8916-5KKH-BB4T
whQ2ytyoYnrxp0Ba,1666099348,–ü–µ—Ä–µ–∫–∞–∑ –Ω–∞ –∫–∞—Ä—Ç–∫—É,4829,4829,-545400,-545400,980,0,0,2000082,True
agpQvjpCWHGFy-RF,1666098891,LIQPAY*Pethouse,5995,5995,-169300,-169300,980,0,0,2545482,False,79H8-5638-BAA9-2197
aC1VnX9WfltzQiYz,1666091247,–ö–æ–ª–æ,5411,5499,-19050,-19050,980,0,190,2714782,False,B34H-A08K-TX2E-865E
ahwpdUO0mGN2LYf8,1666090956,–ê–ø—Ç–µ–∫–∞ –ê–ù–¶,5912,5912,-107870,-107870,980,0,0,2733832,False,3MBB-A890-93E2-04E1
cEgmJXV_zkyWsQJw,1666090669,PershaRestoraciyaShaurmi,5814,5814,-32700,-32700,980,0,654,2841702,False,E7KM-0AXE-P6C3-316X
aBKPpBncjUYtn0hg,1666089091,Bolt Food,4215,4215,-33300,-33300,980,0,0,2874402,False,XAE8-8T91-A73C-6PH7
Abd8nD-0wWZoaTxu,1666079493,Produkti,5499,5499,-7600,-7600,980,0,76,2907702,False,KACT-APK8-CP69-CHBM
Ds5Wf2q5FPppD_J_,1666077651,Bwtc cafe&roasters,5814,5814,-10000,-10000,980,0,200,2915302,False,1MT8-2C88-H691-2X95
lDH2Nw4X-e2-dmVR,1666077571,Bwtc cafe&roasters,5814,5814,-12000,-12000,980,0,240,2925302,False,XHE0-1PHB-PXBH-P8XA
RbdSkkVJ6lEwf1OU,1666077488,Bwtc cafe&roasters,5814,5814,-21500,-21500,980,0,430,2937302,False,BH85-A957-H3H3-AP95
OuMaQaY_jrgs9Ow8,1666075604,–ì–∞—Ä–º–æ–Ω–∏—è family,8062,8062,-80000,-80000,980,0,0,2958802,False,92E0-A344-HX9P-105K
YtTIogRaUN2pAbzv,1666034448,LIQPAY*FOP Bidyuk Dmit,5399,5399,-50000,-50000,980,0,500,3038802,False,P0A4-5C2K-46X8-0293
w-GWyMqz0tRnM5KD,1666009827,Yaroslaviv Val 37-1,5499,5499,-54300,-54300,980,0,543,3088802,False,9402-5M04-3EMK-CPM9
T_1zV4n1Fx8LQ0dR,1666009448,Varcab,5814,5814,-48000,-48000,980,0,960,3143102,False,BP2E-CMC6-3B7M-5HC4
gIPrhpemHyoJ2y9q,1666002136,–ü–æ–ø–æ–≤–Ω–µ–Ω–Ω—è ¬´–ù–∞ –∫–æ–ª–µ—Å–∞ –¥–ª—è –Ñ–∑–∏)¬ª,–í—ñ–¥ –†–æ–º–∏ –ö,4829,4829,-100000,-100000,980,0,0,3191102,True,M358-0BKC-5PX5-855B
A89ViqDIwLviaV5W,1666001062,–íi–¥: –ü–†–ò–•–û–î–¨–ö–û –ï.–í. –§–û–ü,"–î–ª—è –ø–æ–ø–æ–≤–Ω–µ–Ω–Ω—è –∫–∞—Ä—Ç–∫–∏ 5375414101190360, –ü—Ä–∏—Ö–æ–¥—å–∫–æ –ï—Ä–Ω–µ—Å—Ç –íi–∫—Ç–æ—Ä–æ–≤–∏—á, 3487403339",4829,4829,3000000,3000000,980,0,0,3291102,True
MDxxRytdwZAXt_xD,1665992974,Bolt,4121,4121,-39317,-37900,980,0,0,291102,False,4705-MEHA-HA9K-C0C9
K4yaieuUJor9Rgmm,1665937135,WFP.AQUAMARKET,5411,5411,-36580,-36580,980,0,274,330419,False,H22T-T916-KC95-KT6T
DpGn7GNsCdAkyn90,1665934514,Mates,5812,5812,-56700,-56700,980,0,425,366999,True,ACEP-21X4-KM47-KHT1
ZqEz1tS3dX41Dqv_,1665933508,SALON BACKSTAGE,7230,7230,-44000,-44000,980,0,0,423699,False,5KA2-88E4-PHE9-EH7T
5VLfcu81FjHNJVz1,1665923076,Kafe Right Coffee Bar,5814,5814,-5900,-5900,980,0,44,467699,False,K283-MH02-4E8C-AHE9
yQM7uQU9pleweNYU,1665922474,Grin13,5814,5814,-4800,-4800,980,0,36,473599,False,9AEC-P708-CTHH-H847
O9hlXNgBg9r0Ts6r,1665920215,Grin13,5814,5814,-37500,-37500,980,0,281,478399,False,1M85-HMCH-M999-H8MH
-bbd1haMEutNzvmC,1665908409,Fresh Dzhus end Babl T,5812,5812,-30700,-30700,980,0,230,515899,False,X9A0-8371-B4X3-C0K3
H4Ghtkbc00tNKHo4,1665908081,EVA,5977,5977,-149939,-149939,980,0,0,546599,False,XA78-0212-H8K7-54TM
yXFn51-TLjainWU4,1665907047,ITIS CAFE,5814,5814,-27600,-27600,980,0,207,696538,False,XEA9-9045-BXK8-A6MX
HfmTIx1w_4Rz1NYQ,1665905924,OKKO,5541,5541,-94432,-94432,980,0,0,724138,False,C3K7-CE5C-814X-AE07
9XbllN26qcFDl4kQ,1665901321,Bwtc cafe&roasters,5814,5814,-21500,-21500,980,0,161,818570,False,P2CX-6CH8-134C-983C
ez5RJbLKvcLHFx1Z,1665834462,Beer Market,5921,5921,-65088,-65088,980,0,488,840070,False,63CX-MAMH-KXB4-32EE
amglV1ZNNbOlGvCA,1665824087,–ï–∫–æ-–õ–∞–≤–∫–∞,5411,5499,-9900,-9900,980,0,74,905158,False,MCH6-75EB-H77A-6KX0
sxw56q_bHZXwqyo4,1665819099,–ê–ø—Ç–µ–∫–∞ –ê–ù–¶,5912,5912,-99320,-99320,980,0,0,915058,False,6419-K7EX-3518-BX53
m-HprGbaOra0Qweb,1665763637,–§–ö –ï–í–û,5399,5399,-130000,-130000,980,0,975,1014378,False,55MP-H6KC-M89T-TBBX
fs8Dj4POLRELX-qk,1665762142,Mates,5812,5812,-69500,-69500,980,0,521,1144378,True,C1MH-HET0-781X-CE5M
OpRITS33rt2wFjd8,1665734937,magazin 762597,5912,5912,-34695,-34695,980,0,0,1213878,False,TX6B-4H79-7619-BB86
_jbgxl-wD0cnGzdP,1665734308,PIDZEMNYY PARKING,7523,7523,-6000,-6000,980,0,0,1248573,False,P0XP-KAET-1K5A-EC0C
SJHi9dSqioKe2Bcs,1665729327,magazin 762597,5912,5912,-4400,-4400,980,0,0,1254573,False,EM9H-512M-6EPX-A49C
7xEzAnLHpdBDnpvy,1665728707,Bwtc cafe&roasters,5814,5814,-19400,-19400,980,0,145,1258973,False,E4X8-T0HC-80P9-73C1
muf8KAvoHjopB4DB,1665680393,Novapay,8999,8999,-6000,-6000,980,0,0,1278373,False,HBTK-93CA-96AT-K2HB
QJqu5dv4q5t5pzpZ,1665678804,Novapay,8999,8999,-4500,-4500,980,0,0,1284373,False,5BPB-2H8T-833B-69CK
9pQOXIIs0jxMXi7F,1665673997,Yaroslaviv Val 37-1,5499,5499,-26790,-26790,980,0,200,1288873,False,6T7M-TB8E-5CAB-H4X5
fg1VschT2yy99rFs,1665673437,MasterZoo,5995,5995,-17300,-17300,980,0,0,1315663,False,0A32-806T-101E-EXC6
2dT8wujYgQ2VT3hm,1665668148,OkvajnSichovih,5399,5399,-49390,-49390,980,0,370,1332963,False,MMX5-5P9K-1P6K-META
KlIAkydVUsFfhRDt,1665667666,–ö–æ–ª–æ,5411,5499,-10050,-10050,980,0,75,1382353,False,PP42-2MK2-CPAK-EA2H
R1qMdG7xCCk9ZCK5,1665667556,PershaRestoraciyaShaurmi,5814,5814,-44700,-44700,980,0,335,1392403,False,P419-5CCC-34E0-K7EX
9SIM6N9oNy_XIaBz,1665664157,–ï–ø—ñ—Ü–µ–Ω—Ç—Ä,5200,5200,-209625,-209625,980,0,0,1437103,False,AXHE-TCMK-A893-CHK4
S5BhpQ-CNB4-NQ0H,1665662488,–ï–ø—ñ—Ü–µ–Ω—Ç—Ä,5912,5912,-25284,-25284,980,0,0,1646728,False,0XXA-2B8X-E8CB-MB9K
a23o4VXGk7T9ideF,1665661558,Under Armour,5655,5655,-135200,-135200,980,0,0,1672012,False,05PK-92BB-T74K-751K
TGspRqjV51mMtZBD,1665660780,–ú–∞—Ä–∞—Ñ–æ–Ω,5699,5941,-39900,-39900,980,0,0,1807212,False,PMHP-X857-5K34-EH3T
t50bNM_COsiFy4mY,1665656874,LIQPAY*Shine Bright,5977,5977,-105000,-105000,980,0,0,1847112,False,H3T4-129M-EXB9-24E3
nJ-YAVA3S6CEKAlO,1665656349,WFP.CLOTHIING,5651,5651,-27500,-27500,980,0,0,1952112,False,5587-BP6X-3X80-9C6K
iGwjm_1gJJ-60Axf,1665655828,Dodo Socks,5651,5651,-66000,-66000,980,0,0,1979612,False,254A-AE2T-X531-CHK1
nCG_yJmBaa3AMVK7,1665652542,–ü–æ–ø–æ–≤–Ω–µ–Ω–Ω—è ¬´–ù–∞ –ó—É–±–∞—Ç—ñ –õ–æ–ø–∞—Ç–∏¬ª,4829,4829,-12000,-12000,980,0,0,2045612,True,KAH0-EKE5-7HXE-3XM0
gBRPsCXQV9F5foEb,1665648020,–°—ñ–ª—å–ø–æ,5411,5411,-21900,-21900,980,0,219,2057612,False,C9T3-6BK7-B9B4-90MH
uTwYa2HcAGBsv7u0,1665646791,–ì–∞—Ä–º–æ–Ω–∏—è family,8062,8062,-16000,-16000,980,0,0,2079512,False,5PE8-47C3-MEP5-H05X
ybzKrZl7fnnIt5aX,1665645158,Kafe Right Coffee Bar,5814,5814,-11600,-11600,980,0,232,2095512,False,12AP-X5PH-339X-K030
tiUeF-xI1hepYUrW,1665588920,Kafe Right Coffee Bar,5814,5814,-51900,-51900,980,0,1038,2107112,False,E6MM-C906-BXKA-4XMC
tYQHAepaZZ3ta-LZ,1665582709,–í—ñ–¥: –í–ª–∞–¥–∏—Å–ª–∞–≤ –ß–æ—Ä–Ω–∏–π,–°–ø–ª—ñ—Ç,4829,4829,42100,42100,980,0,0,2159012,True
8zdd5YxpNedS-9iG,1665572074,–°—ñ–ª—å–ø–æ,5411,5411,-98987,-98987,980,0,989,2116912,False,P4AB-P7M3-C9A7-X3T0
7hvF_poUVO6Ir0kQ,1665557164,Bwtc cafe&roasters,5814,5814,-12000,-12000,980,0,240,2215899,False,0P21-7C1H-0E0X-A1ET
PxbZrsG9-nnci55b,1665556923,Bwtc cafe&roasters,5814,5814,-20000,-20000,980,0,400,2227899,False,41B2-CX7T-AMBH-8T14
_ltwG43er7WRG4Xq,1665506613,magazin 726008,5912,5912,-23789,-23789,980,0,0,2247899,False,P4KP-1EX6-A5K7-P17C
cGSbrUEtnRsTf9U0,1665504923,ZOOLYUKS,5995,5995,-72000,-72000,980,0,0,2271688,False,P74E-93H9-4C4M-5E39
K-3ri8TbVTwMTEDA,1665496015,5045Kavjarnja,5814,5814,-9000,-9000,980,0,180,2343688,False,450X-PE19-2XTM-T01K
pu1qMPAuY7vV6TDu,1665488145,Vodafone,4814,4814,-2000,-2000,980,0,0,2352688,False,X03M-CBTX-58P3-2T8X
fSpzfQYUBNFnof6X,1665484612,FOP Udala IaM,5814,5814,-7000,-7000,980,0,140,2354688,False,K554-XKCK-1HE6-6C5B
KmQc34VJZtv0uDmq,1665483291,Market delvi,5499,5499,-15000,-15000,980,0,150,2361688,False,P0HT-H232-247P-H9P1
_dMgtghIV9VQI0QO,1665480871,LIQPAY*mscover,5699,5699,-92000,-92000,980,0,0,2376688,False,CAHP-70E8-43BP-K1XC
-NUo3uZ7pKoWjiKz,1665470857,Kafe Right Coffee Bar,5814,5814,-12200,-12200,980,0,244,2468688,False,H1PC-A611-3X03-42MP
61W2S-tzNscWPI9s,1665469966,La fabrique,5814,5814,-23200,-23200,980,0,464,2480888,False,XCTT-5XB8-4CE9-1M73
R-oaWAJ6xGxCXg-P,1665415327,–ö–æ–ª–æ,5411,5499,-12100,-12100,980,0,121,2504088,False,E3X5-XE8X-0EPE-49H9
Y-h5Pnge7RDl7KIf,1665415102,PershaRestoraciyaShaur,5814,5814,-43800,-43800,980,0,876,2516188,False,77B8-63K2-BTA6-5KE9
lQv0Cfw8N-iOf5sL,1665402736,–£–∫—Ä–ø–æ—à—Ç–∞,9402,9402,-13629,-13629,980,0,0,2559988,False,83XB-AXPC-48K2-TA54
MXY4BjbHGVtt3HyL,1665395492,Bwtc cafe&roasters,5814,5814,-27000,-27000,980,0,540,2573617,False,TH66-C63B-B465-X3TE
ggbEoZZyz-A2uF7F,1665395184,La fabrique,5814,5814,-20200,-20200,980,0,404,2600617,False,7C4K-ETC6-0P3H-8TT2
PtBVYZEVm3Ev5eKz,1665391178,–ü–æ–ø–æ–≤–Ω–µ–Ω–Ω—è ¬´–ù–∞ –ø–æ–º—Å—Ç—É¬ª,4829,4829,-100000,-100000,980,0,0,2620817,True,KT6B-7K9A-92BT-3AK2
-fv5vwiCYdoaY77l,1665332578,Bwtc cafe&roasters,5814,5814,-24500,-24500,980,0,490,2720817,False,C85C-9A7X-AP68-E084
_UeUNzwm-HCpAEQc,1665310134,STORE J060 KYIV RETROV,5200,5200,-140000,-140000,980,0,0,2745317,False,XC54-6565-6563-H1X8
HgD8vRJqmMrR4RPg,1665309013,Fresh Dzhus end Babl T,5812,5812,-17600,-17600,980,0,352,2885317,False,334P-HEPB-9TK1-E3HT
rELF3K2K9aoO3QIP,1665308337,Fresh Dzhus end Babl T,5812,5812,-4500,-4500,980,0,90,2902917,False,X8C7-TKT3-T730-2P1K
GwYUcds1zSnU0WER,1665308190,Fresh Dzhus end Babl T,5812,5812,-22900,-22900,980,0,458,2907417,False,B5BB-1X35-4397-40HB
komIl0HjlbHbWOe8,1665307998,ITIS CAFE,5814,5814,-18700,-18700,980,0,374,2930317,False,020P-3CXM-MAH6-CTPB
kv9NXFV7ztFh34yf,1665306387,–°–∫–∞—Å—É–≤–∞–Ω–Ω—è. WOGPAY_G,5541,5541,24633,24633,980,0,0,2949017,False
ibO7oseea1jIf6hx,1665306299,WOGPAY_G,5541,5541,-153000,-153000,980,0,0,2924384,False
7Y_i4RzMCuO7n26g,1665303034,–¢–∞–±–∞–∫–µ—Ä–∫–∞,5993,5993,-60000,-60000,980,0,0,3077384,False,B01M-P6E6-X6K2-T1CB
bZJNW-fFnCLcmG30,1665298689,Kafe Right Coffee Bar,5814,5814,-16900,-16900,980,0,338,3137384,False,AHH4-9KX9-M3B6-3380
GNoQhcHrqTgPr0vO,1665246210,–ú–∞—Ä–≥–∞—Ä–∏—Ç–∞ –¢.,4829,4829,-400000,-400000,980,0,0,3154284,True,8P7A-3A11-2MB0-TAEM
Ah8ehCkRaQm0vkOY,1665245799,Novus,5411,5411,-22096,-22096,980,0,220,3554284,False,KPMP-7TM2-ATPM-9207
PvKDwb5SvsPsX_Jf,1665238984,Varvar bar,5812,5812,-22000,-22000,980,0,440,3576380,False,2E24-8MA1-1EBA-19HC
rA25FNE6wCRO3eu8,1665238906,Varvar bar,5812,5812,-41800,-41800,980,0,836,3598380,False,E088-7150-A0M7-06T5
rz7Rg8XIG1vFE-2m,1665238117,Novapay,8999,8999,-5000,-5000,980,0,0,3640180,False,CH90-0BEX-362H-16H7
DmLLlbxPZXecPGJT,1665218745,WFP.EDA,5811,5811,-10000,-10000,980,0,200,3645180,False,MTHX-E10H-A7M8-8A8E
kZ57acNHizPHbrLk,1665218716,SOPHIA HOTEL KYIV,7011,7011,-58000,-58000,980,0,0,3655180,False,0T86-319X-12PE-3EHE
cNgS4b9AeCmmfMbl,1665210019,Bwtc cafe&roasters,5814,5814,-11000,-11000,980,0,220,3713180,False,0ACE-X89A-K2C9-A27K
olCz5GdNaG9XHgRU,1665151963,Varcab,5814,5814,-27500,-27500,980,0,550,3724180,False,PE49-P3C3-94B3-PH7T
I0E1bb8Pu78iEigu,1665148014,MAGAZIN,5399,5399,-14600,-14600,980,0,146,3751680,False,EH09-E8KA-BM8B-KPEB
dQYoPY4E9VApMMqC,1665142648,–ü–æ–ø–æ–≤–Ω–µ–Ω–Ω—è ¬´–ø–∞—Ü–∏–∫–∞–º –Ω–∞ –∫–∞–ø—Ü—ñ¬ª,4829,4829,-200000,-200000,980,0,0,3766280,True,H0M7-MAKK-89TC-XA85
2Vn91wEpDqxY_Me1,1665137248,Bwtc cafe&roasters,5814,5814,-8000,-8000,980,0,160,3966280,False,1C10-XCH2-6HPA-45KP
hJqcU1qOsvENg2Se,1665137194,–ï–ª–µ–∫—Ç—Ä–æ—Å–∞–º–æ–∫–∞—Ç–∏ Bolt,7999,7999,-4908,-4908,980,0,0,3974280,False,56CK-5PPB-86HA-TC2K
D93YpdhT89NAErd0,1665136930,PROMIN,5651,5651,-46000,-46000,980,0,0,3979188,False,82E3-ME0B-6PMK-X58X
mmW0dP146GqYsqs3,1665136108,–°—ñ–ª—å–ø–æ,5411,5411,-53894,-53894,980,0,538,4025188,False,CECE-9EC3-BXBX-BT10
YzeHfJAGsmZVa4dP,1665135555,–ï–ª–µ–∫—Ç—Ä–æ—Å–∞–º–æ–∫–∞—Ç–∏ Bolt,7999,7999,-1242,-1242,980,0,0,4079082,False,5KPP-3160-PB9T-32EM
b-mlHZ7mIjIFd3bQ,1665128082,Bolt,4121,4121,-16200,-16200,980,0,0,4080324,False,ECMA-4M9X-80MX-PP45
E-J1TadTNXAmVQ4R,1665124247,La fabrique,5814,5814,-5500,-5500,980,0,110,4096524,False,T568-BX6B-C4X3-H8BP
CxJWmw4mHg1tw-ZH,1665123731,Bwtc cafe&roasters,5814,5814,-5500,-5500,980,0,110,4102024,False,H529-XKTK-0CXA-3H0A
tjdRJFBUt47x1w55,1665123114,545708****9727,4829,4829,-6000,-6000,980,0,0,4107524,True,X2T6-622T-KTBA-A05K
1d6i4OAvadlMeSMC,1665122979,–í–∏–¥–∞—á–∞ –≥–æ—Ç—ñ–≤–∫–∏ FOP KUDRINA-KUCHUGURNA,6010,6010,-54000,-54000,980,0,0,4113524,False,CA61-P7E9-XAA9-X1H3
MyuggOEzN2amFF6t,1665122118,Bolt,4121,4121,-16600,-16600,980,0,0,4167524,False,5648-53PA-8570-2HP3
cNXuPBgqGbjVd1VF,1665120813,–ë–∞–Ω–∫–æ–º–∞—Ç DN00 st.Sichovykh Stri,6011,6011,-100000,-100000,980,0,0,4184124,False,46X2-084K-B3CH-XMT5
cNPNFO2Gd3Unj9Iv,1665120760,–ë–∞–Ω–∫–æ–º–∞—Ç DN00 st.Sichovykh Stri,6011,6011,-100000,-100000,980,0,0,4284124,False,70XC-P757-E3KA-C103
4UayTCuqxDXmJ0np,1665120689,–ü–∏—Ä—ñ–∂–∫–æ–≤–∞ ¬´–¢—ñ—Ç–∫–∞ –ö–ª–∞—Ä–∞¬ª,5814,5814,-6500,-6500,980,0,130,4384124,False,694T-E8TC-32A8-70PX
3SPoLyl5vuF_G5oz,1665120651,–ë–∞–Ω–∫–æ–º–∞—Ç DN00 st.Sichovykh Stri,6011,6011,-100000,-100000,980,0,0,4390624,False,0XXH-1M5B-9PPP-067H
Yg1RjFqcC0U4jDjQ,1665082925,–ü–æ–ø–æ–≤–Ω–µ–Ω–Ω—è ¬´–ê–≤—Ç–æ –¥–ª—è —Ä–æ–∑–≤—ñ–¥–Ω–∏–∫—ñ–≤¬ª,4829,4829,-50000,-50000,980,0,0,4490624,True,EP14-7T48-XTC2-A1PP
4BCQ89Icv7jkVMKf,1665074243,414949****4948,4829,4829,-800000,-800000,980,0,0,4540624,True,C7K8-1BAC-E3KE-E731
nn3DbKSjwjYD_vXw,1665072224,–ö–æ–ª–æ,5411,5499,-6150,-6150,980,0,61,5340624,False,T37A-CA81-8XEE-CTPH
nmPVp4oeisCcGZtc,1665072045,–ï–∫–æ-–õ–∞–≤–∫–∞,5411,5499,-4400,-4400,980,0,44,5346774,False,20CE-7610-AE58-69K8
WEhkxQMamvK1EwOt,1665070763,Bwtc cafe&roasters,5814,5814,-10000,-10000,980,0,200,5351174,False,M3B3-T0P0-AC3B-2739
QPQdEWtyEVi7G5X0,1665061167,LIQPAY*PALMIRA,5411,5411,-72900,-72900,980,0,729,5361174,False,X1MA-4MT2-98K7-BKTK
2iGCyOzBaQR7OcME,1665059826,Lesya,–ù–∞ –∫–∏–ª–∏–º–∫–∏,4829,4829,-200000,-200000,980,0,0,5434074,True,P0CH-3A28-2TPE-3KPK
aJQOXlDVoJF8SlHd,1665053324,Bolt Food,4215,4215,-47400,-47400,980,0,0,5634074,False,E2A7-P9XT-2B1A-4095
cM-1EkXgOE2hZb_U,1665052358,LIQPAY*Radiokava,5411,5411,-49200,-49200,980,0,492,5681474,False,P7BC-2202-X81K-TC27
fg9gO83lLckJPYn3,1665037526,Kafe Right Coffee Bar,5814,5814,-13000,-13000,980,0,260,5730674,False,MB0E-7MKT-PA0A-84HC
PNCDSAq3eVmB0gMn,1664985821,–¢–∞–±–∞–∫–µ—Ä–∫–∞,5993,5993,-22500,-22500,980,0,0,5743674,False,963T-4477-XE87-T5T9
UDKkOdveHC2DyWqN,1664985766,Novus,5411,5411,-10827,-10827,980,0,108,5766174,False,3EXE-935H-3EAA-TCA8
axwmY1Gq4cu9Bkef,1664966782,Bwtc cafe&roasters,5814,5814,-8000,-8000,980,0,160,5777001,False,KKP9-8C0C-EE7M-CMC9
8ltaNoiT4BB8QwoK,1664966613,–ù–æ–≤–∞ –ø–æ—à—Ç–∞,4214,4214,-25600,-25600,980,0,0,5785001,False,5P1C-T8CE-C47E-CXK6
ovRWFG-p8VHA_dON,1664966351,Novus,5411,5411,-16626,-16626,980,0,166,5810601,False,04P1-2X90-XMC1-0HH8
tmO9hbfB-2_FY_OA,1664953583,Kafe Right Coffee Bar,5814,5814,-28500,-28500,980,0,570,5827227,False,T6HB-AXB6-EMXA-X933
lEb70iv-Mo_Dbpun,1664897255,ATL,5533,5533,-2640000,-2640000,980,0,0,5855727,False,31E8-6463-MT21-491M
FFdcxcCfUk1ccTF8,1664893053,MIKSMART,5499,5499,-6800,-6800,980,0,68,8495727,False,1CCB-85B8-705X-P2E3
XUl2JYysLeA5lS5z,1664890481,FDY*Food_SSL,5499,5499,-42500,-42500,980,0,425,8502527,False,MM01-HMK1-XTE3-5XB5
5LwnLe2Rrqbe3dtA,1664890314,–£–∫—Ä–ø–æ—à—Ç–∞,9402,9402,-1500,-1500,980,0,0,8545027,False,PC03-KPP5-EK68-04A4
cI-OhvPDX9vyE4OA,1664884001,–ü–æ–ø–æ–≤–Ω–µ–Ω–Ω—è ¬´–ù–∞ –∑–∏–º–æ–≤—ñ —Å–ø–∞–ª—å–Ω–∏–∫–∏.¬ª,4829,4829,-20000,-20000,980,0,0,8546527,True,P25A-H6XC-18A9-E1X0
n5Gsc1mOpGFPAbkK,1664875714,Lesya,4829,4829,-300000,-300000,980,0,0,8566527,True,78B9-X9P5-BK32-C5H8
CQtUiDvxwveljVue,1664874392,–ü–æ–ø–æ–≤–Ω–µ–Ω–Ω—è ¬´–ù–∞ –∞–≤—Ç–æ –¥–ª—è –¢–†–û¬ª,4829,4829,-400000,-400000,980,0,0,8866527,True,7P21-PT73-P09X-E9E8
YGpBwuAxArXBsn6E,1664873418,–íi–¥: –ü–†–ò–•–û–î–¨–ö–û –ï.–í. –§–û–ü,"–î–ª—è –ø–æ–ø–æ–≤–Ω–µ–Ω–Ω—è –∫–∞—Ä—Ç–∫–∏ 5375414101190360, –ü—Ä–∏—Ö–æ–¥—å–∫–æ –ï—Ä–Ω–µ—Å—Ç –íi–∫—Ç–æ—Ä–æ–≤–∏—á, 3487403339",4829,4829,8200000,8200000,980,0,0,9266527,True
iEJQO6dneIFdFx6-,1664867671,Kafe Right Coffee Bar,5814,5814,-11500,-11500,980,0,86,1066527,False,6P3E-K41K-9AC8-49B5
X3Gyy6vCohQa4AKQ,1664866357,Ponchyk Boy,5812,5812,-25200,-25200,980,0,189,1078027,True,CE06-2PBB-H05T-5CH4
CR2yxXibUGRhLtmL,1664865627,–ï–ª–µ–∫—Ç—Ä–æ—Å–∞–º–æ–∫–∞—Ç–∏ Bolt,7999,7999,-2525,-2525,980,0,0,1103227,False,X8X7-E992-8T1A-B9XE
gmTBIulBrFk5YeDM,1664864881,ZOOLYUKS,5995,5995,-96500,-96500,980,0,0,1105752,False,T67T-581X-B50X-4780
SsFNEdTMbhbt7xG-,1664814468,–ö–æ–ª–æ,5411,5499,-6400,-6400,980,0,48,1202252,False,3XA0-5KKX-EC5B-M3HX
HlnEO_daBjTkXpgP,1664813848,–ó–∞–º–æ–≤–ª–µ–Ω–Ω—è —ó–∂—ñ wayforpay,5814,5814,-27000,-27000,980,0,202,1208652,False,XP7X-87EA-CE88-XT1A
TcllhDRUMjrRAKxX,1664807309,Novapay,8999,8999,-5000,-5000,980,0,0,1235652,False,K4TT-7P16-X01P-XBTC
D2hbTZOSXLABle3I,1664802926,Novapay,8999,8999,-8500,-8500,980,0,0,1240652,False,PC39-1A6B-004A-74CX
axwmY1Oq6su9AkWa,1664792067,FDY*Food_SSL,5499,5499,-53500,-53500,980,0,401,1249152,False,51TC-7975-1MBM-8E88
wpfVPE-EUoMkQVRE,1664777973,Kafe Right Coffee Bar,5814,5814,-32900,-32900,980,0,246,1302652,False,2X35-62HE-19M7-3KAM
PPVFsxYtg5ws7gTSeSSc,1664747802,–°–∫–∞—Å—É–≤–∞–Ω–Ω—è. iPay.ua,8062,7399,83300,83300,980,0,0,1335552,False
xrkA-JuxZ0iRKtPN,1664733249,Novapay,8999,8999,-3500,-3500,980,0,0,1252252,False,2KK4-7K56-K6PP-A0X4
DiEzXhCcGh4Ei-ow,1664709842,Kitaika,5814,5814,-65600,-65600,980,0,492,1255752,False,8K91-0PM6-46B9-0MB5
Kd5LpPPuPEhxsMbj,1664709228,Mates,5812,5812,-31500,-31500,980,0,236,1321352,True,4BMH-E5HH-E0KK-A109
YWe3Rkp6KOOUs1gr,1664709128,Market delvi,5499,5499,-2890,-2890,980,0,21,1352852,False,MA48-2282-PBT3-53P8
ze0xOf9DKHHzfr_C,1664709028,Market delvi,5499,5499,-18560,-18560,980,0,139,1355742,False,CB9B-M878-3H9T-1P2K
tQNthY08BjoxpRJT,1664699579,–í—ñ–¥: –û–ª–µ—Å—è –°–∞—á–µ–Ω–∫–æ,–∑–∞ —à—Ç–∞–Ω—Ü—ñ,4829,4829,116180,116180,980,0,0,1374302,True
aVCf9aHEsPEXkkn7,1664698171,–ù–æ–≤–∞ –ø–æ—à—Ç–∞,7399,7399,-9200,-9200,980,0,0,1258122,False,597X-H23K-16H8-45XX
IEfe2BUuhfmTd085,1664698155,–ü—ñ—Å–ª—è–ø–ª–∞—Ç–∞ (–ù–æ–≤–∞ –ø–æ—à—Ç–∞),6538,6538,-120267,-120267,980,4067,0,1267322,False,H179-CKCP-0P7M-AX4A
2rtuHYTQ1JLqnnBE,1664697033,ProduktiJArVal19,5499,5499,-17200,-17200,980,0,0,1387589,False,800K-BT2X-3X88-E7AE
J1Xdo-xLhRQ6qame,1664696617,Suite13,5814,5814,-29000,-29000,980,0,0,1404789,False,E11E-KTXK-M30X-3KM7
71BIVoxqITT7g2CY,1664692475,Kafe Right Coffee Bar,5814,5814,-16100,-16100,980,0,0,1433789,False,M6CH-TPM8-CP0H-95EP
ZnbPvaKSCLdb_4Jn,1664690595,Novapay,8999,8999,-3800,-3800,980,0,0,1449889,False,X0M4-M5B2-92AB-5HB5
K23nG81qk3UmvPxz,1664689810,–ú–µ–¥–∏—á–Ω–∞ –ª–∞–±–æ—Ä–∞—Ç–æ—Ä—ñ—è ¬´–î—ñ–ª–∞¬ª,8062,8099,-83300,-83300,980,0,0,1453689,False,EKXK-063A-873C-3AK8
A-buZBpKLyHZEDoI,1664656341,LIQPAY*FOP Bidyuk Dmit,5399,5399,-50000,-50000,980,0,0,1536989,False,3998-BK5H-CH64-C81H
42d0q92MIfOq1lIf,1664634861,Novapay,8999,8999,-12000,-12000,980,0,0,1586989,False,XME9-A725-16K3-PT63
xN_jK_rf8O983FqU,1664621634,Novus,5411,5411,-18153,-18153,980,0,0,1598989,False,X7BC-1EK8-H4HB-AAH1
1hxSTZjKJcHV-N-O,1664621627,Novus,5411,5411,-14748,-14748,980,0,0,1617142,False,A76M-B7BE-5T4M-CBT3
R0C2_Pl_dZGvtwah,1664614392,iPay.ua,8062,7399,-83300,-83300,980,0,0,1631890,False
oCwDVpGRxIb0_Kay,1664611143,Portmone,4899,4899,-5500,-5500,980,0,0,1715190,False,0606-K9CA-1BT6-47CA
whzf3vrREfJ0xKfk,1664610014,Kafe Right Coffee Bar,5814,5814,-12900,-12900,980,0,0,1720690,False,7XB1-8TK4-EB9K-C2KC
zvIthsj2YgvpYtcP,1664609192,FOP Udala IaM,5814,5814,-51500,-51500,980,0,0,1733590,False,8X1M-60BE-35X8-0EBB
rv8nYdc_xKlenMqo,1664606402,–ù–æ–≤–∞ –ø–æ—à—Ç–∞,4214,4214,-25600,-25600,980,0,0,1785090,False,E5B6-80AH-51TC-947A
51NOBXSBUD4eIvhJ,1667116669,–ù–∞–¥—ñ—è –§.,4829,4829,-75000,-75000,980,0,0,1135249,True,H91B-5X52-K058-381K
TLL79BUlDAux_EPe,1667058496,–ü–æ–ø–æ–≤–Ω–µ–Ω–Ω—è ¬´–ù–∞ –ó–°–£!¬ª,4829,4829,-10000,-10000,980,0,0,1210249,True,HK4M-C8E8-26H8-94B3
grdcrQwmGJh661fg,1667022642,–ü–æ–ø–æ–≤–Ω–µ–Ω–Ω—è ¬´–ù–∞ –∑–∏–º–æ–≤—É –≥—É–º—É¬ª,4829,4829,-100000,-100000,980,0,0,1220249,True,MCBT-ATK2-PA16-4757
795p-2E8jDVGn8bb,1666951602,–ó –ø–ª–∞—Ç–∏–Ω–æ–≤–æ—ó –∫–∞—Ä—Ç–∫–∏,4829,4829,430000,430000,980,0,0,1320249,True
O01D0zbnF7XTo80G,1666802497,516875****0605,4829,4829,-130151,-130151,980,0,0,890249,True,1TCX-EPH3-7786-CMMC
R9_fjpEOklde5-p2,1666726559,Lesya,Sticky Pocket,4829,4829,-400000,-400000,980,0,0,1020400,True,83A6-064M-4AA6-T5A3
-6C6iEJJE3BLar7d,1666714237,Lesya,4829,4829,-15000,-15000,980,0,0,1420400,True,83H3-BCBC-CTA3-E9X8
EKQV1aPJklP7-wg5,1666608365,–ó –ø–ª–∞—Ç–∏–Ω–æ–≤–æ—ó –∫–∞—Ä—Ç–∫–∏,4829,4829,1000000,1000000,980,0,0,1435400,True
JdIt-ojTXPDWsmN4,1666605554,–ü–æ–ø–æ–≤–Ω–µ–Ω–Ω—è ¬´–ö—É–ª—å—Ç—É—Ä–Ω–∏–π Punisher¬ª,4829,4829,-10000,-10000,980,0,0,435400,True,6BA4-CKHK-EC43-TM6M
8UmJH8kzlQWInucH,1666116069,–ü–æ–ø–æ–≤–Ω–µ–Ω–Ω—è ¬´–ù–∞ –æ–±—ñ–≥—Ä—ñ–≤–∞—á—ñ¬ª,4829,4829,-100000,-100000,980,0,0,445400,True,M066-K0K0-6H04-40X6
xlHfdzVOwxX8-Kuu,1666099348,–ó –ø–ª–∞—Ç–∏–Ω–æ–≤–æ—ó –∫–∞—Ä—Ç–∫–∏,4829,4829,545400,545400,980,0,0,545400,True
SHoFtsZiRGxawxzP,1669751663,LIQPAY*Pethouse,5995,5995,-265500,-265500,980,0,0,1712171,False,27XT-T32K-11TC-7KHT
EDpTg_i2IhD8Nc_6,1669713984,Bwtc cafe&roasters,5814,5814,-34500,-34500,980,0,0,1977671,False,4KXE-A819-K67A-5054
2SSd-PO1ZOj5KbIb,1669705873,–û–±—Å–ª—É–≥–æ–≤—É–≤–∞–Ω–Ω—è –ø–ª–∞—Ç–∏–Ω–æ–≤–æ—ó –∫–∞—Ä—Ç–∫–∏,4829,4829,-30000,-30000,980,0,0,2012171,True
cpPv-c5serLH1muK,1669664286,Novapay,8999,8999,-8580,-8580,980,0,0,2042171,False,08CE-A096-2H1M-C1C8
r6zg-JF5XZ0X8yh6,1669664211,Novapay,8999,8999,-6000,-6000,980,0,0,2050751,False,M2K2-C437-3A1C-2996
lgYEMNpdMk8rAZEx,1669664151,Novapay,8999,8999,-24300,-24300,980,0,0,2056751,False,73BC-KX8C-2X47-53M9
KSIgyZksT8Q2eHWH,1669664132,Lesya,4829,4829,-100000,-100000,980,0,0,2081051,True,916A-4T69-K8XT-TTK7
wsFpZHfihmROR-SO,1669664102,Novapay,8999,8999,-15200,-15200,980,0,0,2181051,False,C78H-E9MX-0B51-200P
rOf4VdW3IRUIUiha,1669664039,–ü–µ—Ä–µ–∫–∞–∑ –Ω–∞ –∫–∞—Ä—Ç–∫—É,4829,4829,-1000000,-1000000,980,0,0,2196251,True
Y75vnaqMHDN08fLU,1669663949,Novapay,8999,8999,-4000,-4000,980,0,0,3196251,False,686H-7M6P-HTKB-P47X
ZgK5NlcLJ_pwRTP6,1669661926,LIQPAY*Vidavnictvo Art,5942,5942,-37000,-37000,980,0,0,3200251,False,B7T7-2AMB-C876-9E3K
G9WslOa1Prc792jx,1669651360,Novapay,8999,8999,-4000,-4000,980,0,0,3237251,False,8569-768B-4CH8-038E
5fdFgZRRCE18_Vbw,1669651356,Novapay,8999,8999,-35000,-35000,980,0,0,3241251,False,C28B-H5BK-P42P-X011
iOLirX9AFz05P7OG,1669644103,magazin 762597,5912,5912,-15660,-15660,980,0,0,3276251,False,28T8-54E8-9KTM-10CX
RHHZFEcDU2cKFOU5,1669643089,Novapay,8999,8999,-25600,-25600,980,0,0,3291911,False,T6XB-BC26-4A2T-CM95
alcakLjs5upF-8Ta,1669632805,–íi–¥: –ü–†–ò–•–û–î–¨–ö–û –ï.–í. –§–û–ü,"–î–ª—è –ø–æ–ø–æ–≤–Ω–µ–Ω–Ω—è –∫–∞—Ä—Ç–∫–∏ 5375414101190360, –ü—Ä–∏—Ö–æ–¥—å–∫–æ –ï—Ä–Ω–µ—Å—Ç –íi–∫—Ç–æ—Ä–æ–≤–∏—á, 3487403339",4829,4829,3300000,3300000,980,0,0,3317511,True
glc-OVO7qPYNG_rA,1669578723,WFP*COSMETICS1,5977,5977,-25200,-25200,980,0,0,17511,False,8114-6X50-XPH4-B06X
t3IOkr90sVgeVR5t,1669565306,Novapay,8999,8999,-6400,-6400,980,0,0,42711,False,1CCC-PH19-MXH5-A1C3
PHHY8B-CGrMz6Mfi,1669553835,magazin 726008,5912,5912,-84242,-84242,980,0,0,49111,False,M522-BTBK-44TA-AEX2
fovVOPyRGatGB9BP,1669553574,–°—ñ–ª—å–ø–æ,5411,5411,-70211,-70211,980,0,526,133353,False,004H-KK8H-CP41-TKEP
KJXloHowMJcHBQ7i,1669548129,HUMANS COFFEE IN TECH,5814,5814,-7500,-7500,980,0,0,203564,False,750A-XP06-K3C0-40XX
iMcu-kcrIUbeSAZZ,1669535596,CYSM PLT,5399,5399,-393276,-10504,840,0,2949,211064,False,53T7-P61C-45HH-3924
d6V7IbcLKhe_Gd_r,1669534504,Bwtc cafe&roasters,5814,5814,-5500,-5500,980,0,0,604340,False,41H3-X71A-2617-CB5M
9ZyXD9UOmAEatKzo,1669533202,LIQPAY*Pethouse,5995,5995,-203000,-203000,980,0,0,609840,False,70TX-P55K-2KK3-0CKK
xw3JZEi9mJ9stQJq,1669481696,Produkti,5499,5499,-18800,-18800,980,0,141,812840,False,16BK-65MX-MM1H-HK1K
6RBLMbiv-g0nXVIY,1669465090,Varcab,5814,5814,-44000,-44000,980,0,0,831640,False,66XT-H63E-AK7C-5B8P
q1myyzdalDqjT1ws,1669463935,Vodafone,4814,4814,-20000,-20000,980,0,0,875640,False,4P2X-3TC6-X1C4-6XAT
m05fu8pUTBjWw8VD,1669457744,–ù–æ–≤–∞ –ø–æ—à—Ç–∞,7399,7399,-4800,-4800,980,0,0,895640,False,M5CH-3288-PEBM-K50B
NS5H6XAXBc47zMLl,1669456024,–í—ñ–¥: –ë–æ–≥–¥–∞–Ω –ë—ñ–ª–æ—à–∏—Ü—å–∫–∏–π,4829,4829,233000,233000,980,0,0,900440,True
-3PVWPQP_tBwFi6b,1669450380,Bwtc cafe&roasters,5814,5814,-13500,-13500,980,0,0,667440,False,0TTH-P939-E7CT-XMBT
dAYDDXj8A7ehxc7z,1669398312,Novapay,8999,8999,-8000,-8000,980,0,0,680940,False,59PK-6H77-5X69-60M2
3eVhrIp_Vrcm-gHD,1669378254,–ê–ø—Ç–µ–∫–∞ –ê–ù–¶,5912,5912,-92450,-92450,980,0,0,688940,False,0H06-T3AP-5015-P4ME
QDwdQwKRB4XqnnEQ,1669377783,–¢–∞–±–∞–∫–µ—Ä–∫–∞,5993,5993,-30000,-30000,980,0,0,781390,False,XHBC-17T8-X6M5-5H24
QaBXYAAMxZM3U9Ze,1669377542,–ù–æ–≤–∞ –ø–æ—à—Ç–∞,4214,4214,-14300,-14300,980,0,0,811390,False,3B23-2AP0-AEHH-EAM9
VWXvdRrl2mozHbNp,1669363163,OKKO,5541,5541,-210789,-210789,980,0,0,825690,False,E4KH-50P5-H017-81M6
aR6Zh2urQIPPgxl1,1669310793,–°—ñ–ª—å–ø–æ,5411,5411,-15900,-15900,980,0,119,1036479,False,HT13-5PXK-67MP-M795
atRlRWZoe1PPO9s6,1669310712,–°—ñ–ª—å–ø–æ,5411,5411,-83043,-83043,980,0,622,1052379,False,3EC0-T29P-TP22-93T0
BxpueSc7Wg80IufW,1669310520,–°—ñ–ª—å–ø–æ,5411,5411,-93300,-93300,980,0,699,1135422,False,PE11-6PB3-EP84-5708
8G6Ny18SRm6aQL2h,1669295399,WFP.AQUAMARKET,5411,5411,-97300,-97300,980,0,729,1228722,False,MCBE-M2TA-A6H7-P7T4
B8eXssJQM9TDncdw,1669282272,MUZEJ 1,7991,7991,-273500,-273500,980,0,0,1326022,False,8TX2-481K-A1P1-B2C6
3fbdCtJmLvnv_L0V,1669219928,LIQPAY*T.C.Pizza,5812,5812,-38000,-38000,980,0,0,1599522,False,6PBX-T0M8-K890-26EM
wC58U_npgoauVDEy,1669189464,LIQPAY*Pethouse,5995,5995,-147600,-147600,980,0,0,1637522,False,KHH2-598H-KMB9-7X6B
wpYpb2QhL9RJD70V,1669187967,Novapay,8999,8999,-189500,-189500,980,0,0,1785122,False,C38P-C2T6-8CT5-2XM8
TYugtLt8vJsgyfG0,1669136826,–ê–ª—å—Ç—Ä—É—ó—Å—Ç,5812,5812,-46500,-46500,980,0,0,1974622,False,AH0T-P7K3-3P42-3T6K
CEk9dGSWBWhDTxg4,1669130231,One love coffee —Ü—É–º,7523,7523,-16000,-16000,980,0,0,2021122,False,7175-4607-C0P5-3CP2
9ji1qRZG2lsLRHcs,1669130016,–¶–£–ú –ö–∏–µ–≤,5651,5651,-95000,-95000,980,0,0,2037122,False,MXHP-MM76-E25B-KA43
2UeI105TdjajVlWT,1669124224,–ü–µ—Ä–µ–∫–∞–∑ –Ω–∞ –∫–∞—Ä—Ç–∫—É,4829,4829,-400000,-400000,980,0,0,2132122,True
9uyBgzi6pbjtVyrQ,1669110515,–íi–¥: –ü–†–ò–•–û–î–¨–ö–û –ï.–í. –§–û–ü,"–î–ª—è –ø–æ–ø–æ–≤–Ω–µ–Ω–Ω—è –∫–∞—Ä—Ç–∫–∏ 5375414101190360, –ü—Ä–∏—Ö–æ–¥—å–∫–æ –ï—Ä–Ω–µ—Å—Ç –íi–∫—Ç–æ—Ä–æ–≤–∏—á, 3487403339",4829,4829,1800000,1800000,980,0,0,2532122,True
kK5lTZfxJ8fmI1Vw,1669102758,Bwtc cafe&roasters,5814,5814,-53500,-53500,980,0,0,732122,False,K3KM-M5TK-E632-H10C
Y7tkHyhU-02KGKjs,1669069843,LIQPAY*FOP Bidyuk Dmit,5399,5399,-50000,-50000,980,0,375,785622,False,XC9B-04CP-M8A3-CXM6
k5O2xjjdPWROjdkh,1669052738,PHOPTitova,7230,7230,-194300,-194300,980,0,0,835622,False,2BTB-EMH9-B7A1-7X3A
px5st2pnMiaXXhS3,1669052679,PHOPTitova,7230,7230,-742000,-742000,980,0,0,1029922,False,HEMX-56XE-A961-X2TE
y18dgBLkgPNe7Aqg,1669051981,Produkti,5499,5499,-30000,-30000,980,0,225,1771922,False,3KH6-1AEP-C363-M066
9BJzsUiyZmJKIusb,1669036107,Kafe Right Coffee Bar,5814,5814,-10500,-10500,980,0,0,1801922,False,1C91-4H26-CX15-1540
KZZRofUtyU24uCg-,1669035928,–ü–∏—Ä—ñ–∂–∫–æ–≤–∞ ¬´–¢—ñ—Ç–∫–∞ –ö–ª–∞—Ä–∞¬ª,5814,5814,-16100,-16100,980,0,0,1812422,False,1814-E0X0-96MA-15AM
JanxVgcCp5uoWYaw,1669030026,LIQPAY*FunKeys,5045,5045,-200000,-200000,980,0,0,1828522,False,E8EC-4XXH-5T2M-515T
zLfwOXSdHduUlxkn,1669030005,–ü–µ—Ä–µ–∫–∞–∑ –Ω–∞ –∫–∞—Ä—Ç–∫—É,4829,4829,-900000,-900000,980,0,0,2028522,True
t7fLsUux9NMZSrUJ,1669029995,Lesya,4829,4829,-800000,-800000,980,0,0,2928522,True,X8X7-4032-TKHM-1692
7l8vCwz5SIXi8H7P,1669026907,–íi–¥: –ü–†–ò–•–û–î–¨–ö–û –ï.–í. –§–û–ü,"–î–ª—è –ø–æ–ø–æ–≤–Ω–µ–Ω–Ω—è –∫–∞—Ä—Ç–∫–∏ 5375414101190360, –ü—Ä–∏—Ö–æ–¥—å–∫–æ –ï—Ä–Ω–µ—Å—Ç –íi–∫—Ç–æ—Ä–æ–≤–∏—á, 3487403339",4829,4829,3200000,3200000,980,0,0,3728522,True
psMPR1FflPXlu-qZ,1669021822,"Lifecell
+380631692598",4814,4814,-20000,-20000,980,0,0,528522,True,086X-05T1-00MT-P4XK
dWNTMG0ASZRprZY7,1669017660,–ö–æ–ª–æ,5411,5499,-7500,-7500,980,0,56,548522,False,ATE8-56B2-2289-M6B9
KNoxpgov67biQRiV,1669015502,Bwtc cafe&roasters,5814,5814,-29500,-29500,980,0,0,556022,False,2H77-KK37-K0BE-5T10
TLX9Ggdla0yKQwFHBUUx,1668988266,"–°–∫–∞—Å—É–≤–∞–Ω–Ω—è. FDY*Shops_SSL,VUL. KRUGLOUNIVERSYTETSKA, 14,KYIV,UA",5631,5631,150000,150000,980,0,0,585522,True
NRkAkYKKmRj9vVNv,1668959918,–ö–æ–ª–æ,5411,5499,-2100,-2100,980,0,15,435522,False,B104-7CEB-2887-MBK9
vlGkmdXROsWjBxwC,1668959819,PershaRestoraciyaShaur,5814,5814,-24800,-24800,980,0,0,437622,False,E4MX-6KH8-TX9T-T532
G1mwV4S3bVcmI03r,1668955574,Master Zoo,5995,5995,-63000,-63000,980,0,3150,462422,False,4736-XXME-CCXT-T7PT
Z0pdbtZzfywFZnWH,1668955025,Fotovramke,5946,5946,-23000,-23000,980,0,0,525422,False,0CP3-5X0B-XB5X-4XAH
jsSLa2RWCUMf5gBz,1668936822,WFP.EDA,5811,5811,-9000,-9000,980,0,0,548422,False,X2T0-05E2-7CBK-8B4E
WvxRX0LG-9R5Syjr,1668936763,SOPHIA HOTEL KYIV,7011,7011,-91000,-91000,980,0,0,557422,False,94MH-HX4C-KAB6-9TB0
udgWAwn0CbDsS6PH,1668877004,KOMPLEX SOBICLUB,5814,5814,-79200,-79200,980,0,0,648422,False,B248-9P2C-819X-H7AP
WqvRxoBi54_co5JX,1668876976,–ó –±—ñ–ª–æ—ó –∫–∞—Ä—Ç–∫–∏,4829,4829,500000,500000,980,0,0,727622,True
nQuRKBiLv3ztbg9Q,1668871533,FDY*FOOD,5499,5499,-60000,-60000,980,0,450,227622,False,EB03-AE46-K968-MBK9
UT22Q5lxN7bI-T9i,1668864041,Yaroslaviv Val 37-1,5499,5499,-113000,-113000,980,0,847,287622,False,1C56-T847-9XK6-H8TA
nsLyctUTxvY3M_zd,1668844478,MagazinProdukti,5499,5499,-6700,-6700,980,0,50,400622,False,25K3-22M9-3B21-K9C9
1Je14RvuXKkrp03O,1668844237,–ö–æ–ª–æ,5411,5814,-22500,-22500,980,0,168,407322,False,TAM0-P407-T530-18C6
pSHmP689IqGDJc0_,1668841707,Bwtc cafe&roasters,5814,5814,-5500,-5500,980,0,0,429822,False,4657-8TCM-1273-E8P3
bdKbRTSCbxREIwqx,1668801677,–ö–∏—ó–≤ –¶–∏—Ñ—Ä–æ–≤–∏–π,4111,4111,-40250,-40250,980,0,0,435322,False,8HMP-C248-90H3-5K5C
mNK78g9Y4ZX0dl24,1668790577,Bwtc cafe&roasters,5814,5814,-15000,-15000,980,0,0,475572,False,T4T7-T5B9-68PA-588B
RiIP7UySq1LLcxde,1668790249,–ù–æ–≤–∞ –ø–æ—à—Ç–∞,7399,7399,-5300,-5300,980,0,0,490572,False,EA55-2C5P-6CE9-3XM1
qEalYpNXF1leosq5,1668776876,FOP Naudzhiute Li,5814,5814,-70000,-70000,980,0,0,495872,False,K213-BTK7-08PB-1M84
ExYAXETU3XDVeOh_,1668774176,Kafe Right Coffee Bar,5814,5814,-11600,-11600,980,0,0,565872,False,TT18-M6MH-XX4B-5KM9
aspjj4Ck47RHlxr4,1668773944,–ö–æ–ª–æ,5411,5499,-11450,-11450,980,0,85,577472,False,2T02-TTCC-K4E1-99EH
V69hOjztKHpNHqYz,1668773829,PershaRestoraciyaShaurmi,5814,5814,-28700,-28700,980,0,0,588922,False,HT1M-1T68-779T-BTPM
r0ge24rZj7_GGyj2,1668756332,Bwtc cafe&roasters,5814,5814,-14500,-14500,980,0,0,617622,False,18A7-B4K6-3P0K-X065
B_K5NEJ3u-5oa8LA,1668711259,Etsy,5699,5699,-123367,-3295,840,0,0,632122,False,B083-075T-5B5B-0552
Rc6TW7nXOa7NGi0D,1668686191,AVANGARDEN,5812,5812,-44700,-44700,980,0,0,755489,True,1M3K-AME4-668A-455P
sw4ZoingCGost95s,1668668808,Bwtc cafe&roasters,5814,5814,-5500,-5500,980,0,0,800189,False,EMT9-BHB5-1879-48AK
-9QDpFgsfGMIBvcU,1668618168,–°—ñ–ª—å–ø–æ,5411,5411,-52508,-52508,980,0,393,805689,False,10KX-4347-8B5A-3B25
Y4JRocEj7ES3iQ_f,1668611306,Novapay,8999,8999,-25600,-25600,980,0,0,858197,False,P952-8MME-94ET-TH0E
bhOU53f1qb-tz6n0,1668607438,–ü–∏—Ä—ñ–∂–∫–æ–≤–∞ ¬´–¢—ñ—Ç–∫–∞ –ö–ª–∞—Ä–∞¬ª,5814,5814,-16000,-16000,980,0,0,883797,False,B980-2013-089H-B9M0
0ok7ojwUyJHfrGr-,1668607359,–ê–ø—Ç–µ–∫–∞ –ê–ù–¶,5912,5912,-47990,-47990,980,0,0,899797,False,1XKT-4E41-1A04-CA75
b9TD7lv1x9hDSmyj,1668607161,–ö–æ–ª–æ,5411,5499,-25200,-25200,980,0,189,947787,False,K499-KKKE-M3MA-TC99
nBjdd9m0gXGV6a1L,1668594214,Bolt Food,4215,4215,-95140,-95140,980,0,0,972987,False,55AC-BT0H-0TC5-550C
sIJAv6Tt8rnoY_22,1668584267,Kafe Right Coffee Bar,5814,5814,-5000,-5000,980,0,0,1068127,False,90HT-5805-P9H1-816A
f4OJo1h-_zgVZuS7,1668531904,–°—ñ–ª—å–ø–æ,5411,5411,-34687,-34687,980,0,260,1073127,False,AHMB-A008-P0AM-9C8A
jEfhZJCaw35G_G9L,1668520149,OkvajnSichovih,5399,5399,-143470,-143470,980,0,1076,1107814,False,HE2M-C505-0856-2KXB
9ZAIJRp6uxd9ZsPX,1668519190,AVANGARDEN,5812,5812,-81000,-81000,980,0,0,1251284,True,63CP-7CXK-E616-C308
hmInD7IkZg5BPk3i,1668513013,LIQPAY*Pethouse,5995,5995,-59000,-59000,980,0,0,1332284,False,KETK-92B0-X2C5-2703
C-dH3hdbkT3Tn0LQ,1668499804,Coffeereligia,5812,5812,-13100,-13100,980,0,0,1391284,False,KBK3-1PHT-MH9C-E507
Q9sMG67JrUPpSxzo,1668499631,Master Zoo,5995,5995,-17500,-17500,980,0,875,1404384,False,K7C3-CEB4-4HX2-1H2K
aWJKgVT5eU-vtPLx,1668462394,Etsy,5699,5699,-217043,-5797,840,0,0,1421884,False,8KT5-3ACP-9XB0-8HPB
krFh0K0yhJKhzsUl,1668453525,LIQPAY*Pethouse,5995,5995,-147600,-147600,980,0,0,1638927,False,6MCM-X124-H4HT-6C9C
ViIwnkuZ0_zl0p2M,1668449747,Zygzag,5812,5812,-5000,-5000,980,0,0,1786527,False,T7A9-M9CP-K6BM-MK90
NdBCXKgTNBlyEulO,1668449725,Zygzag,5812,5812,-48500,-48500,980,0,0,1791527,False,E325-X332-T195-2K16
CEo1FEZ2nZmPmizq,1668445775,PHOPTitova,7230,7230,-36000,-36000,980,0,0,1840027,False,04PC-PCP1-78T4-6B78
T-UH7Hr9iHM3J7iy,1668443094,WOG,5541,5541,-155584,-155584,980,0,0,1876027,False,T7X0-2E43-K286-9464
PHKV6u_I57cxsF5M,1668435183,–ö–æ–ª–æ,5411,5499,-38550,-38550,980,0,385,2031611,False,2P18-8C77-47C5-513K
8GX8ygdzsL3geP99,1668435062,PershaRestoraciyaShaurmi,5814,5814,-28700,-28700,980,0,0,2070161,False,140P-B26M-7K2A-TTCH
Tx754BZRKL2-Xa1I,1668426741,–ü–µ—Ä–µ–∫–∞–∑ –Ω–∞ –∫–∞—Ä—Ç–∫—É,4829,4829,-100000,-100000,980,0,0,2098861,True
zGAcktTGl4dEjyxn,1668426691,–°—ñ–ª—å–ø–æ,5411,5411,-18709,-18709,980,0,187,2198861,False,9120-18EM-3874-MMKK
IRkGN2XV15yElh4j,1668422721,–íi–¥: –ü–†–ò–•–û–î–¨–ö–û –ï.–í. –§–û–ü,"–î–ª—è –ø–æ–ø–æ–≤–Ω–µ–Ω–Ω—è –∫–∞—Ä—Ç–∫–∏ 5375414101190360, –ü—Ä–∏—Ö–æ–¥—å–∫–æ –ï—Ä–Ω–µ—Å—Ç –íi–∫—Ç–æ—Ä–æ–≤–∏—á, 3487403339",4829,4829,1800000,1800000,980,0,0,2217570,True
acNIXMq6g2qpVjJ9,1668412867,5045Kavjarnja,5814,5814,-3900,-3900,980,0,0,417570,False,6HAE-C1HM-X052-4T41
N2goje6B0vRTc4EB,1668362973,Bwtc cafe&roasters,5814,5814,-7000,-7000,980,0,0,421470,False,75HE-1HBX-EKA9-743B
skz-lZR2yoVQrx1p,1668362954,BWTC,5814,5814,-30000,-30000,980,0,0,428470,False,7736-PBK7-9MXX-BTX7
rtYk7F7Y2kJPRrAj,1668360787,AVANGARDENGaleryandwin,5814,5814,-64500,-64500,980,0,0,458470,False,12K9-3666-EKC4-KT0A
QmwEC99FeQX-MaFc,1668350371,–ü–∞—Ä–∫–æ–≤–∫–∞,7523,7523,-12000,-12000,980,0,0,522970,False,2BP8-9HK5-7EXP-XH9P
u65y1PX-Jkp5nHqQ,1668350048,SALON BACKSTAGE,7230,7230,-309000,-309000,980,0,0,534970,False,H9P7-8A37-4TPE-6BK6
1G1VzmGxFBQ5zm_s,1668333424,Bwtc cafe&roasters,5814,5814,-4500,-4500,980,0,0,843970,False,2B90-BMM3-55C9-B14P
_d47byr2x3nu_XFZ,1668333384,BWTC,5814,5814,-30000,-30000,980,0,0,848470,False,B429-2PTT-6C0H-3KT1
P4SzKel0yGaXs26k,1668333255,Bwtc cafe&roasters,5814,5814,-32000,-32000,980,0,0,878470,False,6X2K-9HP4-AE43-15KE
ZZL1FxhmUY62_Xu7,1668330382,magazin 726008,5912,5912,-42550,-42550,980,0,0,910470,False,TB20-79P6-HH6C-E1XM
K0TzyK39A2WMnJGc,1668330145,–ï–ª–µ–∫—Ç—Ä–æ—Å–∞–º–æ–∫–∞—Ç–∏ Bolt,7999,7999,-2159,-2159,980,0,0,953020,False,AE3C-B508-2T9P-M2P7
Di2zNCIMFq-o8cwK,1668329108,ZOOLYUKS,5995,5995,-39520,-39520,980,0,0,955179,False,E234-M01C-PX86-78PE
VBeGmhkR4yyC0ku9,1668269384,–í—ñ–¥: –ë–æ–≥–¥–∞–Ω –ë—ñ–ª–æ—à–∏—Ü—å–∫–∏–π,4829,4829,300000,300000,980,0,0,994699,True
0tLdsXwyQVa3QaaX,1668267592,FDY*Food_SSL,5499,5499,-115720,-115720,980,0,867,694699,False,6AHB-419X-A79P-MX95
Y1gGFBU7It15LQmX,1668266231,MUZEJ 1,7991,7991,-57500,-57500,980,0,0,810419,False,T583-08K4-ACA1-A08T
R316GUw5eexXoFL4,1668265602,MUZEJ 1,7991,7991,-351900,-351900,980,0,0,867919,False,HTM1-T0C7-M8MM-T22E
xrqT5Vv7YGgQ2bVV,1668259538,–í—ñ–¥: –û–ª–µ—Å—è –°–∞—á–µ–Ω–∫–æ,4829,4829,75500,75500,980,0,0,1219819,True
Hor0-a3HWnyV7g6Y,1668247859,–ù–æ–≤–∞ –ø–æ—à—Ç–∞,4214,4214,-75500,-75500,980,0,0,1144319,False,KBE6-579B-8CE0-0ETE
nHcYNo3f5ewXsnTu,1668240791,Kafe Right Coffee Bar,5814,5814,-11200,-11200,980,0,0,1219819,False,37H1-446B-5P0P-EHB7
5IRPQY-v-LesY3qL,1668186628,Yaroslaviv Val 37-1,5499,5499,-96990,-96990,980,0,727,1231019,False,E07A-PBTM-4PAC-0TPK
pNfYVO5oZmPzlCYq,1668174895,MestoTorgovli,7991,7991,-12000,-12000,980,0,0,1328009,False,31EB-HXAM-CC0E-H625
P29D6HPXnBU5dTzt,1668166039,LIQPAY*O.TAJE,5651,5651,-223900,-223900,980,0,0,1340009,False,PK04-5667-BTB2-K672
zfBXSRchcmi37c_X,1668164564,–ö–æ–ª–æ,5411,5499,-2350,-2350,980,0,17,1563909,False,XET9-24X7-4TKM-M1EM
U1uGjfSP7Jn-Krkg,1668164456,–ö–æ–ª–æ,5411,5499,-22290,-22290,980,0,167,1566259,False,6456-745A-P07X-9P86
Fb5rIK6x41snEZ_z,1668154903,Bwtc cafe&roasters,5814,5814,-18500,-18500,980,0,0,1588549,False,KXA3-M4P6-987C-6CME
lswb4DfbquuaQno4,1668101158,–ö–∏—ó–≤ –¶–∏—Ñ—Ä–æ–≤–∏–π,4111,4111,-17500,-17500,980,0,0,1607049,False,23HT-HHA4-T029-0TX3
spZMRxaKQT4NN3oB,1668089727,–ö–æ–ª–æ,5411,5499,-3650,-3650,980,0,27,1624549,False,H8KT-TA39-KE03-E2X0
cxSh0CMK3p6r1Gli,1668089569,PershaRestoraciyaShaurmi,5814,5814,-20800,-20800,980,0,0,1628199,False,2MA6-C4C2-B1CB-PXM2
jJc4dAwWYy5SGVrn,1668073517,–°—ñ–ª—å–ø–æ,5411,5411,-13084,-13084,980,0,98,1648999,False,MC3P-4PKA-7M9B-1M1X
WWyB750DbCm1WQzN,1668070308,–í—ñ–¥: –ú–∏–∫–æ–ª–∞ –û–≥–æ–π–∫–æ,üçïüçïüçï,4829,4829,45800,45800,980,0,0,1662083,True
Yk_Uxu0DucMyKFSo,1668068906,Kafe Right Coffee Bar,5814,5814,-18200,-18200,980,0,0,1616283,False,AH8P-1EEX-36X3-1HK0
wU9RqZUlfNJjYwTU,1668068602,MasterZoo,5995,5995,-47250,-47250,980,0,2362,1634483,False,H79T-5H85-TTAE-E22T
0OOGSqCCVdWnWDW1,1668068267,Beer Market,5921,5921,-56700,-56700,980,0,425,1681733,False,2E81-61H4-2MTH-7TC5
-QSCQpqaKnxUtVkH,1668067314,parking,7523,7523,-6000,-6000,980,0,0,1738433,False,3TE0-7K2T-890B-07TB
yVD8qDnut-q6AWIT,1668066283,CAFE COFFEERELIGIA,5812,5812,-12000,-12000,980,0,0,1744433,False,7HM1-ECB6-C7EK-K9M1
2SxJncoJlDw8Yfib,1668066162,Salateira,5814,5814,-8900,-8900,980,0,0,1756433,False,H9EH-2EH9-76C7-3ET7
MBuiB8BFG-JNCE41,1668019363,t.c.pizza,5812,5812,-212200,-212200,980,0,0,1765333,True,6397-X172-5B9C-KH77
El_xkbzmlrzodAJd,1668013376,MIKSMART,5499,5499,-15000,-15000,980,0,0,1977533,False,9X7B-5BKC-38EB-0KT6
bqpzFqFIWsNlv8wx,1667988395,Produkti,5499,5499,-7300,-7300,980,0,0,1992533,False,K758-511H-3P59-HEMA
GvxcX8imZrnA6rUR,1667980287,La fabrique,5814,5814,-20800,-20800,980,0,0,1999833,False,5H1P-176X-XXK4-CTCX
kROqc6JY98LUkaup,1667936957,–û–±—Ä–∞–∑–æ–≤–∞–Ω–∏–µ,8299,8299,-65000,-65000,980,0,0,2020633,False,B5KP-2X3B-H783-1BH7
Bev3Rr_B3UeynIae,1667932837,OkvajnSichovih,5399,5399,-42060,-42060,980,0,0,2085633,False,4H4B-3HMB-990B-94BB
C5YHG7EVZzy9IfOF,1667931266,FDY*Food_SSL,5499,5499,-38500,-38500,980,0,0,2127693,False,C763-2X4M-MKA3-H76C
RAmwpHqzCIqVrzK7,1667908046,–ü–µ—Ä–µ–∫–∞–∑ –Ω–∞ –∫–∞—Ä—Ç–∫—É,4829,4829,-400000,-400000,980,0,0,2166193,True
zh1JU2-bYoQgMUPN,1667905737,Vodafone,4814,4814,-14000,-14000,980,0,0,2566193,False,1ABX-493E-9B2B-2684
AMNiSbvwZytt7heb,1667899536,Kafe Alpaka,5814,5814,-25000,-25000,980,0,0,2580193,False,BP58-BH3X-TEAE-8T03
BRmRO-6OSFmng6f0,1667894255,Produkti,5499,5499,-22500,-22500,980,0,0,2605193,False,5T27-H0B8-72KA-TA1H
DN5_0oBeB54yzMHC,1667892917,La fabrique,5814,5814,-11000,-11000,980,0,0,2627693,False,A118-MP7K-4X02-BEBP
6f-lzX-D9KC9nynC,1667892711,Bwtc cafe&roasters,5814,5814,-11000,-11000,980,0,0,2638693,False,047T-4KX2-8326-76AX
0UAdvIx9jDkZ-2-y,1667824471,Kafe Right Coffee Bar,5814,5814,-11600,-11600,980,0,0,2649693,False,84TP-12AE-6B03-T297
DIFX0G33Jw1G6vcn,1667824160,–ü–∏—Ä—ñ–∂–∫–æ–≤–∞ ¬´–¢—ñ—Ç–∫–∞ –ö–ª–∞—Ä–∞¬ª,5814,5814,-15500,-15500,980,0,0,2661293,False,E05T-E0TM-M8P6-17AA
-JoTId_aTl9bS3JS,1667817794,–°—ñ–ª—å–ø–æ,5411,5411,-21786,-21786,980,0,0,2676793,False,7CEX-7XAX-1B2M-5548
XNgc6-Ea1TgtdwhV,1667812902,–íi–¥: –ü–†–ò–•–û–î–¨–ö–û –ï.–í. –§–û–ü,"–î–ª—è –ø–æ–ø–æ–≤–Ω–µ–Ω–Ω—è –∫–∞—Ä—Ç–∫–∏ 5375414101190360, –ü—Ä–∏—Ö–æ–¥—å–∫–æ –ï—Ä–Ω–µ—Å—Ç –íi–∫—Ç–æ—Ä–æ–≤–∏—á, 3487403339",4829,4829,2200000,2200000,980,0,0,2698579,True
sVZy2m7AowKHSdkS,1667808243,parking,7523,7523,-6000,-6000,980,0,0,498579,False,CTTT-TEX2-2K5B-4956
KEQkD-BrU_RLA2Yr,1667807899,CAFE COFFEERELIGIA,5812,5812,-9300,-9300,980,0,0,504579,False,7CPK-7P17-EA3A-A645
qwT4vNeKQHcAA0co,1667803225,Bwtc cafe&roasters,5814,5814,-19000,-19000,980,0,0,513879,False,6H57-8T5T-BHKH-XCBK
xslZdulnRyfTFfIl,1667746818,ZOOLYUKS,5995,5995,-102060,-102060,980,0,0,532879,False,X0X2-9C3A-35P7-HC3A
krvaDBdlk_01Bc7j,1667745171,Bolt,4121,4121,-5100,-5100,980,0,0,634939,False,5C0X-991X-MK33-9AT7
GetBn6AcdDKpr7gy,1667742159,iPay.ua,4900,4900,-192940,-192940,980,0,0,640039,False,T90P-KCHH-CP07-89CC
uOcJqrKgTGMa4eQN,1667741721,Bolt,4121,4121,-5300,-5300,980,0,0,832979,False,KA85-KM6M-2801-6T9E
j27nq5fhHzubmjam,1667739181,BROEN,5812,5812,-71500,-71500,980,0,0,838279,True,KTA5-A058-HB26-MXK7
D62vuRQwMjJRU4lT,1667734569,OkvajnSichovih,5399,5399,-21500,-21500,980,0,0,909779,False,HC8M-6K59-XA3T-5H7A
NLoo96EEima0xG55,1667733995,OG BURGER,5812,5812,-31000,-31000,980,0,0,931279,False,6AXP-AMK1-X903-EMT3
9DmlC0Oo0Lq75qwr,1667727880,–°—ñ–ª—å–ø–æ,5411,5411,-10900,-10900,980,0,0,962279,False,E2BP-HAK8-HA3T-X7XC
vy4sEPfeuvBsA4_3,1667723895,Bwtc cafe&roasters,5814,5814,-16500,-16500,980,0,0,973179,False,B99A-TE68-24MK-807H
Pfpr68toPA9bNy6S,1667668842,MAGAZIN,5399,5399,-6700,-6700,980,0,0,989679,False,P8E6-8518-BTPH-2BHP
PNlPmqwC1WWB8C4n,1667646793,–°—ñ–ª—å–ø–æ,5411,5411,-228020,-228020,980,0,0,996379,False,1XC5-7EA2-38EX-A1M1
v127IZ62hVEF8uUM,1667638964,–ù–æ–≤–∞ –ø–æ—à—Ç–∞,7399,7399,-21300,-21300,980,0,0,1224399,False,24EC-25PE-A312-2MPP
KuyfvnMUGXCBsHeh,1667635235,Bwtc cafe&roasters,5814,5814,-13500,-13500,980,0,0,1245699,False,AMK6-686X-2H7H-3MHX
mKOSmWHqIcCDtb_B,1667573879,Novapay,8999,8999,-25600,-25600,980,0,0,1259199,False,A1TX-2TB4-21BM-MH52
_WFM5DoAlfmbHB6v,1667572175,Beer Market,5921,5921,-76853,-76853,980,0,0,1284799,False,7360-E4H9-6865-MPMB
PflocPiS3iSAjMRF,1667569986,–°—ñ–ª—å–ø–æ,5411,5411,-4199,-4199,980,0,0,1361652,False,9231-TA95-H467-03M8
yqwArwzKUZ495IP-,1667569239,DOWNTOWNNAILS,7230,7230,-45000,-45000,980,0,0,1365851,False,TH56-XPC4-E005-EM84
XlzJ-BAi-GFHwQWh,1667564662,–ï–ª–µ–∫—Ç—Ä–æ—Å–∞–º–æ–∫–∞—Ç–∏ Bolt,7999,7999,-2297,-2297,980,0,0,1410851,False,6555-X16B-E84K-T5HP
FJduakKlZrd5e4av,1667563515,Rozetka,5722,5732,-249800,-249800,980,0,0,1413148,False,5410-M2B5-350M-P3PM
Js3Pt7FQiMi3wV1r,1667556101,–ö–æ–ª–æ,5411,5499,-7950,-7950,980,0,0,1662948,False,25HH-7M1K-KTA1-HCA9
3ZZeUpC-lDbVqsG4,1667545722,Bwtc cafe&roasters,5814,5814,-11500,-11500,980,0,0,1670898,False,7MHH-T525-0610-9A77
_iMKzJGJXj1QJzLB,1667492719,ZoomagazinMikkiFamily,5995,5995,-49200,-49200,980,0,0,1682398,False,59B3-286A-EPBC-CEB2
Pc_cPRbwIXrKJhQg,1667482118,–ü–∏—Ä—ñ–∂–∫–æ–≤–∞ ¬´–¢—ñ—Ç–∫–∞ –ö–ª–∞—Ä–∞¬ª,5814,5814,-16000,-16000,980,0,0,1731598,False,0HH0-4P24-8115-HEP7
otT_NtsQbJgd4i25,1667481993,–ê–ø—Ç–µ–∫–∞ –ê–ù–¶,5912,5912,-67520,-67520,980,0,0,1747598,False,3X25-381X-6AEA-A5X1
8mMQzSK-sOMltAWq,1667460921,CAFE COFFEERELIGIA,5812,5812,-9000,-9000,980,0,0,1815118,False,33M6-6X35-P5P4-6X7B
qHxv-Ytuu9gX2l__,1667458269,Produkti,5499,5499,-22500,-22500,980,0,0,1824118,False,9CA7-8KH0-3479-93MC
kgA5VfVa1fUtvDMp,1667411976,Off-Grid Knives,5941,5941,-235876,-6300,840,0,0,1846618,False,X7E2-4BHX-8A27-3TC1
Qd4QqqXWt9UzqYqh,1667411922,–ü–µ—Ä–µ–∫–∞–∑ –Ω–∞ –∫–∞—Ä—Ç–∫—É,4829,4829,-200000,-200000,980,0,0,2082494,True
UfQnF3YUkc0aa6g6,1667399463,Kafe Right Coffee Bar,5814,5814,-22500,-22500,980,0,0,2282494,False,22AE-0HMK-H01X-6089
VxQoLRTc7bgpblg4,1667379151,FOP Sturova AS,5814,5814,-33000,-33000,980,0,0,2304994,False,HE5T-BM55-B2CM-3105
J9VDDQfpIm9KXCZ1,1667317743,–ü–µ—Ä–µ–∫–∞–∑ –Ω–∞ –∫–∞—Ä—Ç–∫—É,4829,4829,-1800000,-1800000,980,0,0,2337994,True
z9D2zP-E9zlJ1WK_,1667308836,–íi–¥: –ü–†–ò–•–û–î–¨–ö–û –ï.–í. –§–û–ü,"–î–ª—è –ø–æ–ø–æ–≤–Ω–µ–Ω–Ω—è –∫–∞—Ä—Ç–∫–∏ 5375414101190360, –ü—Ä–∏—Ö–æ–¥—å–∫–æ –ï—Ä–Ω–µ—Å—Ç –íi–∫—Ç–æ—Ä–æ–≤–∏—á, 3487403339",4829,4829,4000000,4000000,980,0,0,4137994,True
nIrPbIXB_a-LBXnv,1667300848,Bolt Food,4215,4215,-52500,-52500,980,0,0,137994,False,6BKX-EEPX-K5T7-X171
v5c1qfuY0-E29y57,1667287207,Bwtc cafe&roasters,5814,5814,-14500,-14500,980,0,0,190494,False,XM9C-K3K4-22X8-HMHA
7CohMviyKVf9QvMd,1669753376,Lesya,4829,4829,-200000,-200000,980,0,0,1950452,True,9A4A-EKBA-0X44-4M99
nqN8dUuiScYm3n2M,1669664039,–ó –ø–ª–∞—Ç–∏–Ω–æ–≤–æ—ó –∫–∞—Ä—Ç–∫–∏,4829,4829,1000000,1000000,980,0,0,2150452,True
-oW7rdajcnQYVGF9,1669518970,–†–µ–≥—É–ª—è—Ä–Ω–µ –ø–æ–ø–æ–≤–Ω–µ–Ω–Ω—è ¬´–§–æ–Ω–¥ –ü–æ–≤–µ—Ä–Ω–∏—Å—å –∂–∏–≤–∏–º¬ª,4829,4829,-25000,-25000,980,0,0,1150452,True
t03-65_FXieFkq-e,1669369616,–û–ª–µ–∫—Å–∞–Ω–¥—Ä –°.,üêï,4829,4829,-130000,-130000,980,0,0,1175452,True,E905-PE65-PHCA-2278
MotDo8mB3qN7J9mR,1669368231,"–ö–∏—ó–≤—Å—Ç–∞—Ä
+380679992233",4814,4814,-20000,-20000,980,0,0,1305452,True,T6C0-9C2C-2C73-115A
58QcerXvW9eMOqf4,1669215267,–ü–æ–ø–æ–≤–Ω–µ–Ω–Ω—è ¬´–ù–∞ –≥–≤–∏–Ω—Ç—ñ–≤–∫—É –¥–ª—è –ó–°–£¬ª,üî´,4829,4829,-50000,-50000,980,0,0,1325452,True,5325-K706-82BE-T822
iOzPC9zIQJAPJz8T,1669196250,Lesya,4829,4829,-100000,-100000,980,0,0,1375452,True,A440-5H53-9048-1MH5
X8OeQnQ09LVrxjS4,1669133669,–ï–º—ñ–ª—ñ—è –®.,–û–ª–µ—Å—è,4829,4829,-65000,-65000,980,0,0,1475452,True,M4TE-X9AK-X9K4-A402
25TFHdeoV-fkSiXC,1669124224,–ó –ø–ª–∞—Ç–∏–Ω–æ–≤–æ—ó –∫–∞—Ä—Ç–∫–∏,4829,4829,400000,400000,980,0,0,1540452,True
UCyV3Ty6Q4VbOLN-,1669124116,–ü–æ–ø–æ–≤–Ω–µ–Ω–Ω—è ¬´–ù–∞ –∫–∞–ø—Ü—ñ¬ª,4829,4829,-150000,-150000,980,0,0,1140452,True,17BE-881H-045H-724K
areA8ALVRpqKnrBX,1669030006,–ó –ø–ª–∞—Ç–∏–Ω–æ–≤–æ—ó –∫–∞—Ä—Ç–∫–∏,4829,4829,900000,900000,980,0,0,1290452,True
Qwh6SqSHOeMj4XcS,1669021267,–ü–æ–ø–æ–≤–Ω–µ–Ω–Ω—è ¬´–ù–∞ –º–∞—Å–∫—É–≤–∞–ª—å–Ω—ñ —Å—ñ—Ç–∫–∏¬ª,4829,4829,-10000,-10000,980,0,0,390452,True,6X0P-E8ET-3M9X-A3E1
ELlZYctKHO9GLgkR,1668978508,–ü–æ–ø–æ–≤–Ω–µ–Ω–Ω—è ¬´–ê–≤—Ç–æ –¥–ª—è —Ä–æ–∑–≤—ñ–¥–∫–∏¬ª,4829,4829,-50000,-50000,980,0,0,400452,True,0XH4-93H4-91B3-XTMC
6WBP00GSZTJDWkS0,1668951951,–ü–æ–ø–æ–≤–Ω–µ–Ω–Ω—è ¬´–∫–Ω–∏–∂–∫–æ–≤–∞ –±–∞—Ä–∞—Ö–æ–ª–∫–∞¬ª,4829,4829,-7000,-7000,980,0,0,450452,True,180C-T798-19TE-3A77
yKLtbO_c280xtpVX,1668949303,–ü–æ–ø–æ–≤–Ω–µ–Ω–Ω—è ¬´–∫–Ω–∏–∂–∫–æ–≤–∞ –±–∞—Ä–∞—Ö–æ–ª–∫–∞¬ª,–õ–µ–π–ª–∞,4829,4829,-20000,-20000,980,0,0,457452,True,C1PX-M1PE-48PM-PPHK
vbzXEyRxVm1QuGyS,1668949137,–ü–æ–ø–æ–≤–Ω–µ–Ω–Ω—è ¬´–∫–Ω–∏–∂–∫–æ–≤–∞ –±–∞—Ä–∞—Ö–æ–ª–∫–∞¬ª,–ü–æ–ª—è üì∏,4829,4829,-150000,-150000,980,0,0,477452,True,K296-28HT-5724-6258
6l_Wga-3ljiTaPps,1668914287,–†–µ–≥—É–ª—è—Ä–Ω–µ –ø–æ–ø–æ–≤–Ω–µ–Ω–Ω—è ¬´–§–æ–Ω–¥ –ü–æ–≤–µ—Ä–Ω–∏—Å—å –∂–∏–≤–∏–º¬ª,4829,4829,-25000,-25000,980,0,0,627452,True
nGnUdXliMorXnjz6,1668876976,–ü–µ—Ä–µ–∫–∞–∑ –Ω–∞ –∫–∞—Ä—Ç–∫—É,4829,4829,-500000,-500000,980,0,0,652452,True
Iwict4IsNuuG2JEO,1668609765,–ú–∞—Ä—ñ—è –î.,–û–ª–µ—Å—è,4829,4829,-550000,-550000,980,0,0,1152452,True,56M4-9337-3E89-93EH
caI-pV4t--9yvHsP,1668587560,Lesya,4829,4829,-300000,-300000,980,0,0,1702452,True,5BP8-E8C7-M768-3BXE
CfjTv8OzuH0sDXAg,1668539408,–ü–æ–ø–æ–≤–Ω–µ–Ω–Ω—è ¬´–ù–∞ –ø—Ç–∞—Ö–∞-–ø—ñ–¥–≥–ª—è–¥–∞—Ö–∞¬ª,4829,4829,-20000,-20000,980,0,0,2002452,True,0081-H6E5-456H-47K5
zf8lvItuzZ5bBH3P,1668533102,–ü–æ–ø–æ–≤–Ω–µ–Ω–Ω—è ¬´–ù–∞ –ü–ù–ë¬ª,4829,4829,-10000,-10000,980,0,0,2022452,True,AXXK-CBM4-32M4-4HM4
6O8taqfKr7tbG2Xz,1668529442,Lesya,4829,4829,-16400,-16400,980,0,0,2032452,True,27K5-H450-10K2-4P02
JLgTha1jNvoq-zCu,1668453875,–ü–æ–ø–æ–≤–Ω–µ–Ω–Ω—è ¬´—Ç–µ–ø–ª–æ –¥–ª—è –≤–ø–æ¬ª,4829,4829,-10000,-10000,980,0,0,2048852,True,B77C-ET27-EH3P-TT49
SthctWnhpE67ZS9f,1668426741,–ó –ø–ª–∞—Ç–∏–Ω–æ–≤–æ—ó –∫–∞—Ä—Ç–∫–∏,4829,4829,100000,100000,980,0,0,2058852,True
Xrt-d8ODtxnVzi5U,1668421652,–ü–æ–ø–æ–≤–Ω–µ–Ω–Ω—è ¬´–§–æ–Ω–¥ –ü–æ–≤–µ—Ä–Ω–∏—Å—å –∂–∏–≤–∏–º¬ª,4829,4829,-1000,-1000,980,0,0,1958852,True,A1H3-6CCH-6529-H7XC
oP2sLJxOAp69JBm0,1668372654,–ö–∞—Ä—ñ–Ω–∞ –ö.,–û–ª–µ—Å—è üî®,4829,4829,-70000,-70000,980,0,0,1959852,True,2A1B-2165-PTP6-M4BX
Vjub1FmyGT-QcWEg,1668360836,545708****6785,4829,4829,-6000,-6000,980,0,0,2029852,True,9BEP-XX52-AAH4-T7KP
r9Wbo0lQxIeI8Vjd,1668337371,516874****6680,4829,4829,-125000,-125000,980,0,0,2035852,True,84K8-PB11-61KE-8X8H
OIkoIwG3N3rDx8mT,1668177486,–ü–æ–ø–æ–≤–Ω–µ–Ω–Ω—è ¬´–ù–∞ –º–æ—Ä—Å—å–∫—ñ –¥—Ä–æ–Ω–∏ üëπ¬ª,4829,4829,-100000,-100000,980,0,0,2160852,True,737H-09TB-9A2B-C7HM
RkrTC5Ztt2gJldlY,1667908046,–ó –ø–ª–∞—Ç–∏–Ω–æ–≤–æ—ó –∫–∞—Ä—Ç–∫–∏,4829,4829,400000,400000,980,0,0,2260852,True
7oOGo8cKJ2PoMDTU,1667735250,414949****1146,4829,4829,-139397,-139397,980,0,0,1860852,True,H6XE-2EKK-TB15-A581
vJhLcjwzBpSmP0uR,1667629169,–ö–æ—Å—Ç—è–Ω—Ç–∏–Ω –ê.,üçïüçªüï∫,4829,4829,-50000,-50000,980,0,0,2000249,True,C2BH-7P18-242B-A08M
FWgJJmBWbJh2JFWx,1667551675,–ü–æ–ø–æ–≤–Ω–µ–Ω–Ω—è ¬´—Å—Ç–∞—Ä–ª—ñ–Ω–∫ —ñ –≥–µ–Ω–µ—Ä–∞—Ç–æ—Ä¬ª,4829,4829,-50000,-50000,980,0,0,2050249,True,X037-EXBA-XB17-H657
83IJXgOxRku0ISlK,1667418871,–ê–ª—ñ–Ω–∞ –ñ.,–î–ª—è –º–∞–º–∏,4829,4829,-35000,-35000,980,0,0,2100249,True,T9A4-P7P3-612P-878P
gAxYk5mfoGCKvUR5,1667411923,–ó –ø–ª–∞—Ç–∏–Ω–æ–≤–æ—ó –∫–∞—Ä—Ç–∫–∏,4829,4829,200000,200000,980,0,0,2135249,True
UuPIpyeZfYzEgjYw,1667409582,–ü–æ–≥–∞—à–µ–Ω–Ω—è –æ–±–ª—ñ–≥–∞—Ü—ñ–π,4829,4829,100000,100000,980,0,0,1935249,True
5ETBN2XGso6bT8Lp,1667317744,–ó –ø–ª–∞—Ç–∏–Ω–æ–≤–æ—ó –∫–∞—Ä—Ç–∫–∏,4829,4829,1800000,1800000,980,0,0,1835249,True
ayGZrVzasbmGujGS,1672409918,–ü–µ—Ä–µ–∫–∞–∑ –Ω–∞ –∫–∞—Ä—Ç–∫—É,4829,4829,-800000,-800000,980,0,0,2155176,True
ZFck0zcAHDSAmYIX,1672405840,Mates,5812,5812,-12000,-12000,980,0,240,2955176,True,TP71-H769-4CEA-BBK8
5ybAhaGaCyAStRj6,1672405275,Mates,5812,5812,-116100,-116100,980,0,2322,2967176,True,MPBT-X8HK-M7X4-C63M
lskr_P16VUgR_nRl,1672396752,Novus,5411,5411,-14999,-14999,980,0,149,3083276,False,E813-C459-1E2X-HKH8
G0FoHJmMO3WkdYcU,1672396415,–íi–¥: –ü–†–ò–•–û–î–¨–ö–û –ï.–í. –§–û–ü,"–î–ª—è –ø–æ–ø–æ–≤–Ω–µ–Ω–Ω—è –∫–∞—Ä—Ç–∫–∏ 5375414101190360, –ü—Ä–∏—Ö–æ–¥—å–∫–æ –ï—Ä–Ω–µ—Å—Ç –íi–∫—Ç–æ—Ä–æ–≤–∏—á, 3487403339",4829,4829,2400000,2400000,980,0,0,3098275,True
BG8apJx8WVppL9Cn,1672337099,WineTime,5921,5921,-60370,-60370,980,0,452,698275,False,0X50-87T9-H1TP-XMMK
OvH3gX1R-5LjChkE,1672330509,Novapay,8999,8999,-6000,-6000,980,0,0,758645,False,TMAX-8H68-0T25-X86H
BAPtXB-XGz5HnOux,1672321152,–ü–∏—Ä—ñ–∂–∫–æ–≤–∞ ¬´–¢—ñ—Ç–∫–∞ –ö–ª–∞—Ä–∞¬ª,5814,5814,-16400,-16400,980,0,123,764645,False,C3TX-XCXE-056H-4HKX
Zj9MirO82D4TcNNY,1672321057,–ê–ø—Ç–µ–∫–∞ –ê–ù–¶,5912,5912,-22000,-22000,980,0,660,781045,False,C02H-56E5-E4P8-P1TC
gisaqL0qPpo7Ct7x,1672320929,–ö–æ–ª–æ,5411,5499,-30020,-30020,980,0,225,803045,False,X25A-67X2-284A-HMHT
uwfAEDXypLyrG5ZY,1672317351,–°—ñ–ª—å–ø–æ,5411,5411,-20700,-20700,980,0,155,833065,False,6P2K-MM10-T9X8-H00T
2BvMhZA-fAn5ygSk,1672299053,Bwtc cafe&roasters,5814,5814,-12500,-12500,980,0,93,853765,False,1K9X-XATM-255K-25T5
D0Z4nd_9jArLCmBW,1672297875,–û–±—Å–ª—É–≥–æ–≤—É–≤–∞–Ω–Ω—è –ø–ª–∞—Ç–∏–Ω–æ–≤–æ—ó –∫–∞—Ä—Ç–∫–∏,4829,4829,-30000,-30000,980,0,0,866265,True
93J7EjI4z-0nod3j,1672249148,KafeOgBurger,5814,5814,-56000,-56000,980,0,420,896265,False,49CA-6C7X-B057-X360
TYmob_uVYaWWu1fx,1672240959,–ö–æ–ª–æ,5411,5499,-10000,-10000,980,0,75,952265,False,7B00-AT64-5T1E-EP13
5DIQjnRvu4uFXVLh,1672240613,–°—ñ–ª—å–ø–æ,5411,5411,-6999,-6999,980,0,52,962265,False,638E-47X9-PT61-XAM5
Stzfog96UupBLmRK,1672240082,–£–∫—Ä–ø–æ—à—Ç–∞,9402,9402,-75697,-75697,980,0,0,969264,False,X03X-0CME-97X8-0T87
w1bS_4BmsLW0taCv,1672234358,Bwtc cafe&roasters,5814,5814,-7000,-7000,980,0,52,1044961,False,M8KA-E1XE-2H21-KX18
QkXTZRhxBSQVMWq2,1672234302,Bwtc cafe&roasters,5814,5814,-9000,-9000,980,0,67,1051961,False,A1TE-EB39-BKB3-M1MT
CpRafCihr_xD6nCn,1672217780,Bwtc cafe&roasters,5814,5814,-5850,-5850,980,0,43,1060961,False,PK53-24XM-440H-K945
JaWQBoKQx7wFWfq5,1672217559,SalonkrasotiHighFive,7230,7230,-35000,-35000,980,0,0,1066811,False,HE44-68MM-T6XC-9492
t8HVYeQk_NmLFHWH,1672216479,–°—ñ–ª—å–ø–æ,5411,5411,-63837,-63837,980,0,478,1101811,False,K2PC-9AA6-5690-24C8
ioc0-I9wMsWq39eH,1672173442,FDY*Food_SSL,5499,5499,-35800,-35800,980,0,268,1165648,False,P439-0AAB-37MA-7B76
ktNkax_78zca8G_V,1672159165,Biokon,5912,5912,-41220,-41220,980,0,0,1201448,False,T32B-AEXC-14BE-0K8P
ucP3Zz0d5rLhQ6zO,1672153832,Produktova lavka Zoloti v,5499,5499,-23970,-23970,980,0,179,1242668,False,MAA9-K0K2-E70H-4H18
Xxvn1EoPSpu8sS56,1672130624,UNIVERSUMCLINIK,8099,8099,-96000,-96000,980,0,0,1266638,False,HTEX-X6T3-KKKC-245X
Ezk98hvZsjgaMA2a,1672126367,Produkti,5499,5499,-7300,-7300,980,0,54,1362638,False,6E6E-9987-T1KT-61AE
eTS66QeDbMlSeseq,1672111406,LIQPAY*Pethouse,5995,5995,-17800,-17800,980,0,0,1369938,False,9E45-KTE6-6MAP-10PE
ZdK4wwghFkzbw622,1672089587,MasloTOM,5411,5411,-108000,-108000,980,0,810,1387738,False,6966-MM69-TMEE-CMKB
_ud5HAakPXuWr8iq,1672082825,WOG,5541,5541,-137500,-137500,980,0,0,1495738,False,1HXA-96X0-BM5X-8CKC
kU2D4qN-nL7OmYzF,1672074442,LIQPAY*Pethouse,5995,5995,-333200,-333200,980,0,0,1633238,False,1XA5-ETX1-BAET-K361
Eh7Uuw4YlbMKjdSE,1672071302,KAVIARNI,5814,5814,-80900,-80900,980,0,1198,1966438,False,8X7C-7674-203B-9T16
JHy63sXCqRDBmmc5,1672051293,Dodo Socks,5651,5651,-56000,-56000,980,0,0,2047338,False,B9ME-M6P5-7ME7-TX75
BYf3fxJe_JYGnwbt,1672050701,–ü–æ–ø–æ–≤–Ω–µ–Ω–Ω—è ¬´–î–æ–≤–≥—ñ –†–£–ö–∏ –¢–†–û¬ª,4829,4829,-10000,-10000,980,0,0,2103338,True,HPH8-6K5M-MAM1-46T8
S9VLQax6gofHT8D-,1672050669,LIQPAY*slowly,5699,5699,-210000,-210000,980,0,0,2113338,False,XK25-705A-0PPH-H2PX
-zBektZuznKXNjAO,1672050655,–ü–µ—Ä–µ–∫–∞–∑ –Ω–∞ –∫–∞—Ä—Ç–∫—É,4829,4829,-3100000,-3100000,980,0,0,2323338,True
LEHqHixjXfYW0xe-,1672049974,LIQPAY*TOV Mejkap Tre,5977,5977,-32700,-32700,980,0,0,5423338,False,16AK-12BX-KBP3-H7A6
o1zP8Mq_GR8U1x6L,1672049171,–íi–¥: –ü–†–ò–•–û–î–¨–ö–û –ï.–í. –§–û–ü,"–î–ª—è –ø–æ–ø–æ–≤–Ω–µ–Ω–Ω—è –∫–∞—Ä—Ç–∫–∏ 5375414101190360, –ü—Ä–∏—Ö–æ–¥—å–∫–æ –ï—Ä–Ω–µ—Å—Ç –íi–∫—Ç–æ—Ä–æ–≤–∏—á, 3487403339",4829,4829,5200000,5200000,980,0,0,5456038,True
r6dJw0IbQPIIeQIc,1671988118,Varcab,5814,5814,-4000,-4000,980,0,30,256038,False,T94E-MBP6-XKMT-4E19
yMBm3U653EsvyeIE,1671972710,–¢–∞–±–∞–∫–µ—Ä–∫–∞,5993,5993,-16000,-16000,980,0,0,260038,False,EXH2-XC92-4M1M-8B77
mQT0rXAYzFH2kN96,1671972654,Novus,5411,5411,-58393,-58393,980,0,437,276038,False,81TP-BAH3-K135-EMMT
dW5KaVYzGC6sCWNn,1671970001,–ó –±—ñ–ª–æ—ó –∫–∞—Ä—Ç–∫–∏,4829,4829,300000,300000,980,0,0,334431,True
5fozVWnYRYfat-Js,1671909205,LIQPAY*SL in.ua,8398,8398,-20000,-20000,980,0,0,34431,False,K46A-6E15-CC15-8X19
koEBahmGcKwNRsER,1671897016,Konteyner,5814,5814,-26500,-26500,980,0,198,54431,False,7H43-2K9A-5A61-CK2X
OO6tF2fxPe2TAIdY,1671893243,WFPFASTFOOD1,5814,5814,-76500,-76500,980,0,573,80931,False,51B0-5P46-14A6-90E9
PtQEDZEQuqdzoZ27,1671886485,Fotovramke,5946,5946,-65000,-65000,980,0,0,157431,False,K842-XA81-0A91-ME09
Nt8qybFErZxn2Oy5,1671883009,CHARLOTTA,5814,5814,-22000,-22000,980,0,165,222431,False,432X-87XE-1C8M-B35T
MrB792teBT4ZBF4V,1671871050,Bwtc cafe&roasters,5814,5814,-25950,-25950,980,0,194,244431,False,5KXX-5A2T-3A1K-5C96
enLBei8xLZeWWevo,1671811496,Bolt Food,4215,4215,-58100,-58100,980,0,0,270381,False,8CEP-605X-9M57-12B1
yLp7X4HLmJL8bMOD,1671807561,answear.ua,5651,5651,-38714,-37800,980,0,0,328481,False,8P69-7385-47B3-3XM3
juvKduUXGbF8q6lz,1671805340,Produkti,5499,5499,-2700,-2700,980,0,20,367195,False,4B6E-KH36-4KX1-30HK
_K9v9QxreZY7zuk-,1671805210,GorodskaPerukarnya,7230,7230,-270000,-270000,980,0,0,369895,False,12B2-65KC-C3KH-CCBH
igborS-Pf6SUu2EB,1671791830,Beer Market,5921,5921,-31381,-31381,980,0,235,639895,False,K8E2-TKAE-KAEA-A7M5
Faj3t_a09ezcaEP6,1671782852,OK Wine,5411,5411,-24300,-24300,980,0,182,671276,False,K315-C51M-2T3T-5BKX
e70Q6UGQC7C_4BNo,1671729877,–ê–ø—Ç–µ–∫–∞ –î–æ–±—Ä–æ–≥–æ –î–Ω—è,5912,5912,-87430,-87430,980,0,0,695576,False,462C-EMB5-2E56-28EE
yR9g0jziFYHNErrh,1671717645,–ù–æ–≤–∞ –ø–æ—à—Ç–∞,7399,7399,-8500,-8500,980,0,0,783006,False,KHTK-75K2-A87E-63E1
zza2e2NLcz2EMCId,1671711452,TOV LA FARINA,5921,5921,-58300,-58300,980,0,437,791506,False,5B5P-ETP7-EA12-4T7K
xatg7Yw3IZ4FqMej,1671710297,JYSK,5712,5712,-109900,-109900,980,0,0,849806,False,A9M6-85EM-954H-M9HK
WvTIKfvJwtbvCCqT,1671709494,–ï–ø—ñ—Ü–µ–Ω—Ç—Ä,5200,5200,-123000,-123000,980,0,0,959706,False,A0PT-85CP-8MA3-3E9M
qHnE7ehUQ7NijtIf,1671696618,LyaFabrk,5814,5814,-11000,-11000,980,0,82,1082706,False,8B71-MEB5-CKBH-EEXK
_FtkigFnM_K8zFGf,1671648587,OK Wine,5411,5411,-16000,-16000,980,0,120,1093706,False,59X5-E6XE-763H-TBCM
PqEYloMEMb7PsVKi,1671627036,–°—ñ–ª—å–ø–æ,5411,5411,-27400,-27400,980,0,205,1109706,False,T0M3-2BPC-BX31-59EH
79gqtVT-HT9q1hzd,1671626939,–°—ñ–ª—å–ø–æ,5411,5411,-139986,-139986,980,0,1049,1137106,False,HPC7-PE98-7319-B4M6
lqZGXQirLG8Q4sLQ,1671563886,Kafe Right Coffee Bar,5814,5814,-11000,-11000,980,0,82,1277092,False,2CE8-7E6T-8386-CKM9
bo2dO9E5aN9oHNVa,1671551198,magazin 762597,5912,5912,-35790,-35790,980,0,0,1288092,False,3H24-T918-5K5C-48K9
3l5HKXlVm31JE9_I,1671551003,OK Wine,5921,5921,-15000,-15000,980,0,112,1323882,False,72CC-3A0M-7KT5-619X
rzkQvYdyLHIOuStA,1671534743,LIQPAY*O.TAJE,5651,5651,-128155,-128155,980,0,0,1338882,False,94T8-MB0K-6EM8-AM7T
LMRFPFO65SRTG6uh,1671525162,First Point,5814,5814,-13200,-13200,980,0,99,1467037,False,8KHT-75KE-A9TT-EBH8
7SnKx_dVs_4YMXE8,1671524132,WFP.AQUAMARKET,5411,5411,-38080,-38080,980,0,285,1480237,False,PAM8-5078-3H84-PAB4
kk-iTKIEuSqc3iCGAjHjkQ,1671493908,"FDY*Food_SSL,VUL. KRUGLOUNIVERSYTETSKA, 14,KYIV,UA",5499,5499,-70875,-70875,980,0,531,1518317,True
zJnjzEjqc0e8XyRnc9bRFF9MCQ,1671493908,–°–∫–∞—Å—É–≤–∞–Ω–Ω—è. FDY*Food_SSL,5499,5499,74875,74875,980,0,-561,1589192,False
QY3xQOr42fnW8rzE,1671470802,–ü–∞—Ä–∫–æ–≤–∫–∞,7523,7523,-8000,-8000,980,0,0,1514317,False,3E17-9HTK-B3X0-32CC
14A_HxuQjIBBxYCz,1671468545,–ü–µ—á–µ–Ω–∞ –∫–∞—Ä—Ç–æ–ø–ª—è,5814,5814,-16400,-16400,980,0,123,1522317,False,PCM3-1XT3-C3A0-T1CX
3ogJkGzorxcTiyX5,1671468176,DUSHKA,5977,5977,-20900,-20900,980,0,0,1538717,False,M110-62H0-A43A-H2EC
qHcXeYpx3cPglglu,1671468020,–°—ñ–ª—å–ø–æ,5411,5411,-63074,-63074,980,0,473,1559617,False,H4M8-MX04-BH7K-T94E
P0xYAy0g-Lh4B-Jc,1671467032,GULIA,5621,5621,-18850,-18850,980,0,0,1622691,False,CC9X-TP38-X1XM-7HK7
oU8MN_fBVDfCcpeL,1671457886,OkvajnSichovih,5399,5399,-150060,-150060,980,0,1125,1641541,False,8H96-1BHT-AM8C-BE1E
zmdJXOP1BGaXptc5,1671457539,PershaRestoraciyaShaurmi,5814,5814,-22900,-22900,980,0,171,1791601,False,E108-8P81-1742-XH1H
G1mwUIGwbFcoIkri,1671444442,–°—ñ–ª—å–ø–æ,5411,5411,-29943,-29943,980,0,224,1814501,False,K5E1-BHHP-AEXX-K51T
qgDtRtliLuWZD6qT,1671437793,KAFE,5812,5812,-8700,-8700,980,0,65,1844444,False,T1C9-1092-821C-4X7B
DHmqbE5jnfxQm-mB,1671436041,ZOOLYUKS,5995,5995,-159000,-159000,980,0,0,1853144,False,TABK-5C1B-37KB-E99M
kpl3KWvuY-4QcCwT,1671432803,ZOOLUX,742,742,-35100,-35100,980,0,0,2012144,False,P3E7-5T8X-P3EP-77E2
SHtXaz8U0znfA5fv,1671380547,Mates,5812,5812,-30000,-30000,980,0,600,2047244,True,62A7-32E4-TB3H-40HX
EQfcA2eu7mUQ5AXp,1671372567,Beer Market,5921,5921,-33375,-33375,980,0,333,2077244,False,3T7T-BC4P-45B5-0XXX
mi9X4S_vTY98T6V_,1671362679,–ü–∏—Ä—ñ–∂–∫–æ–≤–∞ ¬´–¢—ñ—Ç–∫–∞ –ö–ª–∞—Ä–∞¬ª,5814,5814,-26200,-26200,980,0,524,2110619,False,5516-HE7A-T12C-4003
UJfLpDoEXq5w5gE1,1671348657,La fabrique,5814,5814,-11000,-11000,980,0,220,2136819,False,C5E8-E3BC-9EK1-8141
DEUahz4d9_4QNAuuwflZNg,1671319813,"–°–∫–∞—Å—É–≤–∞–Ω–Ω—è. LIQPAY*Pethouse,LIQPAY*Pethouse,DNIPRO,UA,DNIPRO,UA",5995,5995,14800,14800,980,0,0,2147819,True
t-fxE_D3kCaqpVKR,1671294425,–°–∫–∞—Å—É–≤–∞–Ω–Ω—è. WFPFASTFOOD1,5814,5814,75000,75000,980,0,-1500,2133019,False
csnel7WhHG8GGN3Y,1671291982,Beer Market,5921,5921,-14998,-14998,980,0,149,2058019,False,KAPX-4979-4B4T-T488
lap9eLovFKXXiLp7,1671289842,LIQPAY*T.C.Pizza,5812,5812,-49350,-49350,980,0,987,2073017,False,2BBX-XH3C-A56E-8313
i-KAWekSyIPU52OC,1671288731,WFPFASTFOOD1,5814,5814,-75000,-75000,980,0,1500,2122367,False
UGRjCcRVp_G1n-so,1671282181,–ü–µ—Ä–µ–∫–∞–∑ –Ω–∞ –∫–∞—Ä—Ç–∫—É,4829,4829,-800000,-800000,980,0,0,2197367,True
VEQtzZAaa4DmTQWK,1671279977,–°–≤—ñ—Ç –ö–∞–≤–∏,5814,5814,-15500,-15500,980,0,310,2997367,False,5231-4KE6-BBXC-K224
RyhQDECKfGgQZlug,1671278856,STORE J089 BLOCKBUSTER,5712,5712,-116000,-116000,980,0,0,3012867,False,4E47-5422-CHC9-K21K
gd5Ymp3O4KeJAtO_,1671264451,Bwtc cafe&roasters,5814,5814,-25000,-25000,980,0,500,3128867,False,888C-H3PH-B671-6MXX
RTyrQAOTxtomRHJe,1671262312,Novapay,8999,8999,-43900,-43900,980,0,0,3153867,False,MAM1-88C7-XH4K-K72M
6T65h0anNt5zem1N,1671262271,Novapay,8999,8999,-54900,-54900,980,0,0,3197767,False,59ME-M6H7-ET39-3286
8lAxVnD8imEn7Xvr,1671262186,Novapay,8999,8999,-54900,-54900,980,0,0,3252667,False,BP57-323M-6KKE-TBAK
-4I_XwZS-2Sit3gr,1671207676,–°–∫–∞—Å—É–≤–∞–Ω–Ω—è. –ó–∞–º–æ–≤–ª–µ–Ω–Ω—è —ó–∂—ñ wayforpay,5814,5814,41000,41000,980,0,-820,3307567,False
wHmB1DEi2HwLUWFu,1671206624,BURGER FARM,8999,8999,-44520,-44520,980,0,0,3266567,False,36P9-T8TA-TMH2-564K
1fvjhXqUGeNdWoJ3,1671205831,–ó–∞–º–æ–≤–ª–µ–Ω–Ω—è —ó–∂—ñ wayforpay,5814,5814,-41000,-41000,980,0,820,3311087,False
QEo_e72UYmkZKvnp,1671190403,–íi–¥: –ü–†–ò–•–û–î–¨–ö–û –ï.–í. –§–û–ü,"–î–ª—è –ø–æ–ø–æ–≤–Ω–µ–Ω–Ω—è –∫–∞—Ä—Ç–∫–∏ 5375414101190360, –ü—Ä–∏—Ö–æ–¥—å–∫–æ –ï—Ä–Ω–µ—Å—Ç –íi–∫—Ç–æ—Ä–æ–≤–∏—á, 3487403339",4829,4829,2500000,2500000,980,0,0,3352087,True
A1xbAFIv5yh73E5i,1671188009,Novus,5411,5411,-9703,-9703,980,0,72,852087,False,EKKT-4K54-4XBC-H817
v2j8h0nwkz3k0_C0,1671187790,–¢–∞–±–∞–∫–µ—Ä–∫–∞,5993,5993,-15000,-15000,980,0,0,861790,False,M109-4AB0-X27A-756E
MB1mdTycnzV_FVr5,1671187494,Bwtc cafe&roasters,5814,5814,-21500,-21500,980,0,161,876790,False,2366-6PT0-MCMB-BHCP
J0DdQ8vZ2qYoPJD0,1671141756,LIQPAY*Pethouse,5995,5995,-295200,-295200,980,0,0,898290,False,6X5A-2894-HM0T-71HA
P_KI43ZxT1RJJbIa,1671126809,–°—ñ–ª—å–ø–æ,5411,5411,-3399,-3399,980,0,25,1193490,False,AK0C-A9X3-AH1P-KC18
4ubz30cZbSiNrUmC,1671126770,–°—ñ–ª—å–ø–æ,5411,5411,-156448,-156448,980,0,1173,1196889,False,A6C6-9X1E-KPBC-3MPM
xPwW5ZXePfLZNPxp,1671124791,OKKO,5541,5541,-207900,-207900,980,0,0,1353337,False,6T49-BE61-2KA5-3EB3
eV_BbmKJpsYuq52w,1671123536,KnigarnyaKnizhkoviyLev,5942,5942,-31200,-31200,980,0,0,1561237,False,16C3-X4MC-M1CK-5C39
Qy86MV3PjvNCbqv1,1671119674,Produkti,5499,5499,-24000,-24000,980,0,180,1592437,False,16TP-PBE1-K0ET-E03K
KeOpyg6xA-6Lq761,1671115940,–ü–∏—Ä—ñ–∂–∫–æ–≤–∞ ¬´–¢—ñ—Ç–∫–∞ –ö–ª–∞—Ä–∞¬ª,5814,5814,-8200,-8200,980,0,61,1616437,False,2TPK-C309-TE10-5X79
pCmYxUbW73ICu7w1,1671034687,FDY*Food_SSL,5499,5499,-74875,-74875,980,0,561,1624637,False
CzJZTZYiM9zXTJOo,1671033516,Yaroslaviv Val 37-1,5499,5499,-72800,-72800,980,0,546,1699512,False,9M86-8E5K-A28M-77BM
cqCgvodYRRY0_z2e,1671008140,–ú—ñ—Å—å–∫–µ –∫–∞—Ñ–µ –•–∞—Ä–º—Å,5812,5812,-42500,-42500,980,0,318,1772312,True,TBC4-65AA-07A2-EBA3
bkTY_KPQBGBiCxV-,1670957906,LIQPAY*AVM,5977,5977,-94963,-94963,980,0,0,1814812,False,BKH0-65TX-TC4X-6MM0
oOpqkZNWEzZMEfKM,1670952046,–ê–ø—Ç–µ–∫–∞ –ê–ù–¶,5912,5912,-60250,-60250,980,0,1807,1909775,False,H61K-H0BB-CKE2-T2K0
OeCV6ER5DVm-oD5y,1670950761,WFP*CLOTHING_,5691,5691,-70000,-70000,980,0,0,1970025,False,K0H9-ECP8-0EEC-M32H
B8EMDBk28Swl61dG,1670947393,Kafe Right Coffee Bar,5814,5814,-11400,-11400,980,0,228,2040025,False,7TPC-9253-CBPH-ETB3
0HLUUTvDlz0mee_-,1670942060,–ö–æ–ª–æ,5411,5499,-4850,-4850,980,0,48,2051425,False,BC59-5H7E-10HK-2B25
Ff2VqzWAjWoiiL__,1670933145,–ü–µ—Ä–µ–∫–∞–∑ –Ω–∞ –∫–∞—Ä—Ç–∫—É,4829,4829,-500000,-500000,980,0,0,2056275,True
MHpD3NDu1oACasJL,1670933112,Lesya,4829,4829,-300000,-300000,980,0,0,2556275,True,CPK8-K1HT-1060-49CP
kgY8DYwzzk1_yIDn,1670926721,–íi–¥: –ü–†–ò–•–û–î–¨–ö–û –ï.–í. –§–û–ü,"–î–ª—è –ø–æ–ø–æ–≤–Ω–µ–Ω–Ω—è –∫–∞—Ä—Ç–∫–∏ 5375414101190360, –ü—Ä–∏—Ö–æ–¥—å–∫–æ –ï—Ä–Ω–µ—Å—Ç –íi–∫—Ç–æ—Ä–æ–≤–∏—á, 3487403339",4829,4829,2000000,2000000,980,0,0,2856275,True
GCpytEXwdDFF5EtL,1670916395,ZOOLUX,742,742,-124000,-124000,980,0,0,856275,False,9K7M-KT0H-P66M-3425
t37cx7YqtI27yIfo,1670847746,FDY*Food_SSL,5499,5499,-250000,-250000,980,0,1875,980275,False,1E90-H31K-7E2A-428H
H8fFXAlQu9xLlleY,1670843163,Bwtc cafe&roasters,5814,5814,-15500,-15500,980,0,116,1230275,False,8745-EAT3-13AM-0P13
66sLenM2iJ1_n3mz,1670842175,OK Wine,5921,5921,-28140,-28140,980,0,211,1245775,False,490M-81C8-30KX-E98X
lV0SHZDjXlSE5AsM,1670835537,AROMA BURO,5200,5200,-137800,-137800,980,0,0,1273915,True,AE30-CM51-CA46-4829
KubUSEbIho4uhgpg,1670779553,–ö–æ–ª–æ,5411,5499,-19680,-19680,980,0,147,1411715,True,E78B-19E2-B5ET-9B59
sP2Giy2zzXCy1KKe,1670779420,PershaRestoraciyaShaurmi,5814,5814,-42800,-42800,980,0,321,1431395,False,6AA6-1KPB-67H2-K96P
PpzZZ79Mw_fsFKM5,1670767850,OK Wine,5411,5411,-132000,-132000,980,0,990,1474195,False,XPTC-T7TC-1AP6-07P1
RlXPKXWLLlVva2jR,1670765006,–í—ñ–¥: –ú–∏–∫–æ–ª–∞ –û–≥–æ–π–∫–æ,4829,4829,82200,82200,980,0,0,1606195,True
nliyNz7aRpn3NTJT,1670760182,–¢–∞–±–∞–∫–µ—Ä–∫–∞,5993,5993,-17600,-17600,980,0,0,1523995,False,8TM7-576T-C39X-XTMC
Pzzk7XB3PnwLq_ef,1670760122,Novus,5411,5411,-37095,-37095,980,0,278,1541595,False,KC1H-1PC9-M913-3T15
VpbuPFS66GotfcSp,1670760060,–ü—Ä–∏–≤–∞—Ç24: Nazar Topolskyi,6536,6536,109300,109300,980,0,0,1578690,False
42KwFbUANwzis_7Q,1670758499,Kafe,5814,5814,-30500,-30500,980,0,228,1469390,False,104C-AKP4-34K2-9B8B
vhwZSZkaZrx1dZqN,1670758481,KafeTOVODESALIDER,5814,5814,-13000,-13000,980,0,97,1499890,False,TT06-E782-H88K-AT9C
KzJpe_1TjKpJ6EUT,1670753734,WFP.EDA,5811,5811,-5000,-5000,980,0,37,1512890,True,C5KA-B90M-AMP2-2236
hUaIptjqC8C5alwr,1670753726,SOPHIA HOTEL KYIV,7011,7011,-33500,-33500,980,0,0,1517890,True,4377-95M3-2X6M-73HX
SW6yjoSIQgi3XDDG,1670746060,LIQPAY*Pethouse,5995,5995,-147600,-147600,980,0,0,1551390,False,CEAE-415E-TXTM-CMT9
QuXHMMsoR9EZxT84,1670697924,–í—ñ–¥: –í–ª–∞–¥–∏—Å–ª–∞–≤ –ß–æ—Ä–Ω–∏–π,–í–∞—Ä–≤–∞—Ä –ü'—è—Ç–Ω–∏—Ü—è,4829,4829,91700,91700,980,0,0,1698990,True
Q9JGbglOa3zXbgmX,1670691213,Novapay,8999,8999,-6000,-6000,980,0,0,1607290,False,B797-C2B1-5CE5-04K7
-iGqPJ5iRBzuraE9,1670691182,Novapay,8999,8999,-7400,-7400,980,0,0,1613290,False,C557-0C0E-5ABK-P1EK
Zs837p2A2_2q_z9J,1670679608,Produkti,5499,5499,-7790,-7790,980,0,58,1620690,False,A6B0-2290-E6X9-04K6
QIDcoa9FbEhQJLyU,1670679131,Konteyner,5814,5814,-47500,-47500,980,0,356,1628480,False,HH40-PPTH-3MX2-6HM9
eFvXJ92uxl8xOQNo,1670677496,LIQPAY*T.C.Pizza,5812,5812,-143550,-143550,980,0,1076,1675980,True,KH67-94X5-9762-P5C8
ZaNw76vC9cz-xDyJ,1670661133,MasterZoo,5995,5995,-85350,-85350,980,0,4267,1819530,False,88M8-C4CC-MKTP-27P1
kEVgAzDM68TgJKHm,1670614647,Varvar Bar,5812,5812,-390900,-390900,980,0,6629,1904880,True,P068-8KKA-A5X6-707B
hIqtI6kPpftjh0sx,1670614547,–ó –±—ñ–ª–æ—ó –∫–∞—Ä—Ç–∫–∏,4829,4829,350000,350000,980,0,0,2295780,True
2oUyaHZdaAE14NGq,1670598097,Varcab,5814,5814,-15000,-15000,980,0,112,1945780,False,HT8X-4C07-XH5H-56EH
57gjcZfpCF4_h5-R,1670593022,StudijaKvitivtadekoruS,5992,5992,-44000,-44000,980,0,0,1960780,False,C7HM-K8P1-7H4E-72B5
jLIiiDGoZqCjpwp1,1670518949,–ü–µ—Ä–µ–∫–∞–∑ –Ω–∞ –∫–∞—Ä—Ç–∫—É,4829,4829,-500000,-500000,980,0,0,2004780,True
GpQGm5-F32OgU_g5,1670518912,–ü–æ–ø–æ–≤–Ω–µ–Ω–Ω—è ¬´–ù–∞ –∑–∏–º–æ–≤–∏–π –æ–¥—è–≥ üá∫üá¶¬ª,4829,4829,-100000,-100000,980,0,0,2504780,True,M69M-B5TB-085A-5KP3
R6VHy4adFz-sQNkA,1670513647,–ö–æ–ª–æ,5411,5499,-31520,-31520,980,0,315,2604780,False,MK6P-5A93-C102-KMT4
YaiEGufw5K4_8-Qr,1670513431,–ê–ø—Ç–µ–∫–∞ –ê–ù–¶,5912,5912,-64650,-64650,980,0,1939,2636300,False,28A1-E3M2-P133-TB58
iQh5PEbF5LPcIjbq,1670511801,ZOOLYUKS,5995,5995,-56520,-56520,980,0,0,2700950,False,5A57-7X26-1T5T-K9XH
Egtbaris5gCbVAsY,1670510894,ZOOLUX,742,742,-48702,-48702,980,0,0,2757470,False,X0AX-X8XK-2TKB-93TC
rldrAMMaPf-a9pKI,1670488769,NAMELAKA,5812,5812,-100000,-100000,980,0,2000,2806172,True,B60M-73P0-80X5-ME8P
9HsIi3DN2ieIXIVN,1670445440,–ü–æ–ø–æ–≤–Ω–µ–Ω–Ω—è ¬´–ù–∞ –∞–≤—Ç–æ –¥–ª—è –∑—Å—É¬ª,4829,4829,-100000,-100000,980,0,0,2906172,True,66BT-2PKP-E79E-C49E
FTT6LTh20QyznqjF,1670433626,Garage,5921,5921,-65000,-65000,980,0,650,3006172,False,PKHB-5417-T376-32KX
hpYvXR7J4jRgLA1-,1670433106,TOV LA FARINA,5921,5921,-43900,-43900,980,0,439,3071172,False,1PE4-KC3T-XTK4-MM2A
fMXhmyM_kI0A3J0a,1670431568,TOV LA FARINA,5921,5921,-74400,-74400,980,0,744,3115072,False,PX30-9HAP-XTAK-0EH2
jPDNp4EVMckt4oJ9,1670425646,ZOOLYUKS,5995,5995,-200000,-200000,980,0,0,3189472,False,9A69-XCC7-BBEH-XA75
xuicfTzflH97uxlX,1670420914,ProduktiJArVal19,5499,5499,-3000,-3000,980,0,30,3389472,False,A1P5-182H-C43T-0B2T
4q0F7ZAs_C2rju42,1670420394,Mon cher,5814,5814,-123500,-123500,980,0,2470,3392472,False,42E0-BK8M-A501-H835
lKR-Va1Tm7rcfdJM,1670416144,–°—ñ–ª—å–ø–æ,5411,5411,-4199,-4199,980,0,41,3515972,False,7533-1TPH-23X3-7E24
UeL7EHi_VUhbbaUj,1670409806,–íi–¥: –ü–†–ò–•–û–î–¨–ö–û –ï.–í. –§–û–ü,"–î–ª—è –ø–æ–ø–æ–≤–Ω–µ–Ω–Ω—è –∫–∞—Ä—Ç–∫–∏ 5375414101190360, –ü—Ä–∏—Ö–æ–¥—å–∫–æ –ï—Ä–Ω–µ—Å—Ç –íi–∫—Ç–æ—Ä–æ–≤–∏—á, 3487403339",4829,4829,3300000,3300000,980,0,0,3520171,True
LHKehLMF2aIT3tTh,1670409794,Kharms,5814,5814,-4800,-4800,980,0,36,220171,False,E397-74P7-EPH1-AC1X
bHsX5N3TOGjb4p07,1670409124,Produktova lavka Zoloti v,5499,5499,-31960,-31960,980,0,239,224971,False,7E5M-XAM5-CCPP-8595
ORUBASMpRIpfE7jO,1670404606,Bolt,4121,4121,-14200,-14200,980,0,0,256931,False,0T4H-0E8C-PM3E-721C
2mS4faVE-lyIfkdq,1670402647,Dubler,5814,5814,-74500,-74500,980,0,558,271131,False,9796-XP5A-B013-9XBM
LGuTCT_z2Wib3esr,1670362745,ZOOLYUKS,5995,5995,-2470000,-2470000,980,0,0,345631,False,73K7-2BC0-91T4-PCH9
qn-oiQ9ZZ76pzefl,1670362661,–ó –±—ñ–ª–æ—ó –∫–∞—Ä—Ç–∫–∏,4829,4829,800000,800000,980,0,0,2815631,True
4xI60oTmh1m8G1rY,1670354955,Lesya,4829,4829,-100000,-100000,980,0,0,2015631,True,B655-6HKP-E955-8PX7
Usds6q_CHBsJqVmq,1670332939,magazin 762597,5912,5912,-27240,-27240,980,0,0,2115631,False,CBX4-B2TK-H343-HA52
okGNQHpsNQgLtLrc,1670332079,One love coffee —Ü—É–º,7523,7523,-16000,-16000,980,0,0,2142871,False,A1CX-C0KM-3A2H-P898
w_8BxtwKUqb8r13x,1670326534,–ü–µ—Ä–µ–∫–∞–∑ –Ω–∞ –∫–∞—Ä—Ç–∫—É,4829,4829,-300000,-300000,980,0,0,2158871,True
2u6TJgpocfEc60SC,1670326499,JAlinkoviprikrasi,4215,4215,-25000,-25000,980,0,0,2458871,False,T79P-ME66-M6X3-19M4
m8b9pUCm1okIzsJR,1670324701,Egersund Seafood,5411,5411,-55650,-55650,980,0,556,2483871,False,MAE3-8X32-376P-MM57
38BA7KDv54cx6Eg-,1670322302,Kafe Right Coffee Bar,5814,5814,-10900,-10900,980,0,218,2539521,False,7A9P-170B-6173-3A4C
fEEDWMCdACrpWqTL,1670322121,–ê–ø—Ç–µ–∫–∞ –ê–ù–¶,5912,5912,-275940,-275940,980,0,8278,2550421,False,19BE-A7MP-829A-MM79
vbzXFSJ9U2ZeuG-b,1670321057,–íi–¥: –ü–†–ò–•–û–î–¨–ö–û –ï.–í. –§–û–ü,"–î–ª—è –ø–æ–ø–æ–≤–Ω–µ–Ω–Ω—è –∫–∞—Ä—Ç–∫–∏ 5375414101190360, –ü—Ä–∏—Ö–æ–¥—å–∫–æ –ï—Ä–Ω–µ—Å—Ç –íi–∫—Ç–æ—Ä–æ–≤–∏—á, 3487403339",4829,4829,2600000,2600000,980,0,0,2826361,True
poTgkz6rQ9r0RHym,1670314404,Bwtc cafe&roasters,5814,5814,-13950,-13950,980,0,104,226361,False,6933-E838-3B40-ECT9
S2aXbablQFJrxMkm,1670267574,KafeKafeKometa,5814,5814,-74900,-74900,980,0,561,240311,False,EAXA-601B-02XH-BC4T
Ifbo2TyKgUhwAAR4,1670267570,TOV KOMETA,5814,5814,-17000,-17000,980,0,127,315211,False,CM7P-MMCX-01A9-87BK
Q_Yrp2UA2n-T-K6x,1670226456,StudijaKvitivtadekoruS,5992,5992,-45000,-45000,980,0,0,332211,False,AB2C-T63C-PHX2-BHCB
sXMU9YrWHm60NNYF,1670226417,Bwtc cafe&roasters,5814,5814,-6500,-6500,980,0,48,377211,False,BH7X-7B1K-0EXT-02B9
auvl9gooXIITsMHL,1670168841,–Ü–Ω—Ç–µ—Ä–Ω–µ—Ç —ñ –¢–ë,4900,4900,-30000,-30000,980,0,0,383711,True,1345-XX69-0H54-X5TH
Wru9tc6FrWXvCWly,1670162574,Mates,5812,5812,-91500,-91500,980,0,686,413711,True,B2C6-0AA3-6E49-5KPE
n3yVyheBC3rg1dD8,1670158945,StudijaKvitivtadekoruS,5992,5992,-195000,-195000,980,0,0,505211,False,5197-333X-T27X-7MCM
d2HGlWVrz-nOOm4R,1670158304,GorodskaPerukarnya,7230,7230,-25000,-25000,980,0,0,700211,False,8T62-76E2-1618-HE9H
rWq4YDcTP_MeXCxe,1670145149,–°—ñ–ª—å–ø–æ,5411,5411,-66965,-66965,980,0,502,725211,False,X4CM-B1BK-2573-8K1H
JRWDmdBScOvlpaMu,1670143717,CEH 1,7216,7216,-119900,-119900,980,0,0,792176,False,T952-TT6P-H3EM-68A3
q2BFBo2t20CnEbIcYj3OeQ,1670109823,"–°–∫–∞—Å—É–≤–∞–Ω–Ω—è. TACHCARD,KYIV,UA",7399,7399,30900,30900,980,0,0,912076,False
DpD92weZvaiIja9z,1670075773,LIQPAY*Kitajskij privi,5812,5812,-75000,-75000,980,0,562,881176,False,5KT4-3B6X-1281-E6HT
3io3EJFDnY28oMAt,1670063378,WFP.AQUAMARKET,5411,5411,-80320,-80320,980,0,602,956176,False,KP0T-3T9A-3BTH-EE9E
4rSx-ChP8-eHA_H-,1670059189,Novus,5411,5411,-67796,-67796,980,0,508,1036496,False,E21E-6KTX-AEA9-BH5A
dT9Edlnm56F2jQOc,1670058544,FOP Sturova AS,5814,5814,-22000,-22000,980,0,165,1104292,False,HA4T-1BKM-78HP-PM36
qPS6hrEhN5L1yaZu,1670001121,–°—ñ–ª—å–ø–æ,5411,5411,-165442,-165442,980,0,1240,1126292,False,P9MA-41X0-2TC2-92KP
_sbjYcmbFjCVFCp3,1670000283,–°—ñ–ª—å–ø–æ,5411,5411,-31800,-31800,980,0,238,1291734,False,CMPM-T6PK-4781-2C20
npgp9eBypFRzJQsE,1670000228,–°—ñ–ª—å–ø–æ,5411,5411,-25400,-25400,980,0,190,1323534,False,25K1-E5AM-2B7X-HEK3
t5GYXqrFpzem8t0J,1669914590,LIQPAY*Zigzag,5812,5812,-82800,-82800,980,0,621,1348934,False,4XB4-5B50-5E72-6005
m9xLDJKeSRHy7atL,1669913385,Produkti,5499,5499,-7300,-7300,980,0,54,1431734,False,6MH9-321P-2A4T-X49C
792ILGTO6htZZBBN,1669886639,Tachcard,7399,7399,-30900,-30900,980,0,0,1439034,False
K_hVshYfPg_krWAj,1669882049,Bwtc cafe&roasters,5814,5814,-11000,-11000,980,0,82,1469934,False,0TP4-0T60-P58T-EK18
D1PkSkheecfG_s1U,1672409919,–ó –ø–ª–∞—Ç–∏–Ω–æ–≤–æ—ó –∫–∞—Ä—Ç–∫–∏,4829,4829,800000,800000,980,0,0,3606830,True
4YlCMomLnkfVwslM,1672055172,–¢–µ—Ç—è–Ω–∞ –°.,–í—ñ–¥ –ú–∏–∫–æ–ª–∞—è –∑—ñ —Å–≤—è—Ç–∞–º–∏ üéÖ,4829,4829,-390000,-390000,980,0,0,2806830,True,C6X2-7091-9086-K63T
CzVzSXSruSCK_Emx,1672050655,–ó –ø–ª–∞—Ç–∏–Ω–æ–≤–æ—ó –∫–∞—Ä—Ç–∫–∏,4829,4829,3100000,3100000,980,0,0,3196830,True
FVkoJiQJal1_Cy1p,1671970001,–ü–µ—Ä–µ–∫–∞–∑ –Ω–∞ –∫–∞—Ä—Ç–∫—É,4829,4829,-300000,-300000,980,0,0,96830,True
cRVkt5aVslM02ZV3,1671938307,–†–µ–≥—É–ª—è—Ä–Ω–µ –ø–æ–ø–æ–≤–Ω–µ–Ω–Ω—è ¬´–§–æ–Ω–¥ –ü–æ–≤–µ—Ä–Ω–∏—Å—å –∂–∏–≤–∏–º¬ª,4829,4829,-25000,-25000,980,0,0,396830,True
GF1l4BPOYxKRZlpl,1671784160,–ü–æ–ø–æ–≤–Ω–µ–Ω–Ω—è ¬´–ù–∞ –ó–∏–º–æ–≤—É –†–µ–∑–∏–Ω—É¬ª,4829,4829,-50000,-50000,980,0,0,421830,True,E51T-P82B-CM8P-2B3P
zF3L34_GCIMCWeTd,1671693272,"Lifecell
+380631692598",4814,4814,-11000,-11000,980,0,0,471830,True,2AHK-9C87-MPM3-02M8
2V7yG_heBqMNMwkG,1671633427,–ü—Ä–æ—Ü–µ–Ω—Ç –≤—ñ–¥ –æ–±–ª—ñ–≥–∞—Ü—ñ–π,4829,4829,5500,5500,980,0,0,482830,True
mIrovFKs-rrIM3EP,1671628762,414949****0520,4829,4829,-40000,-40000,980,0,0,477330,True,P4XM-P344-44P9-61A9
zffC-jG5eJXySeAt,1671562142,Lesya,4829,4829,-100000,-100000,980,0,0,517330,True,8657-5BPB-2H00-HH28
uRhdM8MaXQf8rYCp,1671525041,–°–≤—ñ—Ç–ª–∞–Ω–∞ –†.,4829,4829,-48800,-48800,980,0,0,617330,True,P8ME-ATT5-THP0-7564
Y-o36wl07gugp_1q,1671474852,Lesya,4829,4829,-220000,-220000,980,0,0,666130,True,5HEX-8HEM-8295-XM75
vXiMYSBGNnSOMjP8,1671333399,–†–µ–≥—É–ª—è—Ä–Ω–µ –ø–æ–ø–æ–≤–Ω–µ–Ω–Ω—è ¬´–§–æ–Ω–¥ –ü–æ–≤–µ—Ä–Ω–∏—Å—å –∂–∏–≤–∏–º¬ª,4829,4829,-25000,-25000,980,0,0,886130,True
8PdpKNgB6ejRvVVH,1671282181,–ó –ø–ª–∞—Ç–∏–Ω–æ–≤–æ—ó –∫–∞—Ä—Ç–∫–∏,4829,4829,800000,800000,980,0,0,911130,True
IoblOyfV1AdVBLRY,1671010503,Lesya,4829,4829,-400000,-400000,980,0,0,111130,True,6730-MK82-9KMK-TC03
0P9zaL9tRquhSEzS,1670933145,–ó –ø–ª–∞—Ç–∏–Ω–æ–≤–æ—ó –∫–∞—Ä—Ç–∫–∏,4829,4829,500000,500000,980,0,0,511130,True
-Lto6dzVIIoIJ5im,1670865301,–ü–æ–ø–æ–≤–Ω–µ–Ω–Ω—è ¬´–ü–æ–¥–∞—Ä—É–Ω–æ–∫ –Ω–∞ –î–Ω—é—Ö—É)¬ª,–ó –¥–Ω–µ–º –Ω–∞—Ä–æ–¥–∂–µ–Ω–Ω—è!! üï∫üéâüéÇ,4829,4829,-500000,-500000,980,0,0,11130,True,0A74-EK9B-0C56-KP8M
MLoQgtHfqBQwR5K_,1670865218,Lesya,4829,4829,-250000,-250000,980,0,0,511130,True,P7B4-E834-XX6T-4A2M
dDg6g8C2Ubmg8y55,1670728634,–†–µ–≥—É–ª—è—Ä–Ω–µ –ø–æ–ø–æ–≤–Ω–µ–Ω–Ω—è ¬´–§–æ–Ω–¥ –ü–æ–≤–µ—Ä–Ω–∏—Å—å –∂–∏–≤–∏–º¬ª,4829,4829,-25000,-25000,980,0,0,761130,True
eZcbUUu-J0B2fd2I,1670669428,535528****8672,4829,4829,-70000,-70000,980,0,0,786130,True,A60X-BM07-K1B7-0CEE
JQrvYU0cs00eMrrc,1670614547,–ü–µ—Ä–µ–∫–∞–∑ –Ω–∞ –∫–∞—Ä—Ç–∫—É,4829,4829,-350000,-350000,980,0,0,856130,True
_eU9aPu0obwQynDQ,1670518950,–ó –ø–ª–∞—Ç–∏–Ω–æ–≤–æ—ó –∫–∞—Ä—Ç–∫–∏,4829,4829,500000,500000,980,0,0,1206130,True
mr6qkm25rjC-uvU4,1670362661,–ü–µ—Ä–µ–∫–∞–∑ –Ω–∞ –∫–∞—Ä—Ç–∫—É,4829,4829,-800000,-800000,980,0,0,706130,True
iYJl3ebJG-C8PJSQ,1670352254,–ü–æ–ø–æ–≤–Ω–µ–Ω–Ω—è ¬´–Ω–∞ –¥—Ä–æ–Ω DJI Matrice¬ª,4829,4829,-300000,-300000,980,0,0,1506130,True,7CM4-C74H-K4MB-TXE5
K1OWGUbkdlPZ_wmq,1670350224,–í–∞–ª–µ–Ω—Ç–∏–Ω–∞ –ö.,–û–ª–µ—Å—è,4829,4829,-90000,-90000,980,0,0,1806130,True,T0A9-166E-K5AE-MB68
sr8w6KaYtj_lAIHy,1670336966,–ï–º—ñ–ª—ñ—è –®.,–û–ª–µ—Å—è üéπ,4829,4829,-65000,-65000,980,0,0,1896130,True,3X5H-KKEP-BM16-EK2C
AD34MW9uWawgcbAq,1670326535,–ó –ø–ª–∞—Ç–∏–Ω–æ–≤–æ—ó –∫–∞—Ä—Ç–∫–∏,4829,4829,300000,300000,980,0,0,1961130,True
tWsCpZbe53AOlz6u,1670313113,Lesya,ü™©üï∫ü™©,4829,4829,-100000,-100000,980,0,0,1661130,True,A9H2-M8TE-9M2M-9P16
Mr7eyNnCdbeHznMw,1670253143,–ü–æ–ø–æ–≤–Ω–µ–Ω–Ω—è ¬´–ù–∞ –¥–∂–∏–ø –ø—ñ–¥ –ë–∞—Ö–º—É—Ç¬ª,BCD ‚úã,4829,4829,-100000,-100000,980,0,0,1761130,True,1CAX-77BE-143M-137P
SCu9Doo_l4nxdw3X,1670123808,–†–µ–≥—É–ª—è—Ä–Ω–µ –ø–æ–ø–æ–≤–Ω–µ–Ω–Ω—è ¬´–§–æ–Ω–¥ –ü–æ–≤–µ—Ä–Ω–∏—Å—å –∂–∏–≤–∏–º¬ª,4829,4829,-25000,-25000,980,0,0,1861130,True
hQJlJjniSIwqIEAh,1669930642,473121****8302,4829,4829,-64322,-64322,980,0,0,1886130,True,916B-HMA2-XEKC-EAX5
Gi_P30KUi3Hg8VrR,1675104435,LIQPAY*ZL Vet,742,742,-65000,-65000,980,0,0,1826454,False,C434-TT5C-3660-6858
S99XeIdAZ2TbDinK,1675099706,–ö–æ–ª–æ,5411,5499,-12000,-12000,980,0,90,1891454,False,5MAM-64AP-8B58-CX7E
vrEOi5AGJLIkwfaq,1675082101,KAFE,5812,5812,-10500,-10500,980,0,78,1903454,False,B137-XEPT-8KTX-M4PA
v_u9tmbjEV0KhZDs,1675074966,–°—ñ–ª—å–ø–æ,5411,5411,-24698,-24698,980,0,185,1913954,False,C61A-88P1-T1A9-5KX3
vo8CxwngH2VtqG5O,1675064517,StudijaKvitivtadekoruS,5992,5992,-105450,-105450,980,0,0,1938652,False,7362-4068-T14B-307X
rc6RbTNb95FSAjqv,1675004700,–°—ñ–ª—å–ø–æ,5411,5411,-38098,-38098,980,0,380,2044102,False,099X-H78A-H718-C6ET
R-XGAFZP_tDUKncn,1674998685,Fresh Dzhus end Babl Ti S,5812,5812,-15800,-15800,980,0,316,2082200,False,09AB-T79A-ABBE-C4AH
Hor08afNWnmf6giR,1674998454,ITIS CAFE,5814,5814,-26600,-26600,980,0,532,2098000,False,BB2M-00C5-B25E-4958
9U4x_IXJtrauoEIG,1674986139,VeterinarniyshpitalGen,742,742,-70500,-70500,980,0,0,2124600,False,389E-ABT8-65AB-7P7E
k27NjU8GYwLWzW_q,1674976277,–û–±—Å–ª—É–≥–æ–≤—É–≤–∞–Ω–Ω—è –ø–ª–∞—Ç–∏–Ω–æ–≤–æ—ó –∫–∞—Ä—Ç–∫–∏,4829,4829,-30000,-30000,980,0,0,2195100,True
y9OFauOGHGRMRdBx,1674926945,Bolt,4121,4121,-8000,-8000,980,0,0,2225100,False,PX4A-1MAE-MAT2-64K4
e7EccISoMQsLzeBS,1674924306,StudijaKvitivtadekoruS,5992,5992,-142500,-142500,980,0,0,2233100,False,XC6T-CP4T-A4CT-82TA
vfCrnAloc2Ae4Dxp,1674906392,–ê–ø—Ç–µ–∫–∞ –ê–ù–¶,5912,5912,-17600,-17600,980,0,0,2375600,False,2CXX-4XPX-2TB1-H5B7
GdC9Npy6hjJDI12W,1674905861,magazin 762597,5912,5912,-55190,-55190,980,0,0,2393200,False,4EC2-XX40-5ET4-27BM
2n7FQ1klLYXsm8Se,1674905594,–¢–∞–±–∞–∫–µ—Ä–∫–∞,5993,5993,-37000,-37000,980,0,0,2448390,False,0AE4-T0T8-2HPC-K9TP
CK_GBOS1CN7hGUp4,1674905426,Novus,5411,5411,-82416,-82416,980,0,824,2485390,False,1640-30KM-494E-K686
l0WzFrjc3y1xvXHX,1674898108,La fabrique,5814,5814,-19500,-19500,980,0,390,2567806,False,0X83-75CE-7E0X-8801
6d8ZS7xz_qfXA2g2,1674897649,–í—ñ–¥: –î–µ–Ω–∏—Å –ö–æ—Ç–æ–≤,4829,4829,35000,35000,980,0,0,2587306,True
ZgyuGeiSA2UAuz0p,1674895116,Novapay,8999,8999,-6100,-6100,980,0,0,2552306,False,1KC4-012M-HM8C-M32E
YL2s7SqPgDLgnh2O,1674895037,Novapay,8999,8999,-5000,-5000,980,0,0,2558406,False,EX0K-B125-X4H4-P9M3
Y4JRqsMj60-2jAXY,1674846550,NEGRONI Aperitivo Bar,5813,5813,-44000,-44000,980,0,880,2563406,False,5A3M-AEH8-A34E-3P33
ocvF2U0mEi0mNcJY,1674844214,–•–º—ñ–ª—å–Ω–∏–π –ö–Ω—è–∑—å,5812,5812,-34000,-34000,980,0,680,2607406,False,9TX5-08TX-332B-059C
me4eA7MopCAsUCOw,1674844194,RESTORAN KHMILNYY KNYAZ,5812,5812,-81000,-81000,980,0,1620,2641406,False,M334-TB9B-K8KC-XAEB
d2CkMgxu0puH0Apu,1674819913,Bestwaytocup,5814,5814,-9000,-9000,980,0,180,2722406,False,5E3X-BH1K-9H5A-4719
Xb87obnul9gqbaSN,1674816537,–íi–¥: –ü–†–ò–•–û–î–¨–ö–û –ï.–í. –§–û–ü,"–î–ª—è –ø–æ–ø–æ–≤–Ω–µ–Ω–Ω—è –∫–∞—Ä—Ç–∫–∏ 5375414101190360, –ü—Ä–∏—Ö–æ–¥—å–∫–æ –ï—Ä–Ω–µ—Å—Ç –íi–∫—Ç–æ—Ä–æ–≤–∏—á, 3487403339",4829,4829,2500000,2500000,980,0,0,2731406,True
eZpQghu0rpOtRaem,1674814419,Portmone,5944,5944,-789000,-789000,980,0,0,231406,False,5442-E2AH-H188-27EC
KCYVOEufiPvjuV1t,1674814383,–ó –±—ñ–ª–æ—ó –∫–∞—Ä—Ç–∫–∏,4829,4829,500000,500000,980,0,0,1020406,True
gjRwbeS_CDUEV7If,1674809246,–°—ñ–ª—å–ø–æ,5411,5411,-39750,-39750,980,0,298,520406,False,7594-7M46-T1XP-K606
6XIdHjcjM-drPT5K,1674809113,–°—ñ–ª—å–ø–æ,5411,5411,-19895,-19895,980,0,149,560156,False,3CB1-XP6P-HE7P-4999
5ktZRc_GMmymaV4I,1674738098,FDY*Food_SSL,5499,5499,-97450,-97450,980,0,730,580051,False,7079-T653-K0M6-7993
ySudDlu3HNdRp8XC,1674727189,WFP.AQUAMARKET,5411,5411,-26980,-26980,980,0,202,677501,False,8TXH-6A7P-PMC4-P240
jpMqBd4kqfTCGa9C,1674724562,LIQPAY*Pethouse,5995,5995,-265600,-265600,980,0,0,704481,False,HT02-T27P-MBM2-9TAX
YW0MF3ODogTXhE8F,1674676864,–ö–∏—ó–≤ –¶–∏—Ñ—Ä–æ–≤–∏–π,4111,4111,-14000,-14000,980,0,0,970081,False,65HX-7T73-0T61-1TC1
Q2iF4lg6pUcOjphK,1674672912,–°—ñ–ª—å–ø–æ,5411,5411,-39750,-39750,980,0,298,984081,False,103T-8T3M-315B-1H16
x0TRb5dMK4oaHG8z,1674672797,–°—ñ–ª—å–ø–æ,5411,5411,-126151,-126151,980,0,946,1023831,False,X879-4E19-6A7B-2AKP
xQvhF9rszOfmdlXI,1674666484,SEJNOUMO1,5814,5814,-87500,-87500,980,0,656,1149982,False,KBM7-BETE-1CHK-4H94
2ml6zisDq0EjgfWS,1674665076,Novapay,5691,5691,-129000,-129000,980,0,0,1237482,False,A5ME-0TXX-1M40-EE6M
1Yr4mEREZBk1swv-,1674662391,–ö–∏—ó–≤ –¶–∏—Ñ—Ä–æ–≤–∏–π,4111,4111,-10500,-10500,980,0,0,1366482,False,BEX8-EPMA-K931-40EC
Ohhtzu6I9ahdbhEU,1674656118,–ü–∏—Ä—ñ–∂–∫–æ–≤–∞ ¬´–¢—ñ—Ç–∫–∞ –ö–ª–∞—Ä–∞¬ª,5814,5814,-11800,-11800,980,0,88,1376982,False,2K63-0AHT-A6BK-819P
24gCVGAJeHDkD8j8,1674655908,–ö–æ–ª–æ,5411,5499,-42420,-42420,980,0,318,1388782,False,73A9-80X1-MBBX-TTAK
XsGwz5yXqs2oF7mK,1674651856,–°—ñ–ª—å–ø–æ,5411,5411,-42496,-42496,980,0,318,1431202,False,8M8H-0200-EHEC-5E6A
tN9oiNbauBXBMTp1,1674579919,FDY*Food_SSL,5499,5499,-52930,-52930,980,0,396,1473698,False,BA55-67ET-0P9X-22K1
-pnPMpU2VeAmcZqE,1674575245,–°–æ–∫—Ä–∞—Ç,5943,5943,-1890,-1890,980,0,0,1526628,False,10M9-6K66-1H42-0A0P
ODMQ5pOc6eLvUbxe,1674575141,JYSK,5712,5712,-24900,-24900,980,0,0,1528518,False,XT8A-H1A4-2HT8-600P
VhbMt8oodRJYe-1q,1674564306,VeterinarniyshpitalGen,742,742,-357000,-357000,980,0,0,1553418,False,C213-6KXP-CC57-BK8B
QjEQ5Ydslk_PFR50,1674558012,FDY*CLOTHING,5691,5691,-220000,-220000,980,0,0,1910418,False,AA50-937X-KX10-B610
eYY2HbrbT1ENRATw,1674557921,–ü–µ—Ä–µ–∫–∞–∑ –Ω–∞ –∫–∞—Ä—Ç–∫—É,4829,4829,-1300000,-1300000,980,0,0,2130418,True
Gp9iOFn_-P-u8qcc,1674557560,Bestwaytocup,5814,5814,-9000,-9000,980,0,180,3430418,False,C018-B3E3-EX53-ECXX
b4Dq2MFPLUZXZO8V,1674551878,–íi–¥: –ü–†–ò–•–û–î–¨–ö–û –ï.–í. –§–û–ü,"–î–ª—è –ø–æ–ø–æ–≤–Ω–µ–Ω–Ω—è –∫–∞—Ä—Ç–∫–∏ 5375414101190360, –ü—Ä–∏—Ö–æ–¥—å–∫–æ –ï—Ä–Ω–µ—Å—Ç –íi–∫—Ç–æ—Ä–æ–≤–∏—á, 3487403339",4829,4829,3200000,3200000,980,0,0,3439418,True
41a-KHn9MileRq82,1674546693,Novapay,8999,8999,-10000,-10000,980,0,0,239418,False,E61P-5P5A-B95P-T3H6
mJigKg50HWE4jypi,1674479890,–ö–æ–ª–æ,5411,5499,-16200,-16200,980,0,121,249418,False,9835-461T-BCT5-MA5X
DH8QvLLTWhHvxXDE,1674479689,PershaRestoraciyaShaurmi,5814,5814,-21900,-21900,980,0,164,265618,False,286C-281B-ACH9-5074
pSlkWqbfzXSlfyub,1674478047,KAFE,5812,5812,-7500,-7500,980,0,56,287518,False,0THE-37HT-PKKT-A0ET
g92J9FzdWJqohY0_,1674472026,–°—ñ–ª—å–ø–æ,5411,5411,-15710,-15710,980,0,117,295018,False,876B-31H5-289M-KB74
Kjw5radgZfllkb-a,1674400930,–ê–¢–ë,5499,5411,-5780,-5780,980,0,43,310728,False,86AM-1094-C1X5-0809
M3p4CL3Iz04hAnY9,1674400292,Namelaka,5814,5814,-30000,-30000,980,0,225,316508,False,P6AM-CM7P-X7XB-8K74
CyvV1_UFcrwPaSvJ,1674393307,Cifra,5932,5932,-9000,-9000,980,0,0,346508,False,62XP-4609-7718-KHCX
qC45VoREv-Gtl211,1674393304,–ó –±—ñ–ª–æ—ó –∫–∞—Ä—Ç–∫–∏,4829,4829,200000,200000,980,0,0,355508,True
6--BxTyB_sIwK5gH,1674392810,Vartsab,5814,5814,-19000,-19000,980,0,142,155508,False,6B3E-H7K0-4988-37MM
WfYIvmvAVjXkAgJh,1674392069,magazin 762597,5912,5912,-3895,-3895,980,0,0,174508,False,BM70-M0B4-4M9B-0C76
3PuBU31SehSg1KMN,1674383424,–ê–ø—Ç–µ–∫–∞ –ê–ù–¶,5912,5912,-86940,-86940,980,0,0,178403,False,550X-P66E-2961-M563
b9i0uBp0POcSh5Ch,1674376538,OK Wine,5411,5411,-34650,-34650,980,0,259,265343,False,24C4-PA10-AB08-KCP7
YK0LWku2GqQX-T92,1674374907,Bestwaytocup,5814,5814,-6500,-6500,980,0,48,299993,False,P09M-2H0E-C894-400H
wrtfavoD0XdM_7_9,1674374566,Bestwaytocup,5814,5814,-5500,-5500,980,0,41,306493,False,XE07-1H47-P8A2-E2K5
Iox56cYRbs53tLfF,1674374223,Bestwaytocup,5814,5814,-27500,-27500,980,0,206,311993,False,H144-8XHM-8KPC-H3A2
QTZjjIH6ruL_Ny-A,1674337368,LIQPAY*Pethouse,5995,5995,-98800,-98800,980,0,0,339493,False,3M3B-6ECC-BMA0-9PAK
VwRg4T7NPvXLYrB_,1674310876,–°—ñ–ª—å–ø–æ,5411,5411,-131605,-131605,980,0,987,438293,False,PHEP-4TE4-H8ET-23EX
G9Th1FypJ2JnC3VF,1674309869,SECHST,5912,5912,-40185,-40185,980,0,0,569898,False,5K0K-91E3-1PHP-EA6E
rrOe70Okihk_ZKhH,1674307886,VET. TOVARY D 55,742,742,-50000,-50000,980,0,0,610083,False,866C-THE6-BB29-HXH9
aAL6RR2NkJ0mNUGO,1674304170,Vodafone,4814,4814,-500,-500,980,0,0,660083,False,9TH1-869H-T8MA-C0A5
NFz9ztZmRPtNFMvF,1674217622,OK Wine,5411,5411,-41040,-41040,980,0,307,660583,False,73E1-9560-X44X-T7P8
ky8EqLlghrxKbcGW,1674211365,VeterinarniyshpitalGen,742,742,-723400,-723400,980,0,0,701623,False,X858-5XP4-78P4-B40C
LfRH5u-08I6TTAVm,1674196853,ZOOLYUKS,5995,5995,-148300,-148300,980,0,0,1425023,False,7XEA-325K-PT9A-41E1
Wwvblx85UlF0jAGO,1674196209,MagazinProdukti,5499,5499,-3900,-3900,980,0,29,1573323,False,3T3B-1239-C77B-4130
S4_H2eyxqK-7NIWQ,1674163530,LIQPAY*Sabi,5200,5200,-50000,-50000,980,0,0,1577223,False,B7BB-H71M-KPMC-T3HX
6fPQRuz4y2kGrdwc,1674135416,–ü–∏—Ä—ñ–∂–∫–æ–≤–∞ ¬´–¢—ñ—Ç–∫–∞ –ö–ª–∞—Ä–∞¬ª,5814,5814,-26500,-26500,980,0,198,1627223,False,077P-2E36-H0MP-876H
nC9U2qt_4FwqJK6I,1674125578,–°—ñ–ª—å–ø–æ,5411,5411,-24217,-24217,980,0,181,1653723,False,TP87-61X4-367M-K70M
YtNNOhOXrxUEllgk,1674115552,Dubler,5814,5814,-19000,-19000,980,0,142,1677940,False,K82E-2KC1-P38M-22MM
mUBYWuSdklriG9ym,1674115145,"Lifecell
+380631692598",4814,4814,-50000,-50000,980,0,0,1696940,True,9181-HM9B-5238-XT2P
ml_gW1TtKZlyJwgH,1674062223,Yaroslaviv Val 37-1,5499,5499,-87000,-87000,980,0,652,1746940,False,E9KM-APBP-9632-531K
ssI48-m4p8611Ytm,1673983592,LIQPAY*Pethouse,5995,5995,-377000,-377000,980,0,0,1833940,False,13TK-X0XK-M020-XXMA
aKQlmNT2ugmnLwrt,1673979170,–ü–µ—Ä–µ–∫–∞–∑ –Ω–∞ –∫–∞—Ä—Ç–∫—É,4829,4829,-1200000,-1200000,980,0,0,2210940,True
ixjtb9E266L-G9hl,1673973917,–°—ñ–ª—å–ø–æ,5411,5411,-136866,-136866,980,0,1368,3410940,False,8108-7PXT-8CH2-XHT1
lbHk0hPv2EGJn-Zy,1673958022,–íi–¥: –ü–†–ò–•–û–î–¨–ö–û –ï.–í. –§–û–ü,"–î–ª—è –ø–æ–ø–æ–≤–Ω–µ–Ω–Ω—è –∫–∞—Ä—Ç–∫–∏ 5375414101190360, –ü—Ä–∏—Ö–æ–¥—å–∫–æ –ï—Ä–Ω–µ—Å—Ç –íi–∫—Ç–æ—Ä–æ–≤–∏—á, 3487403339",4829,4829,3300000,3300000,980,0,0,3547806,True
MJ58vK1OzM9z8kMz,1673950196,Bestwaytocup,5814,5814,-9000,-9000,980,0,67,247806,False,KM37-M0PC-6M03-83TK
U7oLNYrE006ugcrA,1673950042,La fabrique,5814,5814,-20000,-20000,980,0,150,256806,False,9882-0TH5-EBH8-9THE
q0zQnyjsOX7stQ1P,1673949870,–ù–æ–≤–∞ –ø–æ—à—Ç–∞,4214,4214,-3500,-3500,980,0,0,276806,False,M41H-164K-915E-2A8P
yI_qmQGpdb0sQo_i,1673896051,WFP.AQUAMARKET,5411,5411,-48580,-48580,980,0,364,280306,False,6607-B6B4-ETB2-6TXA
CTg5WTuMKWFt3hnv,1673888041,–°–∫–∞—Å—É–≤–∞–Ω–Ω—è. Bolt Food,4215,4215,67500,67500,980,0,0,328886,False
iOdbON1w_TdLeUIb,1673887952,Bolt Food,4215,4215,-67500,-67500,980,0,0,261386,False
0cjTxJgjuzgYXrcd,1673859764,Produktova lavka Zoloti v,5499,5499,-52970,-52970,980,0,397,328886,False,1AX1-X212-X654-A4C0
cHk6SZSh3HKbv-Bs,1673786275,FDY*FOOD,5499,5499,-48300,-48300,980,0,362,381856,False,KP1T-PETC-XCMX-H562
4BfhEbJTHIElYesD,1673786158,–ó –±—ñ–ª–æ—ó –∫–∞—Ä—Ç–∫–∏,4829,4829,200000,200000,980,0,0,430156,True
bMMAx2a0fKUiU7TX,1673766810,–ö–æ–ª–æ,5411,5499,-15980,-15980,980,0,119,230156,False,39TP-MA6E-E446-HP04
DNzjKm5mXHFOViBo,1673766567,magazin 726008,5912,5912,-14480,-14480,980,0,0,246136,False,090M-4APH-AM82-H074
JXS2a3Xtg6RxaFVH,1673766374,–°—ñ–ª—å–ø–æ,5411,5411,-40033,-40033,980,0,300,260616,False,TM04-E1HM-5KBX-X9TM
itGWknsYehmbRKFz,1673715852,30880,5912,5912,-64840,-64840,980,0,0,300649,False,KTA3-9CM9-973C-E89E
3zm8ozXEqLHxk6wm,1673715372,18shop,7221,7221,-82000,-82000,980,0,0,365489,False,KMHK-XE85-11PK-X2KK
smg83ikWFKIcX_3F,1673702689,Novapay,8999,8999,-13000,-13000,980,0,0,447489,False,384B-0520-7K0H-0K51
F21i5L-e9M4yyDGo,1673702664,Novapay,8999,8999,-9500,-9500,980,0,0,460489,False,127M-MM42-XBM7-AX55
o9OiDGz_BN3oTZ_O,1673693917,Spelta,5814,5814,-25500,-25500,980,0,191,469989,False,771C-AA65-H6P5-86BT
M-VTCK-TIjuFgE7s,1673693595,–°–ü√â–õ–¨–¢–ê,5812,5812,-40600,-40600,980,0,304,495489,True,4881-19M0-20XT-60KK
QiZq4AW5B14rqEjf,1673686274,–¢–∞–±–∞–∫–µ—Ä–∫–∞,5993,5993,-16000,-16000,980,0,0,536089,False,TB84-XX6E-TKEE-7CP7
ORrrSw1alPURJnZZ,1673686205,Novus,5411,5411,-26546,-26546,980,0,199,552089,False,K333-B36E-A5TC-X24C
LWEfnCogThjk6hfA,1673628159,FDY*FOOD,5499,5499,-129685,-129685,980,0,972,578635,False,9HE5-A5HT-9E31-5B29
0OovRujXErEj2Gn4,1673616790,GUNIA PROJECT,5719,5719,-750000,-750000,980,0,0,708320,False,2HK9-79TK-E9HP-9B09
2Nf17DJa74Pn8wn5,1673595962,La fabrique,5814,5814,-11000,-11000,980,0,82,1458320,False,B1K6-1PB3-K383-H8X2
FXyEzdNzhwOavfAt,1673528273,–°–∫–∞—Å—É–≤–∞–Ω–Ω—è. Kafe Right Coffee Bar,5814,5814,11500,11500,980,0,-86,1469320,False
qE-WpGplACHY3x9s,1673527780,Kafe Right Coffee Bar,5814,5814,-11500,-11500,980,0,86,1457820,False
RNpwVD0QYm4XDu0T,1673525521,OK Wine,5411,5411,-77710,-77710,980,0,582,1469320,False,40MP-5511-P6C0-X8PE
l4xtVTrsaOsYWxa7,1673524952,PershaRestoraciyaShaurmi,5814,5814,-22400,-22400,980,0,168,1547030,False,40H4-1E92-13TT-4E2C
NN9_2jkOuDZdgECv,1673454820,OKKO,5541,5541,-179912,-179912,980,0,0,1569430,False,65A1-X2A5-7B19-729T
JmkvynV5lCq8W5Ex,1673451978,Goodwine,5921,5921,-90400,-90400,980,0,678,1749342,False,BA66-648A-8M99-H0KC
TQ7oJIJ00-k2t9I_,1673436546,FDY*CLOTHING,5691,5691,-360000,-360000,980,0,0,1839742,False,KMA4-HM22-2PPH-4MMX
oNd9G4lRwBbG0f8D,1673428697,–ü–µ—Ä–µ–∫–∞–∑ –Ω–∞ –∫–∞—Ä—Ç–∫—É,4829,4829,-1500000,-1500000,980,0,0,2199742,True
wlr9DRf0BFIhgpvh,1673428662,–íi–¥: –ü–†–ò–•–û–î–¨–ö–û –ï.–í. –§–û–ü,"–î–ª—è –ø–æ–ø–æ–≤–Ω–µ–Ω–Ω—è –∫–∞—Ä—Ç–∫–∏ 5375414101190360, –ü—Ä–∏—Ö–æ–¥—å–∫–æ –ï—Ä–Ω–µ—Å—Ç –íi–∫—Ç–æ—Ä–æ–≤–∏—á, 3487403339",4829,4829,3300000,3300000,980,0,0,3699742,True
S9RpVCqmNTlIBwLl,1673421169,Produkti,5499,5499,-16000,-16000,980,0,120,399742,False,4X8M-X8P4-6M9T-B333
Xtq2pNq-WndNNPGY,1673365800,–ù–æ–≤–∞ –ø–æ—à—Ç–∞,4214,4214,-5000,-5000,980,0,0,415742,False,2KAM-0BBX-1P08-APAA
z5W4tZGH3e9ngXWm,1673353488,FDY*Food_SSL,5499,5499,-85480,-85480,980,0,641,420742,False,A786-H53E-4A48-08X7
1J-x2mqU17PFrnVD,1673348609,–°–∫–∞—Å—É–≤–∞–Ω–Ω—è. LIQPAY*T.C.Pizza,5812,5812,56175,56175,980,0,-421,506222,False
Mh9h0g7pJ7n9o_SV,1673348570,LIQPAY*T.C.Pizza,5812,5812,-56175,-56175,980,0,421,450047,False
7InpZqQDk3xtGXrQ,1673283415,MAGAZIN,5399,5399,-16500,-16500,980,0,123,506222,False,CETP-3KK6-354K-M2PE
2nRC4eFuogxbj6yS,1673283357,–§–ö –ï–í–û,5399,5399,-69900,-69900,980,0,524,522722,False,M1HT-T04A-H271-2BMX
_q-zsjvIkmiSmryu,1673282141,LIQPAY*Pethouse,5995,5995,-265600,-265600,980,0,0,592622,False,CH0A-9X6T-5139-EXPH
JScQ53Hy9XN2Fl35,1673275275,Novapay,8999,8999,-59900,-59900,980,0,0,858222,False,4EC9-BA2M-24E6-E64B
IhaOCxpAIsH6rNqG,1673274016,Simona,5814,5814,-28500,-28500,980,0,213,918122,False,K2M5-6KT1-A8EK-7088
5_owmPO5gCwHu4cl,1673273705,OkvajnSichovih,5399,5399,-51000,-51000,980,0,382,946622,False,2CA9-7BAM-X1X9-6AK8
Wr6-5YSJh6m_GxaU,1673260598,–°—ñ–ª—å–ø–æ,5411,5411,-20925,-20925,980,0,156,997622,False,HKAM-5A35-B9XK-A8M9
blknirtr7ekvm1dN,1673250587,–°—ñ–ª—å–ø–æ,5411,5411,-77049,-77049,980,0,577,1018547,False,P986-4X02-02P9-8210
ntBJuThvZF_ADlb4,1673194803,Beer Market,5921,5921,-14985,-14985,980,0,112,1095596,False,AX15-H82X-62E3-CXP3
y417eBtKF3pF-h7z,1673180216,Novus,5411,5411,-15862,-15862,980,0,118,1110581,False,M46K-52B7-6K61-1X88
ucQH5NTxADgJZt2j,1673179763,–ù–æ–≤–∞ –ø–æ—à—Ç–∞,7399,7399,-5000,-5000,980,0,0,1126443,False,9X07-771T-507A-E0PE
PGSNDFbWN6jsI_KG,1673171175,–ù–æ–≤–∞ –ø–æ—à—Ç–∞,7399,7399,-4000,-4000,980,0,0,1131443,False,TP30-MPXB-9MTA-T3BA
N941-zpp2I6f9j41,1673168665,Bestwaytocup,5814,5814,-9000,-9000,980,0,67,1135443,False,4BXA-6T7H-E3P9-57EH
fMzgiCM20l64y-MS,1673167578,SALON BACKSTAGE,7230,7230,-72000,-72000,980,0,0,1144443,False,ABX8-C9P6-PMBC-11K3
i-7a149_0NLK-FCt,1673163433,Vodafone,4814,4814,-14000,-14000,980,0,0,1216443,False,E489-C6B5-6PTM-BC7E
mINSHNZbuqgdnj0z,1673127450,DNH*GODADDY.COM UAH,4816,4816,-7982,-7982,980,0,0,1230443,False,TCCP-3CX2-14XE-7H77
q1wSInsqj7z3rueJ,1673113951,LIQPAY*TM Choven,5942,5942,-56000,-56000,980,0,0,1238425,False,30BE-9MTB-A2M1-6722
5csnqq07nlrU1MlY,1673110348,–ï–∫–æ-–õ–∞–≤–∫–∞,5411,5499,-63100,-63100,980,0,473,1294425,False,CMAX-ACX6-92E6-T904
mwTE4D0x6JrPRMbq,1673103630,LIQPAY*TM Choven,5942,5942,-28000,-28000,980,0,0,1357525,False,BA54-KXK4-9T1A-6H81
8CxQ0Hgug0wQiSyC,1673092815,TOV V REBRO,5812,5812,-8500,-8500,980,0,63,1385525,False,1K6B-2B2H-6PHE-HP2H
fRntO9NeTt9SG9d8,1673092801,TOV V REBRO,5812,5812,-102700,-102700,980,0,770,1394025,False,KB70-49B9-4388-CC0P
XUVV4fzZa-gSAG5L,1673089875,Goodwine,5921,5921,-241300,-241300,980,0,1809,1496725,False,50KP-XECH-77AT-7TT2
HOPvO_U9oDanpMe1,1673086836,Syndykat,5651,5651,-189000,-189000,980,0,0,1738025,False,26HH-TP0M-5H7M-75B8
POrh1f82C7qWJZ5r,1673086002,MagazinAkademkniga7NAN,5942,5942,-11200,-11200,980,0,0,1927025,False,BE86-B1HP-943C-6CCM
BW6Idi4ju-xi1y7z,1673080535,FOP Sturova AS,5814,5814,-49500,-49500,980,0,371,1938225,False,0A4E-PTMC-X80M-C5XK
enmsRai6vGBDv3jO,1673028037,Dubler,5814,5814,-38000,-38000,980,0,606,1987725,False,684M-XMH1-X0B6-4456
xvt-6ZUQ-uwkwpje,1673028022,kaphedubler,5814,5814,-11500,-11500,980,0,230,2025725,False,H87M-KX48-44P8-2H54
mI3ZKjsED5yjHcFz,1673026376,Integral Fitness Studio,7997,7997,-39000,-39000,980,0,0,2037225,False,XE1P-3759-K30C-81X6
fSQS-BlOA9eBlwzy,1673010777,OK Wine,5411,5411,-35800,-35800,980,0,358,2076225,False,203A-8A42-4MM9-6P8P
eA8JMDmR87zgNFpG,1673010460,–ö–æ–ª–æ,5411,5499,-15140,-15140,980,0,151,2112025,False,6M2K-7AMK-52MA-1HH0
1mocsc1gvfBHVl7l,1673010309,PershaRestoraciyaShaurmi,5814,5814,-28700,-28700,980,0,574,2127165,False,0MPH-1TE5-H1HC-9080
3Zsf2akrhjeAI8AJ,1673006198,United24.Defence,8398,8398,-10000,-10000,980,0,0,2155865,False,EHT4-5995-2690-001A
-_jRUBhsMvQQDt6O,1673006135,–û–∫—Å–∏–º–µ—Ü—å –û.–û,4829,4829,-45900,-45900,980,0,0,2165865,True,XKKB-MPX8-PTX9-CMAM
LR7GEdasaa_QMTvW,1673006029,LIQPAY*Fonarik.com,5941,5941,-146000,-146000,980,0,0,2211765,False,HAC5-KH8B-7BMT-A110
LDEwlkMYgXlv4Bzy,1673000339,–íi–¥: –ü–†–ò–•–û–î–¨–ö–û –ï.–í. –§–û–ü,"–î–ª—è –ø–æ–ø–æ–≤–Ω–µ–Ω–Ω—è –∫–∞—Ä—Ç–∫–∏ 5375414101190360, –ü—Ä–∏—Ö–æ–¥—å–∫–æ –ï—Ä–Ω–µ—Å—Ç –íi–∫—Ç–æ—Ä–æ–≤–∏—á, 3487403339",4829,4829,2200000,2200000,980,0,0,2357765,True
k510ojhV3H14hgWS,1672996531,KAFE,5812,5812,-8700,-8700,980,0,65,157765,False,7K8M-6KAA-09M4-M9A1
wcylSgltusM4twWa,1672939711,Bolt Food,4215,4215,-60300,-60300,980,0,0,166465,False,07EM-BHHK-T927-0383
w97DqFYjlr7lnLGr,1672938658,magazin 762597,5912,5912,-146190,-146190,980,0,0,226765,False,X9B9-3636-K4P5-581P
CQinqiq1nw0MfMD4,1672932728,Novapay,8999,8999,-43900,-43900,980,0,0,372955,False,2CA9-7708-4CCE-6700
LyNgIk9YBgVYvn0H,1672932682,Novapay,8999,8999,-25600,-25600,980,0,0,416855,False,18MK-4CHH-6T17-X8C8
mpa1NoLuu1Y2XGKE,1672908628,Bestwaytocup,5814,5814,-25500,-25500,980,0,191,442455,False,C077-ACE6-XH95-M212
uBIVQpc7wrcWaLeo,1672854499,Bolt Food,4215,4215,-38600,-38600,980,0,0,467955,False,3KCH-99HH-0253-98MB
YrqI5wfsSwG1Ml9e,1672837504,StudijaKvitivtadekoruS,5992,5992,-52500,-52500,980,0,0,506555,False,EE80-2M64-CABX-A4MK
l7k96K_hCVlmH7OJ,1672837014,Produkti,5499,5499,-24000,-24000,980,0,180,559055,False,K5P2-0M80-T904-5060
fSmE7BtEQo9Hi9FW,1672830489,Novapay,8999,8999,-25600,-25600,980,0,0,583055,False,CC3T-4T50-ETM7-6XX6
QHcKyAkgL0ch5fRn,1672830374,Novapay,8999,8999,-25600,-25600,980,0,0,608655,False,BM97-EB6C-4PH1-6A1M
RW__gdri9-vykCXI,1672829093,WFP.AQUAMARKET,5411,5411,-41980,-41980,980,0,314,634255,False,375A-B8PP-K31K-5K0A
daJzeaYQgqn44zwl,1672824771,Mates,5812,5812,-9000,-9000,980,0,67,676235,True,8T9E-2X56-5K81-ET0X
ig25AIJrr104PBvk,1672819609,JYSK,5200,5200,-40500,-40500,980,0,0,685235,False,2594-X4T4-4AP2-XTAP
WFmDybZXUl3ng5Ip,1672782824,FDY*Jewelry_SSL,5944,5944,-35000,-35000,980,0,0,725735,False,B7T8-C1X8-1TA3-5B83
9C993apLTJW4Eq9F,1672776983,LIQPAY*Pethouse,5995,5995,-385100,-385100,980,0,0,760735,False,E0HK-MP8E-MP24-6H79
GsM0S-kBsMIF-PN6,1672768616,–°—ñ–ª—å–ø–æ,5411,5411,-59294,-59294,980,0,444,1145835,False,P025-2B54-6XPA-1BTH
3uZJUaxE91RIUPFi,1672766915,Integral Fitness Studio,7997,7997,-39000,-39000,980,0,0,1205129,False,M8PH-A373-KBMH-319C
vn3Keq0JWmiQHUwc,1672758355,LIQPAY*TOV NASh FORMA,5942,5942,-28000,-28000,980,0,0,1244129,False,H0X3-0A4B-BAHE-33KH
8M-Pw9YBPHrN3hEd,1672742227,–°—ñ–ª—å–ø–æ,5411,5411,-17184,-17184,980,0,128,1272129,False,C0M2-3HMM-28M8-PC2H
mqHuTY7EAb2cC-TW,1672685701,"–ö–∞—Ñ–µ ""–ö–æ–º–µ—Ç–∞""",5812,5812,-27500,-27500,980,0,206,1289313,True,H39P-X469-PPH4-0B2B
1EtjHN5RqCz28sDq,1672680975,OK Wine,5411,5411,-43400,-43400,980,0,325,1316813,False,41X6-150B-XBPE-80H5
fUp1om1OtTHtJSQY,1672679405,Novapay,8999,8999,-7000,-7000,980,0,0,1360213,False,AT76-3BAH-71P7-K9C5
R5Ebn3vIjLVyVoj9,1672665846,OkvajnSichovih,5399,5399,-15900,-15900,980,0,119,1367213,False,22M5-XB9A-17K9-9M1B
XqeLCpGodRnHQb5y,1672665321,–°—ñ–ª—å–ø–æ,5411,5411,-64246,-64246,980,0,481,1383113,False,B20X-6789-2KX9-AB27
1vomRnBTtEJ61lwF,1672662215,–ö–∏—ó–≤ –¶–∏—Ñ—Ä–æ–≤–∏–π,4111,4111,-3500,-3500,980,0,0,1447359,False,T9H6-2A2E-B2B9-C6BC
QIfbAiH3P3ZeJc7Y,1672661275,–¢–∞–±–∞–∫–µ—Ä–∫–∞,5993,5993,-16000,-16000,980,0,0,1450859,False,548A-KB71-HAMT-A1XA
cqV7qwTnDOs4f59Y,1672661229,Novus,5411,5411,-12547,-12547,980,0,94,1466859,False,219H-P3BT-KKCK-0HCA
7mYPQpO9YiMG0RYo,1672658508,KnigarnyakavyarnyaSens,5814,5814,-12500,-12500,980,0,93,1479406,False,61TB-P7X9-M296-BKEH
s4hXJwWkU943iC-A,1672658312,Sens,5942,5942,-150000,-150000,980,0,0,1491906,False,9C62-C44A-T3HH-PCXE
Ig9LWClhHIyetFp8,1672649996,Bestwaytocup,5814,5814,-15500,-15500,980,0,116,1641906,False,HKTX-923A-H58P-K2A8
x9wWLckB4L--1OVk,1672590567,–ö–æ–ª–æ,5411,5499,-2150,-2150,980,0,16,1657406,False,K8MT-1X17-AK8M-546E
v3OdYBFPvSJlwr9b,1672583678,LIQPAY*TOV Mejkap Tre,5977,5977,-168400,-168400,980,0,0,1659556,False,KPC6-A7M5-0EP8-T2MC
GCYxqukk-BtW0eq1,1672581726,Varcab,5814,5814,-32000,-32000,980,0,240,1827956,False,22EE-6A89-40K6-5M71
UZ5Dr0dqKG2c2BqB,1672574586,–ú–µ–≥–∞–º–∞—Ä–∫–µ—Ç,5399,5411,-34500,-34500,980,0,258,1859956,False,783C-2KMB-B9C2-B8X1
wdfJDrYmf46K3nPV,1672574427,–ú–µ–≥–∞–º–∞—Ä–∫–µ—Ç,5399,5411,-77000,-77000,980,0,577,1894456,False,7E20-XBE2-M766-H1M7
pEtPKq5Buqtya2Zz,1675027396,–õ—ñ–Ω–∞ –ú.,–û–ª–µ—Å—è. –ü—ñ—Ä'—è ü™∂,4829,4829,-104000,-104000,980,0,0,1115900,True,4425-TX6A-139C-AXCT
9c8lm1gEtPu-D0kt,1674962234,–†–µ–≥—É–ª—è—Ä–Ω–µ –ø–æ–ø–æ–≤–Ω–µ–Ω–Ω—è ¬´–§–æ–Ω–¥ –ü–æ–≤–µ—Ä–Ω–∏—Å—å –∂–∏–≤–∏–º¬ª,4829,4829,-25000,-25000,980,0,0,1219900,True
eCWBzGSEuj6v9qAs,1674814383,–ü–µ—Ä–µ–∫–∞–∑ –Ω–∞ –∫–∞—Ä—Ç–∫—É,4829,4829,-500000,-500000,980,0,0,1244900,True
44okD3yhzwtb86Bn,1674758940,Lesya,4829,4829,-150000,-150000,980,0,0,1744900,True,E4M4-HX79-4046-PE50
W5OK2EuiYKN860NR,1674588833,516933****1187,4829,4829,-510000,-510000,980,0,0,1894900,True,25X3-K652-BKM1-CX15
LENuYUUjvRESGY6e,1674557921,–ó –ø–ª–∞—Ç–∏–Ω–æ–≤–æ—ó –∫–∞—Ä—Ç–∫–∏,4829,4829,1300000,1300000,980,0,0,2404900,True
lgzCJHLUMSEBDR5t,1674510569,–ü–æ–ø–æ–≤–Ω–µ–Ω–Ω—è ¬´–¢–µ–ø–ª–æ–≤—ñ–∑—ñ–π–Ω–∏–π –ø—Ä–∏—Ü—ñ–ª¬ª,4829,4829,-100000,-100000,980,0,0,1104900,True,MX58-7MT6-PK9H-7T92
CevsaH4BF6R0wben,1674510233,–ü–æ–ø–æ–≤–Ω–µ–Ω–Ω—è ¬´–ù–∞ –ø–ª–∞–Ω—à–µ—Ç¬ª,4829,4829,-50000,-50000,980,0,0,1204900,True,7PEA-21X2-9220-2070
yamFJmF13m8htebI,1674393304,–ü–µ—Ä–µ–∫–∞–∑ –Ω–∞ –∫–∞—Ä—Ç–∫—É,4829,4829,-200000,-200000,980,0,0,1254900,True
S6FlLM3rfi516Sk-,1674393286,Lesya,4829,4829,-300000,-300000,980,0,0,1454900,True,E5PH-H201-7K03-74B2
RPuno6-D4zTr8lWZ,1674357478,–†–µ–≥—É–ª—è—Ä–Ω–µ –ø–æ–ø–æ–≤–Ω–µ–Ω–Ω—è ¬´–§–æ–Ω–¥ –ü–æ–≤–µ—Ä–Ω–∏—Å—å –∂–∏–≤–∏–º¬ª,4829,4829,-25000,-25000,980,0,0,1754900,True
wcRDzTgla38AoojR,1674311857,414949****0043,4829,4829,-90000,-90000,980,0,0,1779900,True,T0B2-3T7E-1HTK-965K
-E4EKr2o2ayP5PNB,1674225408,–ü–æ–ø–æ–≤–Ω–µ–Ω–Ω—è ¬´–ù–∞ —Ä–µ–º–æ–Ω—Ç –º–∞—à–∏–Ω¬ª,4829,4829,-25000,-25000,980,0,0,1869900,True,7K1X-MM50-BT51-K484
WIQgdgP2Is9k5qcm,1674112168,–ü–æ–ø–æ–≤–Ω–µ–Ω–Ω—è ¬´–ù–∞ —à–æ–ª–æ–º¬ª,4829,4829,-50000,-50000,980,0,0,1894900,True,T0CA-5748-11TK-9M46
77rlCuPWd38Xj6L7,1674049542,–ù–∞—Ç–∞–ª—ñ—è –ê.,4829,4829,-14900,-14900,980,0,0,1944900,True,9864-7A92-8HBE-7816
aufkDG228ganK3Za,1673979170,–ó –ø–ª–∞—Ç–∏–Ω–æ–≤–æ—ó –∫–∞—Ä—Ç–∫–∏,4829,4829,1200000,1200000,980,0,0,1959800,True
_JPKvHcJdv5S7JF9,1673793054,Lesya,4829,4829,-500000,-500000,980,0,0,759800,True,A475-KEH6-HHEC-T972
4xQqQzG2OKMra0Bw,1673786158,–ü–µ—Ä–µ–∫–∞–∑ –Ω–∞ –∫–∞—Ä—Ç–∫—É,4829,4829,-200000,-200000,980,0,0,1259800,True
4SX90Ngt4ty3X7eZ,1673752807,–†–µ–≥—É–ª—è—Ä–Ω–µ –ø–æ–ø–æ–≤–Ω–µ–Ω–Ω—è ¬´–§–æ–Ω–¥ –ü–æ–≤–µ—Ä–Ω–∏—Å—å –∂–∏–≤–∏–º¬ª,4829,4829,-25000,-25000,980,0,0,1459800,True
44GOVJGuGgeAMHgi,1673699995,–ê—Ä—Å–µ–Ω –†.,4829,4829,-11000,-11000,980,0,0,1484800,True,X486-7C93-K7M5-0TKA
V9jUVDOMU85IY0mN,1673696960,–ë–æ–≥–¥–∞–Ω –õ.,4829,4829,-60000,-60000,980,0,0,1495800,True,6PBC-EAT4-MHEM-711X
fU1bzoX7NeknLs0B,1673560532,–ü–æ–ø–æ–≤–Ω–µ–Ω–Ω—è ¬´–ê–≤—Ç–æ –¥–ª—è –†–ï–†¬ª,4829,4829,-50000,-50000,980,0,0,1555800,True,C86M-MT1H-25M9-B8X3
B252lMr8RXH4d3DP,1673451251,Lesya,4829,4829,-500000,-500000,980,0,0,1605800,True,0E4K-MH0T-9HKH-5BE8
YxUwl22vp1sA5stG,1673428697,–ó –ø–ª–∞—Ç–∏–Ω–æ–≤–æ—ó –∫–∞—Ä—Ç–∫–∏,4829,4829,1500000,1500000,980,0,0,2105800,True
DTmRKlBh65oS5B_z,1673425500,Lesya,4829,4829,-300000,-300000,980,0,0,605800,True,PX96-5MB1-E7PA-1MM1
JAriHLfs5m2E2Flp,1673286653,Lesya,4829,4829,-300000,-300000,980,0,0,905800,True,8627-MX83-EB4C-247C
-69yB3f_f-j8iS3e,1673264533,414949****6124,4829,4829,-73000,-73000,980,0,0,1205800,True,E5C6-C903-M727-0HTC
G__UUV465wwHIywY,1673206394,537541****5985,–ë–ª—É—î—Ç—ñ,4829,4829,-1271200,-1271200,980,0,0,1278800,True,33T1-8TB5-5P78-072C
UOihA3hvGB20vzPQ,1673147864,–†–µ–≥—É–ª—è—Ä–Ω–µ –ø–æ–ø–æ–≤–Ω–µ–Ω–Ω—è ¬´–§–æ–Ω–¥ –ü–æ–≤–µ—Ä–Ω–∏—Å—å –∂–∏–≤–∏–º¬ª,4829,4829,-25000,-25000,980,0,0,2550000,True
rN2mFJNVh9wt7NQ1,1672930301,Lesya,4829,4829,-500000,-500000,980,0,0,2575000,True,EH49-0PPM-MX7A-M5CX
FmiXT3mq_xUZKqgb,1672926417,–ü–æ–ø–æ–≤–Ω–µ–Ω–Ω—è ¬´üá∫üá¶ –ù–∞ —Ä–µ–∞–±—ñ–ª—ñ—Ç–∞—Ü—ñ—é¬ª,4829,4829,-100000,-100000,980,0,0,3075000,True,6E15-XPM7-X5E3-C2H0
hkR86AO8iQ6R8LGT,1672744130,Lesya,4829,4829,-400000,-400000,980,0,0,3175000,True,H48T-TKPA-1MCK-X308
Dj-rn8Y6pQie7XWT,1672543352,–†–µ–≥—É–ª—è—Ä–Ω–µ –ø–æ–ø–æ–≤–Ω–µ–Ω–Ω—è ¬´–§–æ–Ω–¥ –ü–æ–≤–µ—Ä–Ω–∏—Å—å –∂–∏–≤–∏–º¬ª,4829,4829,-25000,-25000,980,0,0,3575000,True
D5sRTW_c6_wKAeh9,1677517757,FDY*Gifts,5947,5947,-42000,-42000,980,0,0,2036544,False,BX8P-7B30-BC1H-T19A
rGMzrkA--gKNMeSm,1677491581,–°—ñ–ª—å–ø–æ,5411,5411,-6499,-6499,980,0,0,2078544,False,327E-AEX0-K23X-2248
GCjuamYXZpAi9fr7,1677489397,AROMA BURO,5200,5200,-219700,-219700,980,0,0,2085043,True,HK7B-1P70-1C2X-0BPA
81vVWGSfA9E1dxGb,1677485593,Bestwaytocup,5814,5814,-5500,-5500,980,0,110,2304743,False,75KH-4AEX-XTP1-0AB9
mLE2tbdOIPkDK4oC,1677405374,SalonkrasotiHighFive,7230,7230,-90000,-90000,980,0,0,2310243,False,6PM9-CAX3-7592-XTE9
AfO9owhR6eBqebWq,1677337528,Novus,5411,5411,-13400,-13400,980,0,0,2400243,False,056X-PX1X-8ECC-XC7X
JfjDo0LqL4p2w-a1,1677331208,–°—ñ–ª—å–ø–æ,5411,5411,-39750,-39750,980,0,0,2413643,False,H147-91EM-7XBC-H229
wNe-yweMifoxb0wJ,1677331154,–°—ñ–ª—å–ø–æ,5411,5411,-15400,-15400,980,0,0,2453393,False,P4E7-7K8B-HKHM-A8AM
i1CybQdoYOh8e8r4,1677328537,KafeYIZHA,5814,5814,-27000,-27000,980,0,540,2468793,False,A96H-PX61-0328-3PE3
Sfgk1PQ_IHPeSNHM,1677327390,Mates,5812,5812,-16500,-16500,980,0,330,2495793,True,55E8-9B21-5M8P-C757
DAV4KUPfm6BAUG_J,1677324741,–íi–¥: –ü–†–ò–•–û–î–¨–ö–û –ï.–í. –§–û–ü,"–î–ª—è –ø–æ–ø–æ–≤–Ω–µ–Ω–Ω—è –∫–∞—Ä—Ç–∫–∏ 5375414101190360, –ü—Ä–∏—Ö–æ–¥—å–∫–æ –ï—Ä–Ω–µ—Å—Ç –íi–∫—Ç–æ—Ä–æ–≤–∏—á, 3487403339",4829,4829,2500000,2500000,980,0,0,2512293,True
XsQOMwD9w9pYYQiU,1677313667,Novus,5411,5411,-13400,-13400,980,0,0,12293,False,A953-3B43-K665-P26A
Yh8oZgfhADSJtTpm,1677262327,OkvajnSichovih,5399,5399,-169820,-169820,980,0,0,25693,False,M78P-E5AB-X4MK-0K9C
36U3fEnX8c8Tg8x5,1677261503,–°—ñ–ª—å–ø–æ,5411,5411,-28713,-28713,980,0,0,195513,False,B0XX-79P3-29CP-TEE2
xgCEHAsiPnWaz2w7,1677260802,"Apteka""TOVANRIGRUP""",5912,5912,-75250,-75250,980,0,0,224226,False,19E3-M912-EPAC-3BMC
zlrlHkHhrNThBhyx,1677260748,"Apteka""TOVANRIGRUP""",5912,5912,-142360,-142360,980,0,0,299476,False,920E-8B39-CXBM-1KCK
CH6HnUmV5wYqcXCB,1677237063,Kafe Right Coffee Bar,5814,5814,-7000,-7000,980,0,52,441836,False,6P54-B490-568P-723T
9lIHM61fWcjHSt8M,1677233988,5045Kavjarnja,5814,5814,-5500,-5500,980,0,41,448836,False,K6P6-EMA6-A3E5-4C9M
VWdaFx7gEHwSMVof,1677233968,5045Kavjarnja,5814,5814,-6500,-6500,980,0,48,454336,False,P5EB-EKK7-3CKM-P25E
LxJekYugPIytmKky,1677228351,Vodafone,4814,4814,-500,-500,980,0,0,460836,False,68M5-08TA-TC3C-X497
k9V1V9IYh6TUGVPF,1677222747,Kafe Right Coffee Bar,5814,5814,-18000,-18000,980,0,135,461336,False,2393-B38H-61HH-4703
UAq5JKesen3PVQSG,1677160957,OKKO,5541,5541,-117300,-117300,980,0,0,479336,False,70KK-00E7-P5B1-1C26
x5Y3uhVgP7Cj9yRT,1677158344,BarberPet,7230,7230,-130000,-130000,980,0,0,596636,False,K3BX-X159-63PH-XK0E
Us_rw-v-duB66bja,1677156810,Good Girl,5812,5812,-75400,-75400,980,0,565,726636,True,CC3T-HC2P-9AMC-3B0B
ao-T8WDREJA0_a5X,1677139738,WFPFASTFOOD1,5814,5814,-155000,-155000,980,0,1162,802036,False,EEHB-7EMP-MM13-H7BH
rJLtDnbIadGxWy8s,1677093357,LIQPAY*Pethouse,5995,5995,-306100,-306100,980,0,2295,957036,False,AK7H-M758-TB09-8PMH
CtLwM4a-1XriYb9w,1677054006,SECHST,5912,5912,-74868,-74868,980,0,0,1263136,False,57HT-4H3H-M6PT-H3MX
khSTPVFsUHLjAmuV,1677051433,Bestwaytocup,5814,5814,-6500,-6500,980,0,48,1338004,False,58M2-X9H3-X05A-7XKC
IruphGH5QYV3GLEE,1676996431,magazin 762597,5912,5912,-38344,-38344,980,0,0,1344504,False,KKK4-TTM9-28X8-3C34
9ci61dn0UKvLhS-y,1676996118,OK Wine,5921,5921,-52920,-52920,980,0,0,1382848,False,5T33-8843-P74X-81C3
zRtgoDsx04XU1xnL,1676995856,Novus,5411,5411,-9257,-9257,980,0,0,1435768,False,TX14-TMEE-C7PT-M0C1
en4eHoNcRgizdy6y,1676984047,–°—ñ–ª—å–ø–æ,5411,5411,-153467,-153467,980,0,0,1445025,False,3KA8-08C0-40BB-1B4C
EkbOod2aHMjWO8aP,1676969920,–°–ü√â–õ–¨–¢–ê,5812,5812,-89300,-89300,980,0,669,1598492,True,1E8H-K9TK-BH86-404A
qP6-3pbIL_bG93_1,1676890484,–°—ñ–ª—å–ø–æ,5411,5411,-12798,-12798,980,0,0,1687792,False,M3M8-MEEM-2CE0-137X
6oSXrJiYXtdhXg_w,1676826523,WFP.AQUAMARKET,5411,5411,-158080,-158080,980,0,0,1700590,False,T82P-B6H9-7226-15M2
KqZlxwIWcm3tk6kq,1676822298,Beer Market,5921,5921,-34633,-34633,980,0,0,1858670,False,607B-4HKA-CM9A-981A
IisbmIz3xXtf8oW4,1676822150,MolokovidPHermera,5499,5499,-11325,-11325,980,0,0,1893303,False,3EPX-TAHA-6P63-9BAT
W8JbqywCHFH86ESu,1676821807,Magazin Master Zoo,5995,5995,-58200,-58200,980,0,2910,1904628,False,7HXA-BBP3-94CA-8B28
zjGuKjl2MQxL78UW,1676802254,Fresh Dzhus end Babl T,5812,5812,-21300,-21300,980,0,159,1962828,False,EA14-BB58-THX2-0A79
1TSg0j9q5AVdsqyi,1676750946,Bolt,4121,4121,-21700,-21700,980,0,0,1984128,False,TH70-K9PA-3A69-7936
ao-T8WXSFZw9_61c,1676709974,–ê–ø—Ç–µ–∫–∞ –ê–ù–¶,5912,5912,-10950,-10950,980,0,0,2005828,False,9T6A-9E64-9X8P-0A05
uPUoz1KDIhure314,1676709601,La fabrique,5814,5814,-4500,-4500,980,0,90,2016778,False,79C6-42P4-P8HA-9C61
imbKHYmwk3X_OXpJ,1676709561,magazin 762597,5912,5912,-63146,-63146,980,0,0,2021278,False,H6C1-K4X8-XK14-PXA0
4rPvWCcjSVrIf4oI,1676709437,Novus,5411,5411,-44096,-44096,980,0,0,2084424,False,P086-B802-822E-AX8X
6Uxx_CENv7xYm6mi,1676705422,Novapay,8999,8999,-6500,-6500,980,0,0,2128520,False,HHB1-C2PA-53B0-6A2P
3eMc-Hey-ga_fn72,1676654962,Varvar bar,5812,5812,-96400,-96400,980,0,1928,2135020,False,1X99-4HKA-6B20-941A
R8614auW0odzZBMK,1676652477,–ü–µ—Ä–µ–∫–∞–∑ –Ω–∞ –∫–∞—Ä—Ç–∫—É,4829,4829,-2400000,-2400000,980,0,0,2231420,True
cMQ1lSX2V7t1bgxc,1676650335,–íi–¥: –ü–†–ò–•–û–î–¨–ö–û –ï.–í. –§–û–ü,"–î–ª—è –ø–æ–ø–æ–≤–Ω–µ–Ω–Ω—è –∫–∞—Ä—Ç–∫–∏ 5375414101190360, –ü—Ä–∏—Ö–æ–¥—å–∫–æ –ï—Ä–Ω–µ—Å—Ç –íi–∫—Ç–æ—Ä–æ–≤–∏—á, 3487403339",4829,4829,4500000,4500000,980,0,0,4631420,True
rCNDqSzEpqkd77-M,1676647318,Rozetka,5399,5399,-22500,-22500,980,0,0,131420,False,XX31-69XA-X55P-25E7
XLPLL1mTS02NOiiJ,1676647136,Master Zoo,5995,5995,-60000,-60000,980,0,3000,153920,False,8HK3-H9K6-THTT-C0B7
-mpRSsNNazChRfHq,1676625930,Spelta,5814,5814,-9900,-9900,980,0,74,213920,False,B5M8-2TKA-M267-7H0B
7RLWP2jVeRe2HW2T,1676625836,–ó –±—ñ–ª–æ—ó –∫–∞—Ä—Ç–∫–∏,4829,4829,200000,200000,980,0,0,223820,True
ihlV9UvQQC5cy0h6,1676625629,–°–ü√â–õ–¨–¢–ê,5812,5812,-95700,-95700,980,0,717,23820,True,ECHB-HEK6-PTAA-3E9B
xQG1663lo9g5h0CI,1676621590,ZOOLUX,5995,5995,-15580,-15580,980,0,116,119520,False,2P85-281X-93A2-EKT0
sap1dkqh2YMfEMry,1676621399,ZOOLUX,5995,5995,-750000,-750000,980,0,5625,135100,False,E9E7-XC09-7M37-E142
OtZFDtuHC7AvEtEM,1676567132,–ö–∏—ó–≤–ø–∞—Å—Ç—Ä–∞–Ω—Å,4111,4111,-800,-800,980,0,0,885100,False,E274-T3XX-77E9-3E50
JWe0Ic7ZKZEb8LYb,1676563450,Coffee records,5812,5812,-23700,-23700,980,0,177,885900,True,22C6-B81B-PET9-X71B
qXU88rwhXtN_XGNf,1676562905,RESTORAN1,5814,5814,-6500,-6500,980,0,48,909600,False,90E1-TTB3-52MT-99KA
aYLKib9XO0uVaPWV,1676545504,"–ö–∞—Ñ–µ ""–õ–ò–ü–ê""",5812,5812,-9500,-9500,980,0,71,916100,True,A9PA-KXP7-P01P-XB7B
UP5WnIqWlajFaUis,1676541347,BarLipa,5814,5814,-7000,-7000,980,0,52,925600,False,TT2T-6M1M-KPX0-4P2C
hxRmlamWOAlJ0Ixy,1676532175,FOP Sturova AS,5814,5814,-25000,-25000,980,0,187,932600,False,CC6K-HPBH-H0H7-7CM5
P7u-MYExqZ3aBvki,1676470843,magazin 762597,5912,5912,-1988,-1988,980,0,0,957600,False,P2PT-CEXM-5066-K19M
j41Wf1rjoxuEJBgE,1676469860,FOTOVRAMKE,5946,5946,-85000,-85000,980,0,0,959588,False,EPE6-X668-0M1H-2EK1
iQP21AuET7qsuUO7,1676464919,Bestwaytocup,5814,5814,-9000,-9000,980,0,67,1044588,False,EBC9-08BX-H5E1-7186
tBCPuEmEuUpzwokJ,1676462607,5045Kavjarnja,5814,5814,-5500,-5500,980,0,41,1053588,False,T56C-K10E-05KK-E7AX
HB1ankvQBXzZl1pl,1676458618,LIQPAY*Pethouse,5995,5995,-306100,-306100,980,0,2295,1059088,False,2CCK-4ECM-40AB-6564
y3XgkVcgB-b19Xyk,1676379609,WFP.GIFTS.M.,5947,5947,-16000,-16000,980,0,0,1365188,False,7HE1-7HK2-5270-2370
3u1rQmRV7qIrF0sW,1676364259,–°—ñ–ª—å–ø–æ,5411,5411,-54621,-54621,980,0,0,1381188,False,E035-BABH-T752-BB62
i8ZjElEDz0nLhG5_,1676362224,–ï–∫–æ-–õ–∞–≤–∫–∞,5411,5499,-22200,-22200,980,0,0,1435809,False,1424-AA1X-K7AH-X3H3
J3ZFfFqXHMcAHLJE,1676361764,Urbanisti,5814,5814,-6000,-6000,980,0,45,1458009,False,THMM-01A5-T90B-BBA2
WHStp5Ox0iA2UItN,1676361580,–°—ñ–ª—å–ø–æ,5411,5411,-79500,-79500,980,0,0,1464009,False,3PH7-KT0B-H99M-7MK3
ZJPT-pWZk1kh3MHy,1676361481,–°—ñ–ª—å–ø–æ,5411,5411,-7999,-7999,980,0,0,1543509,False,171A-2BXK-BKEP-17X7
Wt9IDrimSXuLp7LX,1676361424,–°—ñ–ª—å–ø–æ,5411,5411,-27953,-27953,980,0,0,1551508,False,8873-T06E-X93B-66AB
qbcIybNi_Z_hSOe4,1676321160,LIQPAY*ZAGRAVA,5651,5651,-390000,-390000,980,0,0,1579461,False,KM25-CCHH-7T2C-B41M
34KCws4sFY-SXtei,1676290301,Cheese Bakery | Kivsh,5812,5812,-34700,-34700,980,0,312,1969461,True,E1P5-PM5K-996E-PM37
HQughqV_v8VeN9Gq,1676285198,–°—ñ–ª—å–ø–æ,5411,5411,-21368,-21368,980,0,0,2004161,False,PC78-791H-K1TK-9B79
LgowQNnn-2LTUMXf,1676285160,–ü–µ—Ä–µ–∫–∞–∑ –Ω–∞ –∫–∞—Ä—Ç–∫—É,4829,4829,-1400000,-1400000,980,0,0,2025529,True
xvGxmR_K8iZjzeZq,1676285139,–ü–æ–ø–æ–≤–Ω–µ–Ω–Ω—è ¬´–ù–∞ —Å–Ω–∞—Ä—è–≥—É –õ—å–æ–ª—ñ–∫—É¬ª,4829,4829,-150000,-150000,980,0,0,3425529,True,93H0-6T11-HC65-B82H
scWVqm8Siy_S0E5x,1676283770,–íi–¥: –ü–†–ò–•–û–î–¨–ö–û –ï.–í. –§–û–ü,"–î–ª—è –ø–æ–ø–æ–≤–Ω–µ–Ω–Ω—è –∫–∞—Ä—Ç–∫–∏ 5375414101190360, –ü—Ä–∏—Ö–æ–¥—å–∫–æ –ï—Ä–Ω–µ—Å—Ç –íi–∫—Ç–æ—Ä–æ–≤–∏—á, 3487403339",4829,4829,3300000,3300000,980,0,0,3575529,True
DxKBP-EyD-M1tVM8,1676282635,–ó –±—ñ–ª–æ—ó –∫–∞—Ä—Ç–∫–∏,4829,4829,200000,200000,980,0,0,275529,True
SmPDBK2EyuvTF90d,1676272838,–°—ñ–ª—å–ø–æ,5411,5411,-183689,-183689,980,0,0,75529,False,58TH-PP64-76PH-H55E
sMKoo4XxEc4uDm7R,1676220133,–°—ñ–ª—å–ø–æ,5411,5411,-3499,-3499,980,0,0,259218,False,KB3T-XCBH-THP1-M3MT
MYyRXz2g-fwqlHqN,1676203371,EliqStore,4215,4215,-36000,-36000,980,0,0,262717,False,EH13-PHB4-01H4-P01P
D8UW-7pqumCMR5_V,1676202986,IDEALIST COFFEE CO,5814,5814,-63900,-63900,980,0,479,298717,False,8CAA-K1PP-MXAH-0CPC
0OeE0I2G2Hije7WP,1676199375,Novus,5411,5411,-33494,-33494,980,0,0,362617,False,55A5-4EH5-K247-T2HC
kj6mO3N2J0CB1Bf1,1676188522,–°—ñ–ª—å–ø–æ,5411,5411,-26719,-26719,980,0,0,396111,False,071H-3734-T067-8ETH
2GYIODTV7mjgSt7fBUj4FQ,1676167308,"–°–∫–∞—Å—É–≤–∞–Ω–Ω—è. LIQPAY*Pethouse,LIQPAY*Pethouse,DNIPRO,UA,DNIPRO,UA",5995,5995,119000,119000,980,0,0,422830,True
WfI_p-lUD2yfxWI_,1676140907,Bolt,4121,4121,-15600,-15600,980,0,0,303830,False,98H6-BBB6-5EE7-06KT
gI1tJTGc5wXjU_6F,1676125056,–°—ñ–ª—å–ø–æ,5411,5411,-7499,-7499,980,0,0,319430,False,APB3-AE25-XC1P-5HC8
mfCHrzosg5Q0WJe8,1676125001,–°—ñ–ª—å–ø–æ,5411,5411,-6999,-6999,980,0,0,326929,False,CEE0-99T1-K2P4-C375
s5JGGMNgJCy1uV-w,1676124943,Bolt,4121,4121,-15400,-15400,980,0,0,333928,False,1E17-0BPE-CT97-A030
m_ZwTUphRCDXoY-H,1676122668,–ó –±—ñ–ª–æ—ó –∫–∞—Ä—Ç–∫–∏,4829,4829,200000,200000,980,0,0,349328,True
y5kFLkX8Q-j-1XaK,1676122608,OK Wine,5411,5411,-105900,-105900,980,0,0,149328,False,K86E-PHKT-PCT2-63PB
G0R433hfeYSjloWz,1676104688,–°–ü√â–õ–¨–¢–ê,5812,5812,-45100,-45100,980,0,338,255228,True,B46T-0X6C-6C2A-2P2X
_KFWPPEDJLoJZR9n,1676043711,StudijaKvitivtadekoruS,5992,5992,-25600,-25600,980,0,0,300328,False,3HT5-E00H-59XX-THA4
_uDMOu4gvv_RpuYx,1676033893,–ö–æ–ª–æ,5411,5499,-9150,-9150,980,0,0,325928,False,5CKM-11A8-MXA2-3XKT
PkYPo9595-zSq-1b,1676032230,–û–ø–∞–ª–µ–Ω–Ω—è (–∞–±–æ–Ω–µ–Ω—Ç—Å—å–∫–∞ –ø–ª–∞—Ç–∞),4900,4900,-6214,-6214,980,0,0,335078,True,A246-880E-41M4-795H
_PT9H2fveGs-Kstl,1676032210,–û–ø–∞–ª–µ–Ω–Ω—è,4900,4900,-399375,-399375,980,0,0,341292,True,EEA3-KMKK-KX13-6998
rUdRRKgUpcVf6DBn,1676032189,–ì–∞–∑,4900,4900,-7957,-7957,980,0,0,740667,True,61PE-1C9E-6K66-B0M9
ZQwPSkfkNoNYm2pb,1676032168,–ö–≤–∞—Ä—Ç–ø–ª–∞—Ç–∞,4900,4900,-61337,-61337,980,0,0,748624,True,81XE-2BH4-M592-4CTX
Yrl5KdM--DWW9x8p,1676032148,–ì–∞—Ä—è—á–∞ –≤–æ–¥–∞ (–∞–±–æ–Ω–µ–Ω—Ç—Å—å–∫–∞ –ø–ª–∞—Ç–∞),4900,4900,-3070,-3070,980,0,0,809961,True,6P53-B1M5-B49T-HXEH
iucp2J8D7FS2qiP7,1676032128,–í–∏–≤—ñ–∑ —Å–º—ñ—Ç—Ç—è,4900,4900,-7613,-7613,980,0,0,813031,True,0P09-49H4-T9A9-BH88
SzVflNHh-p4oMe_j,1676032108,–•–æ–ª–æ–¥–Ω–∞ –≤–æ–¥–∞,4900,4900,-135208,-135208,980,0,0,820644,True,M5KK-6AH9-8P58-2041
GXZvdqDyBCSY_ZVc,1676032088,–ì–∞–∑ (–¥–æ—Å—Ç–∞–≤–ª–µ–Ω–Ω—è),4900,4900,-352,-352,980,0,0,955852,True,BH17-PMTA-416H-9P85
7HB15Q831sxKcjCV,1676032084,–•–æ–ª–æ–¥–Ω–∞ –≤–æ–¥–∞ (–∞–±–æ–Ω–µ–Ω—Ç—Å—å–∫–∞ –ø–ª–∞—Ç–∞),4900,4900,-7838,-7838,980,0,0,956204,True,3XM3-PK57-26EX-HHKX
xoY6z8Y8qDDz2_0L,1676013646,LIQPAY*Pethouse,5995,5995,-306100,-306100,980,0,2295,964042,False,317A-KH03-4TBB-X4XB
HSGebvKfcWEH7nfm,1675962134,–°—ñ–ª—å–ø–æ,5411,5411,-89277,-89277,980,0,0,1270142,False,22MC-6430-2193-463E
rIKmJkI5hhdPLnqO,1675957027,Beer Market,5921,5921,-94197,-94197,980,0,0,1359419,False,ATTH-EB48-TAXK-KC9K
1VZVa8Z0brK0dNX4,1675929008,OKKO,5541,5541,-81498,-81498,980,0,0,1453616,False,HBPA-81EM-1PPP-7299
ayP3qBUZA0rdzhp6,1675927939,Portmone,5814,5811,-1800,-1800,980,0,13,1535114,False,881X-2TBX-2HB4-6P4K
esg3E7MSdL1GbP9q,1675887342,WFP.AQUAMARKET,5411,5411,-29155,-29155,980,0,0,1536914,False,171P-B5CM-TM5M-762P
jf9kZt4j42KOxlwq,1675852042,–°—ñ–ª—å–ø–æ,5411,5411,-34399,-34399,980,0,0,1566069,False,0261-25E6-9E2P-962H
cSVWMKg6VIGafsoB,1675791576,Bolt,4121,4121,-14900,-14900,980,0,0,1600468,False,C0E3-3X73-8BPT-6TCK
pWYqn7VEKFEVijP4,1675775330,BWTC,5814,5814,-17000,-17000,980,0,127,1615368,False,383P-06T8-MHXE-58P8
kLPEGEAWo_x1tg3K,1675774998,BestwaytoCap,5814,5814,-16650,-16650,980,0,124,1632368,False,C24A-HA0K-X054-PB27
Tw149iGTrYaTj5sT,1675774624,–ù–æ–≤–∞ –ø–æ—à—Ç–∞,4214,4214,-23500,-23500,980,0,0,1649018,False,993K-C92A-TA6T-B91E
OjsUokrFmRfXgS7u,1675774303,OK Wine,5921,5921,-81200,-81200,980,0,0,1672518,False,2166-8841-0M72-62EA
4NI0_gtzaBixkS82,1675763230,Bolt,4121,4121,-13300,-13300,980,0,0,1753718,False,K7BK-T449-51E2-06C7
Je8zx6p-7XygOLdw,1675756801,OK Wine,5921,5921,-34650,-34650,980,0,0,1767018,False,B40E-X0B1-E3B5-M1TK
0Ba9NM3L30qTKaku,1675717562,LIQPAY*Leilia Bakery o,5812,5812,-68000,-68000,980,0,510,1801668,False,8X0A-PX19-9A0T-XHA8
G-GplcDSd4Ljbfu7,1675693840,WFP.AQUAMARKET,5411,5411,-71680,-71680,980,0,0,1869668,False,XC80-KTHA-HH1P-CMB9
iicmveZOCpjNfTx7,1675685368,–ê–ø—Ç–µ–∫–∞ –ê–ù–¶,5912,5912,-126020,-126020,980,0,0,1941348,False,2K4H-4XBH-HB2T-6K7E
0CdPLlfPsJ0GDc9n,1675684842,–ê–ø—Ç–µ–∫–∞ –ê–ù–¶,5912,5912,-56550,-56550,980,0,0,2067368,False,K578-2421-90MP-KA20
DNStSya36VP2fDCB,1675681254,–°—É–≤–µ–Ω—ñ—Ä–∏ –ø–æ–¥–∞—Ä—É–Ω–∫–∏ —ñ–≥—Ä–∞—à–∫–∏ wayforpay,5945,5945,-100000,-100000,980,0,0,2123918,False,37A9-3CHE-H82H-783K
ZvmB_ISho4qlHkeo,1675676068,–ü–µ—Ä–µ–∫–∞–∑ –Ω–∞ –∫–∞—Ä—Ç–∫—É,4829,4829,-1500000,-1500000,980,0,0,2223918,True
jsuR5wU5Il3-JBNE,1675676031,536354****1347,4829,4829,-775000,-775000,980,0,0,3723918,True,5762-CX7P-2E70-6TAT
1Aa3lqV6jnCA1Ha2,1675673456,–íi–¥: –ü–†–ò–•–û–î–¨–ö–û –ï.–í. –§–û–ü,"–î–ª—è –ø–æ–ø–æ–≤–Ω–µ–Ω–Ω—è –∫–∞—Ä—Ç–∫–∏ 5375414101190360, –ü—Ä–∏—Ö–æ–¥—å–∫–æ –ï—Ä–Ω–µ—Å—Ç –íi–∫—Ç–æ—Ä–æ–≤–∏—á, 3487403339",4829,4829,4400000,4400000,980,0,0,4498918,True
Szf92x1vwX0NblfU,1675670734,–°—ñ–ª—å–ø–æ,5411,5411,-46488,-46488,980,0,0,98918,False,81MM-M6A1-28EC-E4H2
YBnQlzS-6Pud7Mbw,1675608621,Beer Market,5921,5921,-44976,-44976,980,0,0,145406,False,HMX5-792K-H301-ME9X
NmEAwdTs5kb7CsyD,1675607766,Market delvi,5499,5499,-16641,-16641,980,0,0,190382,False,03X1-8P3C-94C0-2827
zkNh3zcmcWqpva6i,1675603929,–°–∫–∞—Å—É–≤–∞–Ω–Ω—è. WOGPAY_G,5541,5541,1224,1224,980,0,0,207023,False
oY_MxsEVrwd9OusO,1675603856,WOGPAY_G,5541,5541,-112200,-112200,980,0,0,205799,False
WR0oqJHU61o-fh5f,1675601522,–ó –±—ñ–ª–æ—ó –∫–∞—Ä—Ç–∫–∏,4829,4829,250000,250000,980,0,0,317999,True
iaz6Mh5OXdgmjAdB,1675584609,BestwaytoCap,5814,5814,-15500,-15500,980,0,116,67999,False,4M7M-389K-BHAK-453M
8a8T7-AQkIDUzSqo,1675584292,Novus,5411,5411,-82607,-82607,980,0,0,83499,False,3XTX-XK3K-EET6-2H6T
eT-iZUqzDtuTw_hl,1675584277,–ó –±—ñ–ª–æ—ó –∫–∞—Ä—Ç–∫–∏,4829,4829,100000,100000,980,0,0,166106,True
el95mE4V6U3RPqe_,1675579426,Spelta,5814,5814,-9900,-9900,980,0,74,66106,False,9H7P-P834-2K96-27CC
OKMoBK2fZjJ-nYCWj4jy9g,1675554599,"–°–∫–∞—Å—É–≤–∞–Ω–Ω—è. LIQPAY*Pethouse,LIQPAY*Pethouse,DNIPRO,UA,DNIPRO,UA",5995,5995,29500,29500,980,0,0,76006,True
jXbx8WA2CHuXpGSo,1675508046,–°—ñ–ª—å–ø–æ,5411,5411,-256404,-256404,980,0,0,46506,False,5B22-114K-C508-B985
t9Ort05IVkLkeFxp,1675507681,FDY*Food_SSL,5499,5499,-86635,-86635,980,0,0,302910,False,3KC2-T32K-TPAT-13A2
P7oOKkT8-ZXkrinq,1675497991,La fabrique,5814,5814,-10000,-10000,980,0,75,389545,False,T0K0-BC0A-MM1C-6K56
z_ICUepmiRy4Pz9a,1675497830,BestwaytoCap,5814,5814,-15500,-15500,980,0,116,399545,False,KE4K-8MA5-0EA2-HAH1
R64k2gfOpBXRmdMe,1675431231,Mates,5812,5812,-16000,-16000,980,0,120,415045,True,9P45-AC3K-89KT-9TP5
nvkBRu2aan2UGcHl,1675429625,LIQPAY*Pethouse,5995,5995,-265600,-265600,980,0,1992,431045,False,0PC9-9HMK-5K3X-94KP
kGVKA6pnH2b2ORD8,1675422098,Kafe Right Coffee Bar,5814,5814,-7000,-7000,980,0,52,696645,False,8015-PKPA-KMXK-HCPX
rPdsmVuwxSvwMPED,1675418616,Novus,5411,5411,-34973,-34973,980,0,0,703645,False,1EP5-EP4T-353P-6423
DUCrdHkBXf4Bihi0,1675357054,–ù–æ–≤–∞ –ø–æ—à—Ç–∞,4214,4214,-7000,-7000,980,0,0,738618,False,0TH3-MPP2-A7TX-PTTA
BgYCbyqT-8QojA-X,1675341731,OK Wine,5411,5411,-69630,-69630,980,0,0,745618,False,EP6H-C8B9-X54H-5CCA
pPf8bmgOJ-nPKMMF,1675341554,PershaRestoraciyaShaurmi,5814,5814,-16900,-16900,980,0,126,815248,False,91P9-XKH8-09BM-0B26
uRySWwMcrKSyetSO,1675336799,–°—ñ–ª—å–ø–æ,5411,5411,-37201,-37201,980,0,0,832148,False,7491-H6M8-HT54-489E
BcxHhLosF_TUk0PD,1675324234,Bestwaytocup,5814,5814,-5500,-5500,980,0,0,869349,False,7916-6A6K-23A4-3E2C
QxWIGuSEnbFdkrAF,1675322784,Bestwaytocup,5814,5814,-30000,-30000,980,0,0,874849,False,XB1B-66BK-24M3-B78T
YmldsMkc3suKKzsk,1675273975,Kitaika,5814,5814,-80000,-80000,980,0,0,904849,False,X2A5-A1H3-MAPP-B493
FYGKXmAEgYqKfY8H,1675239034,Tachcard,7399,7399,-51500,-51500,980,0,0,984849,False,E832-4K54-BMPA-KKM6
Tadidf-vSEWKDLTD,1675236747,Novus,5411,5411,-13400,-13400,980,0,0,1036349,False,38P0-E65P-EE0A-K4E4
2kan58WkgnR_2bya,1675236745,Bestwaytocup,5814,5814,-31610,-31610,980,0,0,1049749,False,C944-BXT3-4M90-KT2T
iUhOc1LBCFRGbm5y,1677381503,–†–µ–≥—É–ª—è—Ä–Ω–µ –ø–æ–ø–æ–≤–Ω–µ–Ω–Ω—è ¬´–§–æ–Ω–¥ –ü–æ–≤–µ—Ä–Ω–∏—Å—å –∂–∏–≤–∏–º¬ª,4829,4829,-25000,-25000,980,0,0,2570599,True
L6A5lH7rrs4j1zYl,1677337718,–õ—é–¥–º–∏–ª–∞ –í.,4829,4829,-160600,-160600,980,0,0,2595599,True,MK65-4T21-XTEX-0K9K
gN_Nupnibj86atsz,1676980810,–í—ñ–¥: –¢–µ—Ç—è–Ω–∞ –°–∞—á–µ–Ω–∫–æ,4829,4829,600000,600000,980,0,0,2756199,True
sBw88NSoOCVEMiGf,1676894390,536354****9018,4829,4829,-400000,-400000,980,0,0,2156199,True,P35P-3ETA-6PE9-9B5A
SX06Qmzn8PfFPST5,1676776730,–†–µ–≥—É–ª—è—Ä–Ω–µ –ø–æ–ø–æ–≤–Ω–µ–Ω–Ω—è ¬´–§–æ–Ω–¥ –ü–æ–≤–µ—Ä–Ω–∏—Å—å –∂–∏–≤–∏–º¬ª,4829,4829,-25000,-25000,980,0,0,2556199,True
F6QmQ5Y6qu7ZB7xo,1676712314,–¢–µ—Ç—è–Ω–∞ –°.,4829,4829,-600000,-600000,980,0,0,2581199,True,ETXB-PM8A-13EA-5T8M
sghGYeLWekjmA-aa,1676652477,–ó –ø–ª–∞—Ç–∏–Ω–æ–≤–æ—ó –∫–∞—Ä—Ç–∫–∏,4829,4829,2400000,2400000,980,0,0,3181199,True
fhClJ6QwGGk8HA2Z,1676625836,–ü–µ—Ä–µ–∫–∞–∑ –Ω–∞ –∫–∞—Ä—Ç–∫—É,4829,4829,-200000,-200000,980,0,0,781199,True
xdXbMbB0Y-S2QPB1,1676616751,–ü–æ–ø–æ–≤–Ω–µ–Ω–Ω—è ¬´–®–∏–Ω–∏ –Ω–∞ –≤–∞–Ω—Ç–∞–∂—ñ–≤–∫–∏¬ª,4829,4829,-100000,-100000,980,0,0,981199,True,H25B-4197-ECE0-23PP
ZK-jYlQsNNzzQOyz,1676386303,Lesya,4829,4829,-500000,-500000,980,0,0,1081199,True,BE93-AXC3-30TH-3E67
L-xCmIz0v0QrQsSm,1676365152,516874****7983,4829,4829,-40201,-40201,980,0,0,1581199,True,91K7-36MP-0PCP-HCX4
NGNxbrOG2NZo15ep,1676307086,–í–ª–∞–¥–∏—Å–ª–∞–≤ –¢.,–û–ø–ª–∞—Ç–∞ –∑–∞ –∑–∞–º–æ–≤–ª–µ–Ω–Ω—è 20681,4829,4829,-159500,-159500,980,0,0,1621400,True,P188-4KXC-7XT8-A8PB
7ch_qLn-Hfq7FZ4V,1676285160,–ó –ø–ª–∞—Ç–∏–Ω–æ–≤–æ—ó –∫–∞—Ä—Ç–∫–∏,4829,4829,1400000,1400000,980,0,0,1780900,True
_0H9ryOxsKJXbiTz,1676282635,–ü–µ—Ä–µ–∫–∞–∑ –Ω–∞ –∫–∞—Ä—Ç–∫—É,4829,4829,-200000,-200000,980,0,0,380900,True
Rq8yVn69-QpfRs2V,1676171919,–†–µ–≥—É–ª—è—Ä–Ω–µ –ø–æ–ø–æ–≤–Ω–µ–Ω–Ω—è ¬´–§–æ–Ω–¥ –ü–æ–≤–µ—Ä–Ω–∏—Å—å –∂–∏–≤–∏–º¬ª,4829,4829,-25000,-25000,980,0,0,580900,True
WDS3Q_y5vRy8Cpsl,1676122668,–ü–µ—Ä–µ–∫–∞–∑ –Ω–∞ –∫–∞—Ä—Ç–∫—É,4829,4829,-200000,-200000,980,0,0,605900,True
pmTGYp6tP_V5av_z,1675847106,Lesya,4829,4829,-400000,-400000,980,0,0,805900,True,TH8P-K23P-KEP7-6HKH
0RX9sq83UhYv_fuO,1675772686,Lesya,4829,4829,-400000,-400000,980,0,0,1205900,True,MC08-25H4-XC35-HC8M
We5SK5AlxvJIV0Ff,1675771460,–õ–µ–π–ª—è –¢.,–ó–∞ –ø–æ–Ω—á–∏–∫–∏ üç©,4829,4829,-15000,-15000,980,0,0,1605900,True,68TK-A85H-C0PM-ET76
-6t5bxaN-3PWzfSj,1675681617,–ü–æ–ø–æ–≤–Ω–µ–Ω–Ω—è ¬´–ù–∞ –∫–∞—Ä—Ç–æ–≥—Ä–∞—Ñ—ñ–≤¬ª,4829,4829,-100000,-100000,980,0,0,1620900,True,H0T2-BH50-08KB-P977
8Pv4E3VSoYcveJFG,1675676068,–ó –ø–ª–∞—Ç–∏–Ω–æ–≤–æ—ó –∫–∞—Ä—Ç–∫–∏,4829,4829,1500000,1500000,980,0,0,1720900,True
blknhLBj4-0qmFhP,1675601522,–ü–µ—Ä–µ–∫–∞–∑ –Ω–∞ –∫–∞—Ä—Ç–∫—É,4829,4829,-250000,-250000,980,0,0,220900,True
Sa0537DAahStlWep,1675584277,–ü–µ—Ä–µ–∫–∞–∑ –Ω–∞ –∫–∞—Ä—Ç–∫—É,4829,4829,-100000,-100000,980,0,0,470900,True
kSiQ5YX3_d2axMCP,1675567158,–†–µ–≥—É–ª—è—Ä–Ω–µ –ø–æ–ø–æ–≤–Ω–µ–Ω–Ω—è ¬´–§–æ–Ω–¥ –ü–æ–≤–µ—Ä–Ω–∏—Å—å –∂–∏–≤–∏–º¬ª,4829,4829,-25000,-25000,980,0,0,570900,True
PEXnGKamt2_c0EBQ,1675332144,–ü–æ–ø–æ–≤–Ω–µ–Ω–Ω—è ¬´–ù–∞ –∞–≤—Ç–∏–≤–∫—É –¥–ª—è –ó–°–£¬ª,4829,4829,-120000,-120000,980,0,0,595900,True,3M02-P25H-3554-1111
0L0qy8afmP4mY4-B,1680205376,Varvar Bar | –ö–∏—ó–≤,5812,5812,-191100,-191100,980,0,1270,834438,True,91B6-9A0X-554E-H8H6
o7qpb-bxyD8lE6x0,1680194235,Bolt,4121,4121,-6500,-6500,980,0,0,1025538,False,K74H-9975-62MH-KT82
43XvXsWv3zazLfdZ,1680189975,–ó–∞–º–æ–≤–ª–µ–Ω–Ω—è —ó–∂—ñ,5499,5499,-92620,-92620,980,0,0,1032038,False,5108-XP2T-26AX-X24E
R_qe4JpeA_jv7iTl,1680186693,OK Wine,5411,5411,-18900,-18900,980,0,0,1124658,False,9045-0AM8-9BB6-X21P
A8LJslXTEAnqFTRf,1680178469,Bolt,4121,4121,-6900,-6900,980,0,0,1143558,False,XTCA-7K3M-2A26-053C
LTypl0NayPIbPA9W,1680175976,–°–ü√â–õ–¨–¢–ê,5812,5812,-76800,-76800,980,0,576,1150458,True,2X50-51XC-6M9B-HECE
J0rNU-JmcQncp2o9,1680173757,APTEKA N2,5912,5912,-46690,-46690,980,0,0,1227258,False,9056-CXC6-B1X0-49E9
NqaAIhEiky2ryA8s,1680173519,Bolt,4121,4121,-6900,-6900,980,0,0,1273948,False,P229-E94P-T6X3-HT9X
QSY0Ja3WM7tv09Jq,1680173450,KnigarnyaKnizhkoviyLev,5942,5942,-111600,-111600,980,0,0,1280848,False,91X3-001H-E9T7-AX9H
ntQ5glDJlcaJil8M,1680169495,–ê–ø—Ç–µ–∫–∞ –ê–ù–¶,5912,5912,-61090,-61090,980,0,0,1392448,False,PA0A-7694-C8K1-37E9
7wZCinV851BpFWRK,1680169241,DaBoroda,7230,7230,-80000,-80000,980,0,0,1453538,False,CM5B-HMAP-0EB1-4569
x3MMMQ9k6jCYu2fM,1680156275,Bestwaytocup,5814,5814,-6500,-6500,980,0,48,1533538,False,K98B-H53K-C821-B676
1zEVMZjzCqIzXxIq,1680109221,Novus,5411,5411,-55997,-55997,980,0,0,1540038,False,P90M-8A14-9HP0-22B1
PIS8PB9tHpkf6P4v,1680108526,OK Wine,5411,5411,-52920,-52920,980,0,0,1596035,False,ET00-KTB2-565H-EMT6
IGBlSD4MFzVDYRg-,1680101525,Mates,5812,5812,-19800,-19800,980,0,148,1648955,True,HHB3-P7P1-A755-TABH
_KJop5GBDbvxj2n-,1680095179,Maslo TOM,5499,5499,-129600,-129600,980,0,0,1668755,True,2X2M-05XA-MKEX-T6AA
XCkB4esQ9hAzPPpj,1680087423,LIQPAY*ibis.net.ua_Ver,5941,5941,-227368,-227368,980,0,0,1798355,False,CK9E-7H88-X27M-78A0
TpwsnUEQPvpWbEdg,1680082947,–°—ñ–ª—å–ø–æ,5411,5411,-13442,-13442,980,0,0,2025723,False,H581-BH96-6274-1096
7PDIuRqNajKu8_n-,1680070894,Bestwaytocup,5814,5814,-15000,-15000,980,0,300,2039165,False,5443-65M5-80KT-THBH
d9CgswLmGse12fis,1680070280,–û–±—Å–ª—É–≥–æ–≤—É–≤–∞–Ω–Ω—è –ø–ª–∞—Ç–∏–Ω–æ–≤–æ—ó –∫–∞—Ä—Ç–∫–∏,4829,4829,-30000,-30000,980,0,0,2054165,True
W9LGXrBJnMGBqHqI,1680032924,WFP.AQUAMARKET,5411,5411,-28310,-28310,980,0,0,2084165,False,M6E3-H26T-1PC8-2ET8
kZIw3cMsXGsEffoU,1680029907,Bolt,4121,4121,-10300,-10300,980,0,0,2112475,False,4HK0-6HK5-B07M-B10A
_BMGNSF068lwpmLR,1680028976,–ü–µ—Ä–µ–∫–∞–∑ –Ω–∞ –∫–∞—Ä—Ç–∫—É,4829,4829,-400000,-400000,980,0,0,2122775,True
a7sEWA7PLt8DFAYU,1680026990,O'panas,5812,5812,-335600,-335600,980,0,6712,2522775,False,X3A2-MHH7-P2A2-2E7C
I1l7gN52x7yFvvKO,1680021510,Bolt,4121,4121,-11400,-11400,980,0,0,2858375,False,AB8P-8CC9-KCA6-KPPA
c83RVYH3o3Ny9i2g,1680000817,–ü–∞—Ä–∫–æ–≤–∫–∞,7523,7523,-6000,-6000,980,0,0,2869775,False,PA23-980K-ME28-5A33
-klWGolUmVQ6iKo4,1679996893,Lesya,4829,4829,-500000,-500000,980,0,0,2875775,True,B96C-7113-8364-C158
ZxKuiiDrSJXkXTzR,1679987026,Bestwaytocup,5814,5814,-32500,-32500,980,0,650,3375775,False,93P2-XP4H-38C6-2E81
FdJqpJOPHYScDj6a,1679943797,Novapay,8999,8999,-8000,-8000,980,0,0,3408275,False,4P6K-E8P0-5C76-KETT
SInPanv59zCzJzsK,1679934371,Novus,5411,5411,-2599,-2599,980,0,0,3416275,False,5T29-H117-C73E-X40K
s1ExNNQGCZFq3KGU,1679934025,magazin 762597,5912,5912,-32150,-32150,980,0,0,3418874,False,12EK-6K3H-7HXB-ABK9
yPBlIqa8XGuxY9J6,1679932471,Novapay,8999,8999,-7000,-7000,980,0,0,3451024,False,62B1-EPAE-XKXP-34K7
21T3VLDRNVgIEhtP,1679915813,LIQPAY*Pethouse,5995,5995,-306100,-306100,980,0,0,3458024,False,1883-58X3-P046-01M5
tck0yMIOcE2iEx4c,1679909989,–°—ñ–ª—å–ø–æ,5411,5411,-20438,-20438,980,0,0,3764124,False,4E4C-E2H0-1K8T-722B
aGrH-rj2ejBJ1ros,1679903553,–íi–¥: –ü–†–ò–•–û–î–¨–ö–û –ï.–í. –§–û–ü,"–î–ª—è –ø–æ–ø–æ–≤–Ω–µ–Ω–Ω—è –∫–∞—Ä—Ç–∫–∏ 5375414101190360, –ü—Ä–∏—Ö–æ–¥—å–∫–æ –ï—Ä–Ω–µ—Å—Ç –íi–∫—Ç–æ—Ä–æ–≤–∏—á, 3487403339",4829,4829,3700000,3700000,980,0,0,3784562,True
5ln8KH66o_NzuYoC,1679901372,KAFE,5812,5812,-5500,-5500,980,0,41,84562,False,KA0E-MKT0-E288-T7ME
hcm9Aga_GgbaDDVW,1679900040,Bestwaytocup,5814,5814,-6500,-6500,980,0,48,90062,False,9XXH-3EX7-1T3X-2308
CladQoE6HnoqNWd-,1679831763,Novapay,8999,8999,-3500,-3500,980,0,0,96562,False,P411-X78M-9C8E-AHAT
5sdQc0bP_92Y_KlO,1679823924,Novapay,8999,8999,-3500,-3500,980,0,0,100062,False,PKT7-6M05-ECH4-XMH3
B3obn5ABqnzacXX5,1679817117,OK Wine,5411,5411,-83870,-83870,980,0,0,103562,False,7099-4P66-P606-M49A
HyuEjm_U7TGKIzGZ,1679817063,–ó –±—ñ–ª–æ—ó –∫–∞—Ä—Ç–∫–∏,4829,4829,100000,100000,980,0,0,187432,True
q8mSF8JXctkEajuC,1679817011,magazin 762597,5912,5912,-88440,-88440,980,0,0,87432,False,783M-5281-ABH1-B870
pa9bDD67HVw0YIlE,1679814563,FOP Naudzhiute Li,5814,5814,-90900,-90900,980,0,681,175872,False,HM38-3T3K-8B9E-PHAK
YVTCUhpZbQryLWb8,1679812804,–ï–ª–µ–∫—Ç—Ä–æ—Å–∞–º–æ–∫–∞—Ç–∏ Bolt,7999,7999,-1549,-1549,980,0,0,266772,False,418X-1P19-99CK-X878
r3eJXoxXyZgbLNbr,1679812797,–ï–ª–µ–∫—Ç—Ä–æ—Å–∞–º–æ–∫–∞—Ç–∏ Bolt,7999,7999,-1560,-1560,980,0,0,268321,False,0E3M-0XK3-634M-TB94
p_Ejq81GVmOw_cK2,1679811342,Kafe Right Coffee Bar,5814,5814,-7500,-7500,980,0,56,269881,False,9261-69KM-E9MC-MPT6
MgqCfxsRh2ykRyUg,1679773292,LIQPAY*TOV MLDILA,8099,8099,-401450,-401450,980,0,0,277381,False,3C6C-6334-1T1C-E9EH
ujp_Lj_sH7aLfQpK,1679773274,–ó –±—ñ–ª–æ—ó –∫–∞—Ä—Ç–∫–∏,4829,4829,400000,400000,980,0,0,678831,True
ufA5_U5dCl_544dg,1679757114,–ó –±—ñ–ª–æ—ó –∫–∞—Ä—Ç–∫–∏,4829,4829,200000,200000,980,0,0,278831,True
4tInNHwZx_ybtSO6,1679753659,–°–ü√â–õ–¨–¢–ê,5812,5812,-104800,-104800,980,0,786,78831,True,A86H-EH23-6757-BK6H
86xC2XNn5BBOETvN,1679746387,Bolt,4121,4121,-6500,-6500,980,0,0,183631,False,1350-MM9K-AKA2-69XT
GFVPC2bMA-JzfI0y,1679739786,–ï–ª–µ–∫—Ç—Ä–æ—Å–∞–º–æ–∫–∞—Ç–∏ Bolt,7999,7999,-2550,-2550,980,0,0,190131,False,0T00-3XX1-C2B1-9B65
8CvQGvn0BdmlJNS-,1679738733,WFP.EDA,5811,5811,-13000,-13000,980,0,97,192681,False,8369-P24T-4KXK-C30K
PbVTlD4-07yh_Eo_,1679738671,SOPHIA HOTEL KYIV,7011,7011,-131000,-131000,980,0,0,205681,False,1EBB-1ATE-M8PK-BKMK
eLP81Vad83dDNGwr,1679734186,–ï–ª–µ–∫—Ç—Ä–æ—Å–∞–º–æ–∫–∞—Ç–∏ Bolt,7999,7999,-2786,-2786,980,0,0,336681,False,3267-30CK-1X86-8528
yPY0GDVYKdu_IEQZ,1679734179,–ï–ª–µ–∫—Ç—Ä–æ—Å–∞–º–æ–∫–∞—Ç–∏ Bolt,7999,7999,-3309,-3309,980,0,0,339467,False,01T0-HMB6-9KH8-345T
vtzShUo1Aa9upUdW,1679732014,–ó –±—ñ–ª–æ—ó –∫–∞—Ä—Ç–∫–∏,4829,4829,200000,200000,980,0,0,342776,True
bBMub5uyEGehOp6L,1679728757,Bestwaytocup,5814,5814,-6500,-6500,980,0,48,142776,False,M31P-H487-K155-2EB2
EwxebwdLeyOZWhAo,1679677903,Flowerbox,5992,5992,-90000,-90000,980,0,675,149276,False,K7ME-T4HH-16PM-31KB
91FGqLZuOt3dm0dM,1679677684,–ó –±—ñ–ª–æ—ó –∫–∞—Ä—Ç–∫–∏,4829,4829,100000,100000,980,0,0,239276,True
rrujI_hu3VZonTgA,1679665848,Kharms,5814,5814,-6500,-6500,980,0,48,139276,False,7HHK-52PE-KP5H-HC4C
NzHXwB0rWvG-3tp5,1679662823,–í—ñ–¥: –ù–∞—Ç–∞–ª—ñ—è –ê–∂–∏–ø–∞,4829,4829,22600,22600,980,0,0,145776,True
qWW61tWEv0V8C7q3,1679662691,Frankly,5812,5812,-59400,-59400,980,0,445,123176,True,30CB-3K5X-MTM1-H87A
Pswm_coCrF0QZAyh,1679649015,Kharms,5814,5814,-5200,-5200,980,0,39,182576,False,5PE3-106H-EKCX-2C5C
tpkVkppREMXTXlZZ,1679646826,Kafekonditerska,5814,5814,-115000,-115000,980,0,862,187776,False,3XT1-H98A-7106-EH2E
xtGhDgCnJYmVW1pw,1679646713,–ï–ª–µ–∫—Ç—Ä–æ—Å–∞–º–æ–∫–∞—Ç–∏ Bolt,7999,7999,-2297,-2297,980,0,0,302776,False,317B-9971-22T3-5K23
cOair4b6SkUB-KtC,1679646405,OK Wine,5411,5411,-39370,-39370,980,0,0,305073,False,9374-144T-EM16-1AEX
z8nGA-tM5ZJpJFSz,1679640379,Bestwaytocup,5814,5814,-15500,-15500,980,0,116,344443,False,AE9T-1385-MTH7-PAE6
1AyCYaT0KIdd4LCg,1679598952,–ï–ª–µ–∫—Ç—Ä–æ—Å–∞–º–æ–∫–∞—Ç–∏ Bolt,7999,7999,-2506,-2506,980,0,0,359943,False,X645-2587-5M6X-6B53
AHBamSk6wnPvTzpB,1679557400,–ó–∞–≤–µ—Ä—Ç–∞–π–ª–æ,5812,5812,-37400,-37400,980,0,280,362449,True,MT93-HKBP-88T1-95C3
X5Cld49-C81Rf1VF,1679554126,Bestwaytocup,5814,5814,-6500,-6500,980,0,48,399849,False,P96T-T3M3-7T9A-56H4
G5VoOUwwgdkKP2Hu,1679499745,KAFE,5812,5812,-9200,-9200,980,0,69,406349,False,A00P-E7PH-029B-K92H
7YhwQJhcYYQDT0xO,1679480317,–ê–ø—Ç–µ–∫–∞—Ä—å,5912,5912,-36110,-36110,980,0,0,415549,False,B7M1-499B-B1K4-T43H
ZTMld8iV5tf8NCgO,1679480175,–°—ñ–ª—å–ø–æ,5411,5411,-10398,-10398,980,0,0,451659,False,9B1M-4CKP-06BA-C672
GX2KTk_gsJ9LiiSx,1679400061,–°—ñ–ª—å–ø–æ,5411,5411,-11600,-11600,980,0,0,462057,False,57TK-76P9-T678-MHBK
UrpNd7hH8bdRZ_im,1679394750,–ö–∏—ó–≤ –¶–∏—Ñ—Ä–æ–≤–∏–π,4111,4111,-12250,-12250,980,0,0,473657,False,443H-XE90-4MK6-074B
EIDUeAipQmD0c3nV,1679392280,VeterinarniyshpitalGen,742,742,-25000,-25000,980,0,0,485907,False,68X3-9H56-6P1X-HKK7
7KwC_aYawfNEyki1,1679386094,Novus,5411,5411,-3799,-3799,980,0,0,510907,False,THAM-2317-6T6C-MAK5
l_BnKjMCUgQ_rOYb,1679386043,Novus,5411,5411,-3449,-3449,980,0,0,514706,False,C4H9-H58H-0CBP-71AP
fSJRC39nTzQc0tx2,1679385781,Novus,5411,5411,-22368,-22368,980,0,0,518155,False,19KC-7CCP-K4PH-10AA
k9LoYxdiS2V5EVNs,1679384348,Bolt,4121,4121,-7100,-7100,980,0,0,540523,False,M782-P75C-110E-713H
0apnR3hfKamUha1q,1679382992,–°—ñ–ª—å–ø–æ,5411,5411,-7849,-7849,980,0,0,547623,False,P0P9-3K48-B3CC-P50M
IrN5x5GiTP-XFB_N,1679381861,magazin 762597,5912,5912,-109760,-109760,980,0,0,555472,False,P949-6M78-063P-67AE
V_s7uctQEFdCkcVC,1679381630,Bestwaytocup,5814,5814,-4950,-4950,980,0,37,665232,False,77T2-C7P7-3P3A-7887
1-iAheT4TRG5Jbn6,1679379461,Novapay,8999,8999,-7000,-7000,980,0,0,670182,False,MPPK-B4T7-8XX3-P62H
fUWnAcUK5gCehWLQ,1679329585,Integral Fitness Studio,7997,7997,-39000,-39000,980,0,0,677182,False,E437-T21T-PEMB-T869
-rcpAkPtCZLyUYxM,1679320433,–°—ñ–ª—å–ø–æ,5411,5411,-216098,-216098,980,0,0,716182,False,83BB-H960-775K-18P5
DKaaBvgHJG7rNmGM,1679316110,–¢–∞–±–∞–∫–µ—Ä–∫–∞,5993,5993,-41000,-41000,980,0,0,932280,False,X3HA-C5MH-AB20-02KB
T0rsITp_rt6Uubrv,1679315851,Novus,5411,5411,-22496,-22496,980,0,0,973280,False,BE02-4965-3KME-TA05
p1CtohE_GewbnlY6,1679313024,Bestwaytocup,5814,5814,-12000,-12000,980,0,90,995776,False,MB3A-1KPM-CB23-0X0P
pwYkxyjYl3rbhLNh,1679307824,Pie Spot Pizza,5812,5812,-31900,-31900,980,0,239,1007776,False,BPBX-6K53-7466-M08A
tqx-yyZSgBECKW7j,1679307807,Pie Spot Pizza,5812,5812,-120100,-120100,980,0,900,1039676,False,P4BP-38AX-03K4-A717
RmoLKXpG0y5Cn9jC,1679302392,OKKO,5541,5541,-19900,-19900,980,0,0,1159776,False,12X2-AMPH-X573-A0K0
GvHm1_0vskCqeOPV,1679250389,LIQPAY* Internet magaz,5995,5995,-36000,-36000,980,0,0,1179676,False,4TEX-HC09-4M2K-B9A3
n7R2wza5kTxi94vL,1679233855,LIQPAY*Pethouse,5995,5995,-306100,-306100,980,0,0,1215676,False,CC15-CPAC-EBX7-5E33
xGZ4GUzUR5dZWDs6,1679232210,–ë—É—Ä–≥–µ—Ä–Ω–∞ –Ω—ñ—à–∞ / Fresh Black,5812,5812,-26200,-26200,980,0,196,1521776,True,6726-KC3E-X78P-103M
uAWM6zvcRvdKpgJb,1679230517,18shop,7221,7221,-17500,-17500,980,0,0,1547976,False,98T3-MT2E-54BC-X3A6
lZLNzKtKMd5-UwM_,1679214441,OK Wine,5411,5411,-52920,-52920,980,0,0,1565476,False,51TB-79P9-30PA-B82X
sZwzS8XWluserpVD,1679214150,Bestwaytocup,5814,5814,-22000,-22000,980,0,165,1618396,False,TX2X-M65M-7CBM-1234
RDEw3SBmNhbMfCzp,1679160616,WFP.AQUAMARKET,5411,5411,-107720,-107720,980,0,0,1640396,False,BH25-106A-KEX4-0K37
gAI83VuezLtRzKDf,1679146122,magazin 762597,5912,5912,-82347,-82347,980,0,0,1748116,False,AKCM-0301-9TXE-HHPE
sb0qPpdjmpeqVUkv,1679145553,Mates,5812,5812,-38600,-38600,980,0,289,1830463,True,P1TH-22MP-51XE-T962
MJP-QRgpA667isTz,1679070298,magazin 762597,5912,5912,-9745,-9745,980,0,0,1869063,False,2ATE-2A67-C25T-65TK
buKa6mmBEfnM-2Wj,1679054792,Portmone,8398,8398,-10200,-10200,980,0,0,1878808,False,M1P0-6T4K-1K5E-9HMT
V-_PSFJJv2QEC4Gr,1679054438,–ö–æ–ª–æ,5411,5499,-8350,-8350,980,0,0,1889008,False,57BK-02XH-HPB2-6T8B
6kTkvaJP918hi7DH,1679049037,–°—ñ–ª—å–ø–æ,5411,5411,-31381,-31381,980,0,0,1897358,False,P9HB-E959-P6H5-MX65
Q7hvj1gBViTPwbaK,1679039162,Bestwaytocup,5814,5814,-18500,-18500,980,0,138,1928739,False,1EEB-M8B8-1226-X396
sLiJlfRbdhLNQrCX,1679009217,Garage | Mirali,5812,5812,-352000,-352000,980,0,6380,1947239,True,PP05-B3H6-5787-AC12
S7C7cULHkPUIMG2W,1678967047,–ü–µ—Ä–µ–∫–∞–∑ –Ω–∞ –∫–∞—Ä—Ç–∫—É,4829,4829,-2000000,-2000000,980,0,0,2299239,True
BSSh7fzr1IDM2ab8,1678967035,OK Wine,5411,5411,-105840,-105840,980,0,0,4299239,False,M236-3PK9-7EPM-89E9
ibsy725adCYs9Wpm,1678956540,–íi–¥: –ü–†–ò–•–û–î–¨–ö–û –ï.–í. –§–û–ü,"–î–ª—è –ø–æ–ø–æ–≤–Ω–µ–Ω–Ω—è –∫–∞—Ä—Ç–∫–∏ 5375414101190360, –ü—Ä–∏—Ö–æ–¥—å–∫–æ –ï—Ä–Ω–µ—Å—Ç –íi–∫—Ç–æ—Ä–æ–≤–∏—á, 3487403339",4829,4829,3200000,3200000,980,0,0,4405079,True
SbzPWHTrU3AhHIWP,1678953010,"Lifecell
+380631692598",4814,4814,-30000,-30000,980,0,0,1205079,True,5PKX-8575-E262-0598
3TnEouch8yzeva_t,1678951832,Bestwaytocup,5814,5814,-30950,-30950,980,0,232,1235079,False,3024-4724-XA9K-9M20
sg1bTIBKxE3kk6J1,1678916767,JetBrains,5817,5817,-265079,-7080,840,0,0,1266029,False,45K9-BXTA-A56K-AP6P
LrgCD9rM0SFSCywz,1678899890,LIQPAY*ZL Vet,742,742,-65000,-65000,980,0,0,1531108,False,4CTM-PXBT-HEAM-9PE3
GvUwZxv1AoyUw16z,1678894860,LIQPAY*T.C.Pizza,5812,5812,-69825,-69825,980,0,523,1596108,False,12K7-P5K6-AAX9-CAKK
wGpwBQaAatcyDcRE,1678893589,–°—ñ–ª—å–ø–æ,5411,5411,-88472,-88472,980,0,0,1665933,False,E8A4-E5CH-1XT3-A14P
vpF9_DGZZKPlZY5O,1678892727,SECHST,5912,5912,-68876,-68876,980,0,0,1754405,False,3KKK-PBA6-P4PX-K8CM
_mO0szQCpOubsCQI,1678887861,–°—ñ–ª—å–ø–æ,5411,5411,-23399,-23399,980,0,0,1823281,False,PPPK-08K4-81XP-2E7X
YuY6SFh-2LuuQIYl,1678866706,Bestwaytocup,5814,5814,-12500,-12500,980,0,93,1846680,False,MX5P-PA81-3C27-P467
cpyXYsUx9Pz7jXJP,1678866340,La fabrique,5814,5814,-26700,-26700,980,0,200,1859180,False,5T48-ET53-K473-H3B6
NrfYaEcwpaqFZGmr,1678860798,–°—ñ–ª—å–ø–æ,5411,5411,-102323,-102323,980,0,0,1885880,False,T6C0-HCM3-09P1-K71M
kQ45rWclucpvYBin,1678796158,Mates,5812,5812,-30500,-30500,980,0,462,1988203,True,995C-KMHP-XPM3-P1XK
6JDJIaVmaiG-uD8_,1678777841,La fabrique,5814,5814,-12000,-12000,980,0,240,2018703,False,9284-E5B0-TM9P-7A49
vUl_WMTcEaKeuBfx,1678776183,–°—ñ–ª—å–ø–æ,5411,5411,-68651,-68651,980,0,0,2030703,False,9T59-5T7X-8CMT-E8H8
i6ccSapgUYSCtps0,1678706918,OK Wine,5921,5921,-56270,-56270,980,0,0,2099354,False,P613-XPEC-7597-785M
-AZ5n4q38x4FIvbi,1678706097,Bestwaytocup,5814,5814,-8500,-8500,980,0,170,2155624,False,5073-14EB-51E3-9K0M
OMHuXh6czKsaS_Tf,1678705884,KAFE AVI,5812,5812,-32000,-32000,980,0,640,2164124,False,CX45-7590-E96M-PX51
Bvtc8dZ4TvrnnyrW,1678703731,–°—ñ–ª—å–ø–æ,5411,5411,-17644,-17644,980,0,0,2196124,False,29CH-22T7-1EHC-0H5K
ILPT-Eyszb-KR4Mn,1678699352,–ü–µ—Ä–µ–∫–∞–∑ –Ω–∞ –∫–∞—Ä—Ç–∫—É,4829,4829,-500000,-500000,980,0,0,2213768,True
8w4gImtHyIzzS0Kr,1678699299,–íi–¥: –ü–†–ò–•–û–î–¨–ö–û –ï.–í. –§–û–ü,"–î–ª—è –ø–æ–ø–æ–≤–Ω–µ–Ω–Ω—è –∫–∞—Ä—Ç–∫–∏ 5375414101190360, –ü—Ä–∏—Ö–æ–¥—å–∫–æ –ï—Ä–Ω–µ—Å—Ç –íi–∫—Ç–æ—Ä–æ–≤–∏—á, 3487403339",4829,4829,2600000,2600000,980,0,0,2713768,True
brf-AcWZxkMrfGtE,1678639347,–í–ê–†–¶–ê–ë,5814,5814,-40000,-40000,980,0,300,113768,False,M99P-419E-X7MC-BBE2
Vgj3FefVVO6Cok70,1678636758,Novapay,8999,8999,-7000,-7000,980,0,0,153768,False,AKCA-CT4X-74H5-69MP
hnQ4Y9MS7rN57kPp,1678621709,5045Kavjarnja,5814,5814,-11500,-11500,980,0,86,160768,False,30EK-TX2C-EM7E-0006
kECBA2C9eV3lmf0c,1678621550,OK Wine,5411,5411,-136720,-136720,980,0,0,172268,False,1EC6-07M0-P8PT-EC66
kxM_J4WGmxjdhHLc,1678621531,–ó –±—ñ–ª–æ—ó –∫–∞—Ä—Ç–∫–∏,4829,4829,200000,200000,980,0,0,308988,True
_lq0oCXJNUmdj4Xo,1678562842,LIQPAY*Pethouse,5995,5995,-318000,-318000,980,0,0,108988,False,366E-1XP6-2AHX-895A
dBm9mK5eUD8PuiUD,1678562825,–ó –±—ñ–ª–æ—ó –∫–∞—Ä—Ç–∫–∏,4829,4829,300000,300000,980,0,0,426988,True
Z2DUqlc3t2rSXIgb,1678548350,Rozetka,5399,5399,-17400,-17400,980,0,0,126988,False,AM5M-8EX3-4TXC-177A
LOqSoX64WFsq3G-F,1678548037,–ó –±—ñ–ª–æ—ó –∫–∞—Ä—Ç–∫–∏,4829,4829,100000,100000,980,0,0,144388,True
aYLKi7tXNEWQb_eU,1678545092,Mates,5812,5812,-46800,-46800,980,0,351,44388,True,26K8-5B76-10AA-M9PP
Dup_ixRXNJGBqK-X,1678543721,Brewers,5814,5814,-73500,-73500,980,0,551,91188,False,4AAP-3KBE-X5X8-MCPH
z9Rk91W9V1x5c8Sb,1678535595,–ï–ø—ñ—Ü–µ–Ω—Ç—Ä,5912,5912,-75924,-75924,980,0,0,164688,False,1PXX-3T6E-4H97-4P94
7oY4xpllNacgYHey,1678534453,–ï–ø—ñ—Ü–µ–Ω—Ç—Ä,5211,5211,-52920,-52920,980,0,0,240612,False,KC6H-MT70-HHTM-CC2B
okNGVwoKKY3s-Bb_,1678531363,WFP.EDA,5811,5811,-40000,-40000,980,0,300,293532,False,HTHP-TM2X-842X-53KT
LNIVb-fsU43MOBBc,1678531237,SOPHIA HOTEL KYIV,7011,7011,-302000,-302000,980,0,0,333532,False,KX05-KE51-77AK-MHT5
tuZa88yRHXPhopPP,1678474522,–ï–ª–µ–∫—Ç—Ä–æ—Å–∞–º–æ–∫–∞—Ç–∏ Bolt,7999,7999,-4100,-4100,980,0,0,635532,False,EXTB-TK03-11MK-B759
iegScNpQXILHjzeY,1678473892,–ï–ª–µ–∫—Ç—Ä–æ—Å–∞–º–æ–∫–∞—Ç–∏ Bolt,7999,7999,-2047,-2047,980,0,0,639632,False,B709-CX0M-K0BA-5X0X
Fu7Z_TqYvMsCVPfE,1678467480,–ö–∏—ó–≤ –¶–∏—Ñ—Ä–æ–≤–∏–π,4111,4111,-31500,-31500,980,0,0,641679,False,5E3X-6X6H-47HA-HB4M
aaGPKbpw3-rL-Z6w,1678453947,One love coffee —Ü—É–º,7523,7523,-16000,-16000,980,0,0,673179,False,K8BP-HE33-HEK9-4M65
X1trVqU-zPZcwH0j,1678433504,EasyPay,5411,5411,-26800,-26800,980,0,0,689179,False,E8AE-1X67-A52X-P10P
k5kkSccfxt1MxWfw,1678430699,–ù–æ–≤–∞ –ø–æ—à—Ç–∞,7399,7399,-245000,-245000,980,0,0,715979,False,A65C-TX23-4H9E-B4EX
ZOd0OemnV7BCqkv3,1678304453,WFP.AQUAMARKET,5411,5411,-77750,-77750,980,0,0,960979,False,3T1P-79M1-68CH-P0P5
SHB3mks-SqGj-GeZ,1678283830,magazin 762597,5912,5912,-67761,-67761,980,0,0,1038729,False,B49H-70A4-PA8K-KTX6
8zCGWkVq2lJJQwBJ,1678283623,OK Wine,5411,5411,-52920,-52920,980,0,0,1106490,False,E3X1-E6KM-K8AE-P00A
r--bPHhcLO4r4jTs,1678283327,Novapay,8999,8999,-8000,-8000,980,0,0,1159410,False,1116-M0C3-X1PP-PB7K
EZolzhkL9buxRlor,1678283267,Novapay,8999,8999,-7800,-7800,980,0,0,1167410,False,PTCC-4B08-81PK-3MTC
mDfhv-uP9NY4-bdD,1678267876,Bestwaytocup,5814,5814,-12500,-12500,980,0,93,1175210,False,4E2A-EH85-7P5C-ET4T
W7eumdSk533md0Pc,1678264876,Bestwaytocup,5814,5814,-6500,-6500,980,0,48,1187710,False,TM24-MEX3-09C3-4896
7dn9RDt3pdnLrnJo,1678258385,FOP Sturova AS,5814,5814,-57400,-57400,980,0,430,1194210,False,XXAK-KM4X-T94K-PX98
CuTmzJ0GWDwMhtOl,1678256182,–°—ñ–ª—å–ø–æ,5411,5411,-59525,-59525,980,0,0,1251610,False,8892-PAB6-T411-H047
zVlNZiSoUf44Bh9G,1678221461,–ï–ª–µ–∫—Ç—Ä–æ—Å–∞–º–æ–∫–∞—Ç–∏ Bolt,7999,7999,-3903,-3903,980,0,0,1311135,False,H1C7-81KE-E317-M99C
ApM_ybmVxo40OAIV,1678206474,–ï–ª–µ–∫—Ç—Ä–æ—Å–∞–º–æ–∫–∞—Ç–∏ Bolt,7999,7999,-2335,-2335,980,0,0,1315038,False,8HC8-M25B-T20K-1K23
sITH_O2JXgMZ-GfE,1678195193,OK Wine,5921,5921,-52900,-52900,980,0,0,1317373,False,9P3K-KT3M-XB19-5B85
bj1YYBkPFAuA6v28,1678193179,–ï–∫–æ-–õ–∞–≤–∫–∞,5411,5499,-11900,-11900,980,0,0,1370273,False,AKA8-KM7T-0650-B501
8d0SuxguA7Nni3L0,1678192366,Katim≈ç cafe,5812,5812,-12500,-12500,980,0,93,1382173,False,E614-E7H2-02MA-60PP
O81kTWN1smFsFW0x,1678126324,PHOPTitova,7230,7230,-83700,-83700,980,0,0,1394673,False,7AAK-1XPM-0P4E-A039
Az3qSfSEEQ-gQPjn,1678122100,magazin 731866,5912,5912,-56130,-56130,980,0,0,1478373,False,770K-TT20-X083-699A
4OBKrWL0o21vb8R7,1678120642,–°—ñ–ª—å–ø–æ,5411,5411,-261108,-261108,980,0,0,1534503,False,MT9E-5PM6-6569-1XP7
CoUW00Tec88qJnHd,1678111712,–°—ñ–ª—å–ø–æ,5411,5411,-19138,-19138,980,0,0,1795611,False,TET3-3068-H08X-27H0
Y5y-V2B4YwmpaUjt,1678097561,–°—ñ–ª—å–ø–æ,5411,5411,-10298,-10298,980,0,0,1814749,False,P9TX-036T-5477-8X87
zu0jcS6pKWgD8JOu,1678097355,–°—ñ–ª—å–ø–æ,5411,5411,-31975,-31975,980,0,0,1825047,False,91T5-HP22-78X7-8KX1
ebw3RYigQ-QEmnxv,1678025882,TOV V REBRO,5812,5812,-128200,-128200,980,0,961,1857022,False,A6M2-T0TH-BKHX-292P
gXZ2JV037BKq6OdD,1678023023,–°—ñ–ª—å–ø–æ,5411,5411,-122238,-122238,980,0,0,1985222,False,9E2M-58TC-K9MA-A054
orr5QQWvRi-PSVeh,1678020408,WOGPAY_G,5541,5541,-102000,-102000,980,0,0,2107460,False,MX4K-TB2M-BBPH-0CH8
KkniaKwRl5YNrV1C,1678018255,–°—ñ–ª—å–ø–æ,5411,5411,-179899,-179899,980,0,0,2209460,False,EKA2-0HC6-PH6M-5P3E
L6m42GRIO85-Hb3n,1678009808,–ï–ø—ñ—Ü–µ–Ω—Ç—Ä,5211,5211,-52100,-52100,980,0,0,2389359,False,PTPE-BC01-A3K1-MBEC
OQ8GVCnOYWMPlJOr,1678008864,–ï–ø—ñ—Ü–µ–Ω—Ç—Ä,5211,5211,-68640,-68640,980,0,0,2441459,False,021M-AH63-9BM8-77HE
C2_npQLau0BKOmfm,1677940223,–°–ø–∏—Å–∞–Ω–Ω—è IPAY TIPS,6012,6012,-20000,-20000,980,0,0,2510099,False,9HBK-P2TC-303P-2H5B
rVoo_sqt7xhAJG9M,1677940203,RESTOR KHUTORETS NA DN,5812,5812,-29500,-29500,980,0,590,2530099,False,4K07-BC98-1KPH-K958
94mEuZnEBPDhe7dk,1677940184,RESTAURANT KHUTORETS,5812,5812,-79500,-79500,980,0,1590,2559599,False,K1ET-TXBC-BM0X-B3MT
lHvtab3c6ScjXa6k,1677937243,OkvajnSichovih,5399,5399,-8800,-8800,980,0,0,2639099,False,727A-32T9-H5AT-96E0
oBt9UsbX6S8yX2Z5,1677926704,StudijaKvitivtadekoruS,5992,5992,-352000,-352000,980,0,17600,2647899,False,A1E2-AT11-HXPX-28M9
3Xw552zelF_lDzFU,1677926180,OK Wine,5411,5411,-52920,-52920,980,0,0,2999899,False,6BE4-P4XT-AMX5-546H
XcmcY8JtyxW6Hhsa,1677922277,–ü–∞—Ä–∫–æ–≤–∫–∞,7523,7523,-6000,-6000,980,0,0,3052819,False,EM47-PX2A-XAE4-2KAB
eC0qM2m47yCKjelk,1677922006,SALON KRASY BACKSTAGE,7230,7230,-59400,-59400,980,0,0,3058819,False,C8MK-A3MH-EPXB-1C66
yCC8xksyruG5e8ra,1677852877,Minimarket Baker Street b,5812,5812,-98500,-98500,980,0,1970,3118219,False,818E-3A66-14HM-8CMP
n4i0bBpCKgmJ4r_x,1677850747,Novus,5411,5411,-7898,-7898,980,0,0,3216719,False,E79T-HPC7-E4BM-6B12
XJ0AG_89oELmfbvH,1677850583,EVA,5977,5977,-8490,-8490,980,0,0,3224617,False,17MB-4B77-CH51-H1E7
DFmQtAfxCz6tEnsb,1677841508,–íi–¥: –ü–†–ò–•–û–î–¨–ö–û –ï.–í. –§–û–ü,"–î–ª—è –ø–æ–ø–æ–≤–Ω–µ–Ω–Ω—è –∫–∞—Ä—Ç–∫–∏ 5375414101190360, –ü—Ä–∏—Ö–æ–¥—å–∫–æ –ï—Ä–Ω–µ—Å—Ç –íi–∫—Ç–æ—Ä–æ–≤–∏—á, 3487403339",4829,4829,2500000,2500000,980,0,0,3233107,True
h0eq-GFsBwauFzLN,1677837052,–§–û–ü –ë–∞–±—ñ—á –í–∞–ª–µ–Ω—Ç–∏–Ω–∞ –ú–∏–∫–æ–ª–∞—ó–≤–Ω–∞,4829,4829,-80070,-80070,980,1570,0,733107,True,KK15-AKH8-957K-PA3P
E2CkMtVkffmivDb4,1677829510,LIQPAY*Pethouse,5995,5995,-486700,-486700,980,0,0,813177,False,EKXB-20KE-713E-8EHA
pylVKtlESzd03vyl,1677828102,Novus,5411,5411,-13907,-13907,980,0,0,1299877,False,AT0X-CHXX-CE30-CXTP
uGC7MSFaR9LmWu60,1677764059,Yaroslaviv Val 37-1,5499,5499,-40600,-40600,980,0,0,1313784,False,64HC-5TC7-9T58-PE05
IzrhAUso2nAciI2G,1677763325,–°—ñ–ª—å–ø–æ,5411,5411,-21864,-21864,980,0,0,1354384,False,394M-6M76-089H-MX54
vAYacl6C7yu8X66K,1677699651,WFP.CHARITY,8398,8398,-7000,-7000,980,0,0,1376248,False,EMCH-CA3K-XEM5-XP5X
AaOuDMo_GRTWEzDZ,1677691455,–ó–∞–º–æ–≤–ª–µ–Ω–Ω—è —ó–∂—ñ,5499,5499,-85480,-85480,980,0,0,1383248,False,2391-2B71-5B41-1P56
yH11AshjczSu66WP,1677677735,OkvajnSichovih,5399,5399,-77670,-77670,980,0,0,1468728,False,A56C-4CC2-75KA-31EE
JWF5BgT7jrT0HuKc,1677677486,–ö–æ–ª–æ,5411,5499,-58920,-58920,980,0,0,1546398,False,134C-APT8-EK87-1PX5
B6-jJH-VbEnBVgN1,1677677320,PershaRestoraciyaShaurmi,5814,5814,-19900,-19900,980,0,0,1605318,False,H64X-5CHB-A5XC-1A90
J63n8gYkHbwzORd_,1677666502,–°—ñ–ª—å–ø–æ,5411,5411,-19548,-19548,980,0,0,1625218,False,31T4-0K66-CE1P-B879
7YoP7zL3x5UgNrXd,1677654662,–°–ü√â–õ–¨–¢–ê,5812,5812,-64700,-64700,980,0,0,1644766,True,52MM-PH8B-58T0-59MC
opab0BCd2kz17w_v,1677653050,Novapay,8999,8999,-7000,-7000,980,0,0,1709466,False,4128-EACB-C3EM-1TME
peZNm1bmOwbnuAit,1677653022,WFP.AQUAMARKET,5411,5411,-39880,-39880,980,0,0,1716466,False,9821-E204-7PM3-B5T5
hzO00JmsSX1crFxx,1677651516,–°—ñ–ª—å–ø–æ,5411,5411,-97738,-97738,980,0,0,1756346,False,8844-0A15-AKT2-1XXB
8KrWg3JlkRGXAwbp,1680075238,516874****9503,4829,4829,-150000,-150000,980,0,0,1181999,True,T5X1-EXAX-TAAH-1E29
zBHcWQ-9Yw5uCwBE,1680028977,–ó –ø–ª–∞—Ç–∏–Ω–æ–≤–æ—ó –∫–∞—Ä—Ç–∫–∏,4829,4829,400000,400000,980,0,0,1331999,True
hkgEhktndPkH5G75,1679846476,FDY*FOOD,5499,5499,-84000,-84000,980,0,0,931999,False,H787-870H-B15E-6799
3px5wAW3RUaI7_Qs,1679817063,–ü–µ—Ä–µ–∫–∞–∑ –Ω–∞ –∫–∞—Ä—Ç–∫—É,4829,4829,-100000,-100000,980,0,0,1015999,True
6P2xWsS2Z9xUlBtU,1679797075,–†–µ–≥—É–ª—è—Ä–Ω–µ –ø–æ–ø–æ–≤–Ω–µ–Ω–Ω—è ¬´–§–æ–Ω–¥ –ü–æ–≤–µ—Ä–Ω–∏—Å—å –∂–∏–≤–∏–º¬ª,4829,4829,-25000,-25000,980,0,0,1115999,True
STnai6682w1Pnuyz,1679773273,–ü–µ—Ä–µ–∫–∞–∑ –Ω–∞ –∫–∞—Ä—Ç–∫—É,4829,4829,-400000,-400000,980,0,0,1140999,True
ivQuq99EBYvkDPKb,1679757114,–ü–µ—Ä–µ–∫–∞–∑ –Ω–∞ –∫–∞—Ä—Ç–∫—É,4829,4829,-200000,-200000,980,0,0,1540999,True
3t0PE6W6FJvtEKPG,1679732014,–ü–µ—Ä–µ–∫–∞–∑ –Ω–∞ –∫–∞—Ä—Ç–∫—É,4829,4829,-200000,-200000,980,0,0,1740999,True
BMLq4dpBUQtOM0w9,1679677683,–ü–µ—Ä–µ–∫–∞–∑ –Ω–∞ –∫–∞—Ä—Ç–∫—É,4829,4829,-100000,-100000,980,0,0,1940999,True
h8rL59HpoGcax251,1679567411,–§–û–ü –ë–∞–±–µ–Ω—Ü–æ–≤–∞ –û–ª—å–≥–∞ –°–µ—Ä–≥—ñ—ó–≤–Ω–∞,4829,4829,-145000,-145000,980,0,0,2040999,True,8MHM-K975-TP4B-EA67
fGggKtfZ0CHze02I,1679514613,–í–∞–ª–µ—Ä—ñ–π –Ø.,–ó–∞–º–æ–≤–ª–µ–Ω–Ω—è 35211,4829,4829,-219600,-219600,980,0,0,2185999,True,3TC0-40TA-XCMB-B2HC
9FOe6P02qqHRP7-j,1679195874,–†–µ–≥—É–ª—è—Ä–Ω–µ –ø–æ–ø–æ–≤–Ω–µ–Ω–Ω—è ¬´–§–æ–Ω–¥ –ü–æ–≤–µ—Ä–Ω–∏—Å—å –∂–∏–≤–∏–º¬ª,4829,4829,-25000,-25000,980,0,0,2405599,True
Cay4Ct_r9aOpS7nF,1679054901,–ê–Ω—Ç–æ–Ω—ñ–Ω–∞ –ü.,4829,4829,-90000,-90000,980,0,0,2430599,True,5KAP-A3MK-A0CH-290A
GmZFU3WeHash0HBO,1678967047,–ó –ø–ª–∞—Ç–∏–Ω–æ–≤–æ—ó –∫–∞—Ä—Ç–∫–∏,4829,4829,2000000,2000000,980,0,0,2520599,True
GDG5uBrtEK0OBtVY,1678900191,Lesya,4829,4829,-400000,-400000,980,0,0,520599,True,B5AM-34H0-2AHB-5585
2a7r78hncofdLrDy,1678802279,Lesya,4829,4829,-200000,-200000,980,0,0,920599,True,EB1H-7M64-6CA6-X544
WcPFPu1ZxwZmr3yk,1678715451,–ü–æ–ø–æ–≤–Ω–µ–Ω–Ω—è ¬´–ù–∞ –∞–≤—Ç–æ –¥–ª—è –ó–°–£¬ª,4829,4829,-400000,-400000,980,0,0,1120599,True,XBAB-94K3-005P-HA92
saGZX5Dzcgeh5nhu,1678699353,–ó –ø–ª–∞—Ç–∏–Ω–æ–≤–æ—ó –∫–∞—Ä—Ç–∫–∏,4829,4829,500000,500000,980,0,0,1520599,True
kTwUytCToRNGhDSB,1678621815,Lesya,4829,4829,-100000,-100000,980,0,0,1020599,True,4ACT-CHM0-B0B9-14EX
YxPcjcIdRamuss1P,1678621531,–ü–µ—Ä–µ–∫–∞–∑ –Ω–∞ –∫–∞—Ä—Ç–∫—É,4829,4829,-200000,-200000,980,0,0,1120599,True
GhL4PlTdbiwFgF-x,1678603907,–ü–æ–ø–æ–≤–Ω–µ–Ω–Ω—è ¬´–¢–µ–ø–ª –ø—Ä–∏—Ü—ñ–ª–∏ 227 –û–ë¬ª,4829,4829,-100000,-100000,980,0,0,1320599,True,H6PC-6TX8-PM51-CHCA
vyzlIEY3i9seQllK,1678591121,–†–µ–≥—É–ª—è—Ä–Ω–µ –ø–æ–ø–æ–≤–Ω–µ–Ω–Ω—è ¬´–§–æ–Ω–¥ –ü–æ–≤–µ—Ä–Ω–∏—Å—å –∂–∏–≤–∏–º¬ª,4829,4829,-25000,-25000,980,0,0,1420599,True
JI-AUl1WDdLDwQJd,1678562824,–ü–µ—Ä–µ–∫–∞–∑ –Ω–∞ –∫–∞—Ä—Ç–∫—É,4829,4829,-300000,-300000,980,0,0,1445599,True
u6i4CtbZwLS9cTsk,1678548037,–ü–µ—Ä–µ–∫–∞–∑ –Ω–∞ –∫–∞—Ä—Ç–∫—É,4829,4829,-100000,-100000,980,0,0,1745599,True
9NwCfQNhApQjuWbo,1678548027,Lesya,4829,4829,-100000,-100000,980,0,0,1845599,True,6AK2-7TH8-5BCM-6HPB
_1dNqgC_2LhUPbOM,1678522231,–ü–æ–ø–æ–≤–Ω–µ–Ω–Ω—è ¬´10 –º–∞–≤—ñ–∫—ñ–≤ —É –ë–∞—Ö–º—É—Ç¬ª,4829,4829,-100000,-100000,980,0,0,1945599,True,997C-PP14-MH1H-904P
OVQ-qhxt_CqNQCaH,1678205324,Lesya,4829,4829,-300000,-300000,980,0,0,2045599,True,3953-HX1E-P438-HT4K
SeyR5igiaHCZI6VL,1678180600,–ü–æ–ø–æ–≤–Ω–µ–Ω–Ω—è ¬´–ù–∞ —à—É–∑–∏¬ª,4829,4829,-150000,-150000,980,0,0,2345599,True,3H8T-4K9M-365P-18E6
j_p3IdrnDymCd38H,1678179637,Lesya,4829,4829,-50000,-50000,980,0,0,2495599,True,2HHA-PC49-KPE2-KHHB
ZyiYL6tO00ve2N0o,1677986371,–†–µ–≥—É–ª—è—Ä–Ω–µ –ø–æ–ø–æ–≤–Ω–µ–Ω–Ω—è ¬´–§–æ–Ω–¥ –ü–æ–≤–µ—Ä–Ω–∏—Å—å –∂–∏–≤–∏–º¬ª,4829,4829,-25000,-25000,980,0,0,2545599,True
xiZ-5dUFN2WAhp9L,1682795819,ULTRAMARKET,5411,5411,-30280,-30280,980,0,0,2672143,False,TP74-094P-P0HT-K201
QgRkk9AdpJP4NOo4,1682772946,WINETIME,5921,5921,-30400,-30400,980,0,0,2702423,False,5EA4-06H3-BA9A-21P3
S-pNBIY_vvkF79Qk,1682772166,–õ–µ–π–ª—è –¢.,4829,4829,-8500,-8500,980,0,0,2732823,True,3CB7-H6X5-MBTX-T07C
aJv39cAaaQuOByHD,1682771881,t.c.pizza,5812,5812,-60500,-60500,980,0,1210,2741323,True,TBE3-7CEC-HE6P-0867
XE3b0xmgS9JH6vKR,1682769564,–ï–ª–µ–∫—Ç—Ä–æ—Å–∞–º–æ–∫–∞—Ç–∏ Bolt,7999,7999,-2517,-2517,980,0,0,2801823,False,31EP-1A6P-741P-TTCX
bPp6Gygj1sAZXFcF,1682765980,–ï–ª–µ–∫—Ç—Ä–æ—Å–∞–º–æ–∫–∞—Ç–∏ Bolt,7999,7999,-1867,-1867,980,0,0,2804340,False,KA71-3517-M4H0-MXEX
0ozIEWQ4q-i-apcD,1682765670,Bolt,4121,4121,-8600,-8600,980,0,0,2806207,False,CTP4-XP00-CK5M-K73A
XBHLSPKAT3HkuEbV,1682764974,Mates,5812,5812,-23100,-23100,980,0,462,2814807,True,XB6M-X294-0X8A-6654
-EkEDoELkFOdvi_3,1682757615,–ï–ª–µ–∫—Ç—Ä–æ—Å–∞–º–æ–∫–∞—Ç–∏ Bolt,7999,7999,-3005,-3005,980,0,0,2837907,False,H0T3-0EA9-5TX7-0989
ts5fl6cym2Rwhm47,1682756719,–ï–ª–µ–∫—Ç—Ä–æ—Å–∞–º–æ–∫–∞—Ç–∏ Bolt,7999,7999,-2639,-2639,980,0,0,2840912,False,5EEX-P491-AT14-HB0A
XocFABl0SFdHNsU8,1682756602,–ö–∏—ó–≤–ø–∞—Å—Ç—Ä–∞–Ω—Å,4111,4111,-800,-800,980,0,0,2843551,False,67BB-MA9A-965A-C57T
VISYq8wo4ofXJUwP,1682755718,Svitkavi,5814,5814,-42000,-42000,980,0,840,2844351,False,A4E8-2T5A-K1C9-6BPK
rsm_vntUdjDWsweQ,1682754423,–ö–∏—ó–≤–ø–∞—Å—Ç—Ä–∞–Ω—Å,4111,4111,-800,-800,980,0,0,2886351,False,9AAE-94C0-4EKK-6C41
Ld2aD4e-DJPsZceC,1682754416,–ö–∏—ó–≤–ø–∞—Å—Ç—Ä–∞–Ω—Å,4111,4111,-800,-800,980,0,0,2887151,False,2TP9-2774-5E54-T200
oGkAmaWYIE1rf3bt,1682754248,–ï–ª–µ–∫—Ç—Ä–æ—Å–∞–º–æ–∫–∞—Ç–∏ Bolt,7999,7999,-1699,-1699,980,0,0,2887951,False,PK00-6P8E-5994-1E6K
YGvwlbhQQErgEfCG,1682754248,–ï–ª–µ–∫—Ç—Ä–æ—Å–∞–º–æ–∫–∞—Ç–∏ Bolt,7999,7999,-2755,-2755,980,0,0,2889650,False,83H9-777K-C55P-49PE
5ayqWZVtVSDM_c2B,1682752199,Novapay,8999,8999,-7000,-7000,980,0,0,2892405,False,XKH9-3043-7KE1-BE8T
fGLv42ed7lF8gA1c,1682750386,Best way to cup,5814,5814,-6500,-6500,980,0,130,2899405,False,5C7P-T74M-7PEX-4C49
oYegXPo1Dec6l3MF,1682748960,–í—ñ–¥: –ë–æ–≥–¥–∞–Ω –ë—ñ–ª–æ—à–∏—Ü—å–∫–∏–π,4829,4829,19300,19300,980,0,0,2905905,True
stCltT6sqjugZjNp,1682748681,–û–±—Å–ª—É–≥–æ–≤—É–≤–∞–Ω–Ω—è –ø–ª–∞—Ç–∏–Ω–æ–≤–æ—ó –∫–∞—Ä—Ç–∫–∏,4829,4829,-30000,-30000,980,0,0,2886605,True
O9WDVpwgV-fHWSc0,1682747866,–ü–µ—Ä–µ–∫–∞–∑ –Ω–∞ –∫–∞—Ä—Ç–∫—É,4829,4829,-800000,-800000,980,0,0,2916605,True
lxcRpDFqEN584EKx,1682747850,–ü–æ–ø–æ–≤–Ω–µ–Ω–Ω—è ¬´–ù–∞ –±—É—Å –ú–ü–ë¬ª,4829,4829,-150000,-150000,980,0,0,3716605,True,B359-7AX2-C0MH-M86T
c7CRscsiS5Dp4mKT,1682707996,30880,5912,5912,-720,-720,980,0,14,3866605,False,6ET0-H6AM-E40X-K56K
NsyxfI2Xcimx-LBh,1682704272,–ö—ñ–Ω–æ—Ç–µ–∞—Ç—Ä –ñ–æ–≤—Ç–µ–Ω—å,7832,7832,-28000,-28000,980,0,0,3867325,False,AXB7-806X-BAP0-H60E
XQC3-kQUxzyhIfvW,1682697248,30880,5912,5912,-8800,-8800,980,0,176,3895325,False,CBCA-MHPA-96B0-8B51
LBMB-9U8XUQLRHr0,1682697218,30880,5912,5912,-3000,-3000,980,0,60,3904125,False,054P-20T9-M494-3HTB
Zr8CEuUJs64vdD3c,1682697106,Beer Market,5921,5921,-52920,-52920,980,0,0,3907125,False,76HX-9TC3-1C0M-06TE
Dmrtwh3fgROuT8eY,1682697100,Novapay,8999,8999,-8000,-8000,980,0,0,3960045,False,2C04-C4A1-T8C5-68PM
W4OXq6sPVPft7w_l,1682695206,–ù–æ–≤–∞ –ø–æ—à—Ç–∞,4214,4214,-12300,-12300,980,0,0,3968045,False,9324-6T2T-H105-EEH7
9GiFKpdWdR-iBI-S,1682690784,–í–ê–†–¶–ê–ë,5814,5814,-1000,-1000,980,0,20,3980345,False,5PBA-BPB5-C7MX-70EH
IKl2-PXn1awLC3j_,1682690755,–í–ê–†–¶–ê–ë,5814,5814,-4000,-4000,980,0,80,3981345,False,M93B-5KBC-KC9P-HC9K
bNQOW5f58-W3IhGR,1682684017,Bolt,4121,4121,-6100,-6100,980,0,0,3985345,False,5T3P-2T6A-MP42-0TX0
dYfyrtnsehaRKDAE,1682671370,–íi–¥: –ü–†–ò–•–û–î–¨–ö–û –ï.–í. –§–û–ü,"–î–ª—è –ø–æ–ø–æ–≤–Ω–µ–Ω–Ω—è –∫–∞—Ä—Ç–∫–∏ 5375414101190360, –ü—Ä–∏—Ö–æ–¥—å–∫–æ –ï—Ä–Ω–µ—Å—Ç –íi–∫—Ç–æ—Ä–æ–≤–∏—á, 3487403339",4829,4829,2500000,2500000,980,0,0,3991445,True
UwNOb83H2mL6uJgq,1682670918,–ù–æ–≤–∞ –ø–æ—à—Ç–∞,7399,7399,-7000,-7000,980,0,0,1491445,False,CP53-B85B-MET2-PAEB
n5CDrxbOg1jvWWjN,1682670902,–ü—ñ—Å–ª—è–ø–ª–∞—Ç–∞ (–ù–æ–≤–∞ –ø–æ—à—Ç–∞),6538,6538,-10661,-10661,980,361,0,1498445,False,MKH3-BXHT-713M-MCB5
2jnCqD87O_x8e2xM,1682668631,DRATsENA Vaib,5814,5814,-7000,-7000,980,0,52,1509106,False,4BBM-9H0K-H118-06AM
F7bce-Sihw8Z_qHe,1682662739,Best way to cup,5814,5814,-6500,-6500,980,0,48,1516106,False,T50M-C34M-ETT2-E0E7
zV6s2xY2VJQGMbNw,1682659442,LIQPAY*Pethouse,5995,5995,-144700,-144700,980,0,0,1522606,False,52H5-1186-TA23-KA27
1D6gvDZKFkIJgB1N,1682620172,FDY*Clothing_SSL,5691,5691,-96000,-96000,980,0,0,1667306,False,5TMT-MMTK-B773-THP6
IJbz85TYcj4yidbc,1682611067,SHIBUYA | –Ø—Ä–æ—Å–ª–∞–≤—ñ–≤ –í–∞–ª,5812,5812,-29700,-29700,980,0,222,1763306,True,X1KA-7X8C-809B-EB9C
3AuX1hwnvYxyg3im,1682610589,SHIBUYA | –Ø—Ä–æ—Å–ª–∞–≤—ñ–≤ –í–∞–ª,5812,5812,-92800,-92800,980,0,696,1793006,True,H129-APM6-X85T-20HT
5ComyoYwbCcdvxeF,1682604006,Novapay,8999,8999,-7300,-7300,980,0,0,1885806,False,M16K-KX6P-3HB3-CHPK
B2Wf6JxYTsvxAOh_,1682588504,–°—ñ–ª—å–ø–æ,5411,5411,-17296,-17296,980,0,0,1893106,False,27BA-P1KE-3XMA-223H
AT-P92rp_7XIQjnQ,1682571930,–ù–æ–≤–∞ –ø–æ—à—Ç–∞,7399,7399,-14300,-14300,980,0,0,1910402,False,5TK0-EMEC-MT81-5PPK
KjDAGuk6-StYwtdP,1682571831,La fabrique,5814,5814,-18500,-18500,980,0,138,1924702,False,0A8X-TEE0-11X3-E664
LmEzWTXNJG15dDpn,1682521465,AVANGARDEN,5812,5812,-24200,-24200,980,0,181,1943202,True,77K7-T7C0-0MTX-E36X
tSllnvIR6RaPqtF5,1682506229,PHotosalonMAN,7221,7221,-13000,-13000,980,0,0,1967402,False,A3KK-8931-2TM7-MM8B
HsViZ3Lk4JyeR0k5,1682504010,–ï–ª–µ–∫—Ç—Ä–æ—Å–∞–º–æ–∫–∞—Ç–∏ Bolt,7999,7999,-2395,-2395,980,0,0,1980402,False,T64C-T237-7ET5-H861
PKEaWA9JYr-j0x9x,1682503205,–ë—É—Ä–≥–µ—Ä–Ω–∞ –Ω—ñ—à–∞ / Fresh Black,5812,5812,-43000,-43000,980,0,644,1982797,True,T004-H82T-171C-T8C3
3ns7izuOTxQrwfpI,1682502324,EasyPay,4814,4814,-3500,-3500,980,0,0,2025797,False,7CPB-EXA3-7PC8-H21E
H9rQfDNMGm6aV3ov,1682493665,Best way to cup,5814,5814,-30000,-30000,980,0,600,2029297,False,2HMT-2290-4B93-9P8C
FP7E5_4A1m9s2dnV,1682492499,414950****2049,4829,4829,-5000,-5000,980,0,0,2059297,True,6MAH-3XMH-15XA-E4H2
zgt573tVtnaGuqP7,1682490782,Best way to cup,5814,5814,-15000,-15000,980,0,300,2064297,False,4E8B-XMA7-5CXA-C62A
5IF74Afw2Q4ieSXPaYw25A,1682465307,"–°–∫–∞—Å—É–≤–∞–Ω–Ω—è. LIQPAY*Pethouse,LIQPAY*Pethouse,DNIPRO,UA,DNIPRO,UA",5995,5995,4900,4900,980,0,0,2079297,True
yLx1cnBiWOoaX7kp,1682435653,Lesya,4829,4829,-200000,-200000,980,0,0,2074397,True,K7A3-ACPB-HCP9-XM42
jc6iufUL5jCl7lZw,1682432884,–ú–∏–∫–∏—Ç–∞ –ü.,4829,4829,-290000,-290000,980,0,0,2274397,True,P4HE-CAK8-0P91-BXCX
_zTC24DOz43t3M6Q,1682430866,Beer Market,5921,5921,-123138,-123138,980,0,0,2564397,False,53CE-6717-2606-7H2M
XV4iuGZ54a7W5XMg,1682428281,prom.ua,4829,4829,-55040,-55040,980,0,0,2687535,False,42TM-TPMH-HA4H-1H1M
V4OuEZ8lh-lGL4GP,1682414897,–ê–ø—Ç–µ–∫–∞ –ê–ù–¶,5912,5912,-79710,-79710,980,0,1594,2742575,False,926C-KMT7-XK5K-TC86
RE5cYyMDHtboJWpf,1682412245,Mates,5812,5812,-54100,-54100,980,0,1082,2822285,True,0B1X-XX7B-A91M-K81H
gGNGCndhzcq_CqCj,1682409857,–íi–¥: –ü–†–ò–•–û–î–¨–ö–û –ï.–í. –§–û–ü,"–î–ª—è –ø–æ–ø–æ–≤–Ω–µ–Ω–Ω—è –∫–∞—Ä—Ç–∫–∏ 5375414101190360, –ü—Ä–∏—Ö–æ–¥—å–∫–æ –ï—Ä–Ω–µ—Å—Ç –íi–∫—Ç–æ—Ä–æ–≤–∏—á, 3487403339",4829,4829,2600000,2600000,980,0,0,2876385,True
byFQd3wKA8MkyoY0,1682403215,Best way to cup,5814,5814,-8700,-8700,980,0,65,276385,False,09T4-3AH1-MK31-858E
QedyRILUWTI2cXcX,1682359430,WFP.AQUAMARKET,5411,5411,-28310,-28310,980,0,0,285085,False,5T5P-C22H-A3H8-HMPX
rCbR_vRN30l14aTf,1682359401,–°—ñ–ª—å–ø–æ,5411,5411,-37800,-37800,980,0,0,313395,False,H3MX-4KXH-1KKH-EBE8
OJSUz7awe4eSJKGp,1682355612,Novapay,8999,8999,-7500,-7500,980,0,0,351195,False,6XXA-8B2E-B20B-BP1K
g34Rw29fSKd--iMz,1682353971,VeterinarniyshpitalGen,742,742,-254100,-254100,980,0,0,358695,False,HM59-95B0-380B-KM2M
xOM-kT7-D42_Zre_,1682351445,LIQPAY*Pethouse,5995,5995,-289100,-289100,980,0,0,612795,False,H8HT-M94A-K0B5-6TA8
WjSgMqoriKzZS4sz,1682347522,LIQPAY*ZL Vet,742,742,-65000,-65000,980,0,0,901895,False,1848-2549-P64H-5EH0
nAw-VRPZdOxcQVI9,1682331027,Freedompizza,5814,5814,-10000,-10000,980,0,75,966895,False,57E7-3MM7-EAAM-2XAA
V5XoIsFv_MFz0VKD,1682329089,Freedompizza,5814,5814,-25400,-25400,980,0,190,976895,False,2A1H-6B93-P8PM-CBX2
xeepkTyyhJw3k8bC,1682328679,Freedompizza,5814,5814,-59100,-59100,980,0,443,1002295,False,3XXE-3B8H-KTCT-XEM8
IksND8B3EjuGwx0-,1682279253,SP KOSAS COSMETICS,5977,5977,-294620,-7869,840,0,2209,1061395,False,CH14-3TK2-514B-B2EK
chGKy9LrZEUZ0DY7,1682266521,VeterinarniyshpitalGen,742,742,-232600,-232600,980,0,0,1356015,False,HCXM-9K0M-624A-PKCX
dYyOTfgk2wvU1eyk,1682261202,Novapay,8999,8999,-12800,-12800,980,0,0,1588615,False,5X7C-A0M8-4AH7-5T05
73x3kIukfig_iyIq,1682261176,Novapay,8999,8999,-20500,-20500,980,0,0,1601415,False,4ETH-7A0E-7H89-B1C0
NMEX5XKBUccnvD9c,1682251606,–ï–ª–µ–∫—Ç—Ä–æ—Å–∞–º–æ–∫–∞—Ç–∏ Bolt,7999,7999,-9338,-9338,980,0,0,1621915,False,0K7P-00PX-BA65-1TCC
sBKqDdUK7hkQ9uL2,1682251592,–ï–ª–µ–∫—Ç—Ä–æ—Å–∞–º–æ–∫–∞—Ç–∏ Bolt,7999,7999,-9440,-9440,980,0,0,1631253,False,H7BE-360E-A6KX-A55C
vkeN3AyrajKtE6da,1682251434,OK Wine,5411,5411,-52920,-52920,980,0,0,1640693,False,CTE8-BPPB-X16X-8418
MyVPVSRkA7BTK0sE,1682249535,Bilyardna,5814,5814,-99500,-99500,980,0,746,1693613,False,9K9X-5793-PBXE-7TPM
VuQ2fMCyVtXa2KP0,1682249516,FOP Kovtun VV,5814,5814,-21000,-21000,980,0,157,1793113,False,C09E-M3HP-XHPC-P5M2
P9a9yVtNvawSV2IU,1682245076,–ï–ª–µ–∫—Ç—Ä–æ—Å–∞–º–æ–∫–∞—Ç–∏ Bolt,7999,7999,-1999,-1999,980,0,0,1814113,False,AEX4-1XT9-3T67-A1HA
nEO1TGH4JQVQXGwH,1682245075,–ï–ª–µ–∫—Ç—Ä–æ—Å–∞–º–æ–∫–∞—Ç–∏ Bolt,7999,7999,-1996,-1996,980,0,0,1816112,False,MAEH-M841-E75A-0H3B
65bOHC_NWQOv4ucj,1682241215,SalontayskogomasazhuSA,7297,7297,-200000,-200000,980,0,1726,1818108,False,T324-5H7K-P5E1-643E
roDpihJpyTX_gvvq,1682179278,5045Kavjarnja,5814,5814,-4500,-4500,980,0,90,2018108,False,34MT-4BEE-99TK-5AC6
dWaz9Wh01Q8_48a9,1682177778,5045Kavjarnja,5814,5814,-14000,-14000,980,0,280,2022608,False,5BBH-M2TA-96AK-46HB
DcHExRXR_BB7YN0j,1682171629,VeterinarniyshpitalGenesi,742,742,-255600,-255600,980,0,0,2036608,False,AEP2-E0PA-X47K-2993
lqMYPF1eQIdgBUil,1682169894,–°–∫–∞—Å—É–≤–∞–Ω–Ω—è. WOGPAY_G,5541,5541,19596,19596,980,0,0,2292208,False
zuFBN7uoxR5Z8O1Z,1682169766,WOGPAY_G,5541,5541,-215556,-215556,980,0,0,2272612,False
b6Ilb1fhGClL6zjC,1682163840,–ö–æ–ª–æ,5411,5499,-2150,-2150,980,0,0,2488168,False,E0X4-6CXC-70EB-81MX
7zOtjOBFgrXrv1zj,1682158348,WFP.MEBEL.UA,5712,5712,-200000,-200000,980,0,0,2490318,False,B6A9-7T4T-8EEE-TTAX
kZ51ZsJEijzFarjl,1682098795,–ï–ª–µ–∫—Ç—Ä–æ—Å–∞–º–æ–∫–∞—Ç–∏ Bolt,7999,7999,-1847,-1847,980,0,0,2690318,False,M8EA-4KKH-A9K1-E6A9
vJhEdDk8BZerPUyQ,1682098599,–ï–ª–µ–∫—Ç—Ä–æ—Å–∞–º–æ–∫–∞—Ç–∏ Bolt,7999,7999,-4002,-4002,980,0,0,2692165,False,423H-T7CM-AX18-C595
N_l8FxQYZRQ4S7ro,1682097752,OK Wine,5411,5411,-56400,-56400,980,0,0,2696167,False,M685-CTTE-AB97-8745
yjrDKSFH4IhYxrKz,1682096393,Magazin Master Zoo,5995,5995,-55700,-55700,980,0,0,2752567,False,C8EX-19MM-9X48-H4CH
LfcxrqFuhfC3xqhh,1682093296,VeterinarniyshpitalGen,742,742,-490600,-490600,980,0,0,2808267,False,EK9E-CHPX-PHBX-36BC
yElK5lDL3bKWLET8,1682069845,–°—ñ–ª—å–ø–æ,5411,5411,-13130,-13130,980,0,0,3298867,False,P0AE-H1BA-XPBK-TEH8
JGVvuTtE95who9Kt,1682065620,–íi–¥: –ü–†–ò–•–û–î–¨–ö–û –ï.–í. –§–û–ü,"–î–ª—è –ø–æ–ø–æ–≤–Ω–µ–Ω–Ω—è –∫–∞—Ä—Ç–∫–∏ 5375414101190360, –ü—Ä–∏—Ö–æ–¥—å–∫–æ –ï—Ä–Ω–µ—Å—Ç –íi–∫—Ç–æ—Ä–æ–≤–∏—á, 3487403339",4829,4829,3100000,3100000,980,0,0,3311997,True
x6cngzr4cthodtpx,1682056330,Best way to cup,5814,5814,-6500,-6500,980,0,48,211997,False,4XE2-M1E1-C38T-0C79
ZZmRNrJZ_35eVj8M,1682008077,PIDZEMNYY PARKING,7523,7523,-30000,-30000,980,0,0,218497,False,5AP5-9T16-EKC1-C51H
cd-RKtOgUhjtredh,1681988934,Kharms,5814,5814,-5200,-5200,980,0,39,248497,False,38TE-P5P0-MT18-C075
pTVwkomvLCEMVb0B,1681987489,"Syharnyy dim ""fortuna""",5993,5993,-100800,-100800,980,0,0,253697,False,86CB-3XP7-M458-3A1T
knhLoMCQwezDAgd-,1681987254,STEAKHOUSE,5812,5812,-24000,-24000,980,0,180,354497,False,32X8-3070-7H69-0A14
zK-xm1DqpbaDx6H_,1681973584,–ï–ª–µ–∫—Ç—Ä–æ—Å–∞–º–æ–∫–∞—Ç–∏ Bolt,7999,7999,-2688,-2688,980,0,0,378497,False,4HH8-7P54-H0MA-28H0
u0LG9Y8P-czNaizl,1681973028,–ê–ø—Ç–µ–∫–∞ –ê–ù–¶,5912,5912,-3530,-3530,980,0,26,381185,False,74TA-6HM2-0E8K-E2H3
HO7ySrg612bRe2qL,1681970579,–°—ñ–ª—å–ø–æ,5411,5411,-42200,-42200,980,0,0,384715,False,HAX3-8PK9-AM79-4HP4
1eeNKdb7Pk6vIczQ,1681922737,–°—ñ–ª—å–ø–æ,5411,5411,-70829,-70829,980,0,0,426915,False,37BH-4C67-H688-MK4E
_Qnm42RjL4_Wc7Qu,1681919622,Mates,5812,5812,-20700,-20700,980,0,155,497744,True,H1K7-4125-CPEB-KHAP
EBz8oUgQnh_TpeVS,1681914929,SILPOSHOP 1,5411,5411,-226806,-226806,980,0,0,518444,False,E027-07H1-346E-XC54
gDkpViLaLy5O_zHQ,1681888515,TOV PARYTET,5511,5511,-120000,-120000,980,0,0,745250,False,P845-CHK8-HE96-53C4
YNXi_aBlJymChsHc,1681885286,La fabrique,5814,5814,-14500,-14500,980,0,108,865250,False,573A-T946-1BE5-PE3A
PzBCJTZFwvuoOYJO,1681885048,Best way to cup,5814,5814,-30000,-30000,980,0,225,879750,False,X47X-XMPM-PKCM-73C4
R_5wCIzjiRCq9gGU,1681842170,MAKEUP,5977,5977,-84400,-84400,980,0,633,909750,False,EXK9-54MH-9X90-664B
0Pz7-JUD4nzoptgS,1681836995,OG BURGER,5814,5814,-61000,-61000,980,0,457,994150,False,99MB-7EH0-MT2B-T31H
wxglg0JTfnxE9l3N,1681815580,–ï–ª–µ–∫—Ç—Ä–æ—Å–∞–º–æ–∫–∞—Ç–∏ Bolt,7999,7999,-9766,-9766,980,0,0,1055150,False,0CC9-2A94-264T-9E82
DnSituVVSwGFrSXU,1681814085,OK Wine,5921,5921,-52920,-52920,980,0,0,1064916,False,MTXB-5T60-0B74-27CT
0H-dG8LH7vzGBpW_,1681802073,Best way to cup,5814,5814,-19200,-19200,980,0,144,1117836,False,1BKH-14E9-96MA-P1KM
vrMlP10CeMS9x8Q2,1681726187,–°—ñ–ª—å–ø–æ,5411,5411,-32982,-32982,980,0,0,1137036,False,E3H0-EKHT-M89M-4P51
RgCgLwtf_CmRCv_t,1681646856,YOLO,5814,5814,-21000,-21000,980,0,157,1170018,False,BX0X-08A8-B396-PT1M
lc1CzXpg7_HbkzC_,1681646564,O'panas,5812,5812,-73000,-73000,980,0,547,1191018,False,TXMH-8625-BXP6-A373
Z5iCe_SkPRwWNEA8,1681643736,WFP.AQUAMARKET,5411,5411,-80710,-80710,980,0,0,1264018,False,KE95-95BE-7XX4-39K3
_0QYbD22IK3TTS0y,1681640031,–ï–ø—ñ—Ü–µ–Ω—Ç—Ä,5211,5211,-80800,-80800,980,0,0,1344728,False,MCXB-HEX4-TMAB-193K
AXBT9jUbc6OVqxAv,1681634646,Flowerbox,5992,5992,-12000,-12000,980,0,0,1425528,False,4T9B-74K5-0MTX-5K29
8y3nfMKCg4k3Ao7k,1681634506,–ê–ø—Ç–µ–∫–∞ –ê–ù–¶,5912,5912,-217820,-217820,980,0,1633,1437528,False,6TA8-2A17-225A-2XC5
ExIFsrJdk_uTj0JO,1681481273,Beer Market,5921,5921,-105840,-105840,980,0,0,1655348,False,BMCP-E0XM-2E4C-0XHB
BRDhpmb5aAFYWbdO,1681470308,LIQPAY*Pethouse,5995,5995,-385500,-385500,980,0,0,1761188,False,BA12-6E13-HP28-750T
zWe5TSMTZPgjSlsF,1681464912,–°—ñ–ª—å–ø–æ,5411,5411,-9998,-9998,980,0,0,2146688,False,M4P3-H0MK-A9H1-9AK9
jHt0TtMyXY06csVr,1681455237,FOP Sturova AS,5814,5814,-82500,-82500,980,0,1650,2156686,False,4PK0-459X-EXMP-941A
EjlRSeRTOwW5m4Zy,1681453504,Bestwaytocup,5814,5814,-5500,-5500,980,0,110,2239186,False,523A-94CX-AP5H-231P
6kMYUTUNfUA0m2Ip,1681413132,–ü–æ–ø–æ–≤–Ω–µ–Ω–Ω—è ¬´–ù–∞ –æ–ø—Ç–∏—á–µ—Å–∫–∏–π –ø—Ä–∏—Ü—ñ–ª¬ª,4829,4829,-100000,-100000,980,0,0,2244686,True,M7E9-M2A2-3577-2KC3
vVzUjACMJtpSfnz5,1681413037,–ü–æ–ø–æ–≤–Ω–µ–Ω–Ω—è ¬´–ù–∞ –û–ü–¢–ò–ö–£ –°–ù–ê–ô–ü–ï–†–£¬ª,4829,4829,-100000,-100000,980,0,0,2344686,True,KK8K-HK75-B07K-AM95
m-Sgj6yfCSNSG6aN,1681412400,–ü–æ–ø–æ–≤–Ω–µ–Ω–Ω—è ¬´–∑–∞ –Ø—Ä—É –∑ –•–æ–ª–æ–¥–Ω–æ–≥–æ –Ø¬ª,4829,4829,-50000,-50000,980,0,0,2444686,True,282T-PEX3-4274-AAAE
xjFJoXbFJvEvnBJx,1681411657,–ï–ª–µ–∫—Ç—Ä–æ—Å–∞–º–æ–∫–∞—Ç–∏ Bolt,7999,7999,-3804,-3804,980,0,0,2494686,False,PP97-M6H4-A7TT-EXTC
idpX3Z5eqdjxAR8z,1681394436,–î–µ–Ω–∏—Å –ö–æ—Ç–æ–≤,4829,4829,-24000,-24000,980,0,0,2498490,True,AA55-A4CH-CMTT-M87M
GCHv3YdCC0On3FYg,1681388218,Kharms,5814,5814,-5200,-5200,980,0,104,2522490,False,0390-HM77-5M5P-50T0
H22WQN7UH19sq7M9,1681375649,–ï–ª–µ–∫—Ç—Ä–æ—Å–∞–º–æ–∫–∞—Ç–∏ Bolt,7999,7999,-2600,-2600,980,0,0,2527690,False,P609-7TB2-KMCH-06P8
1yMrFf6XCLCo-qYr,1681374571,WFP.HOTTELS1,7011,7011,-848400,-848400,980,0,0,2530290,False,M4A2-74EP-95M8-7BT4
iYmjW42mVC0ng5GH,1681374451,–ü–æ–ø–æ–≤–Ω–µ–Ω–Ω—è ¬´–ù–∞ Mavic 3T –¥–ª—è 23—ó¬ª,–°–º–µ—Ä—Ç—å –≤–æ—Ä–æ–≥–∞–º,4829,4829,-6000000,-6000000,980,0,0,3378690,True,MT66-6A62-H053-CP7E
HeBTcyAzH0rFEdP5,1681374244,–íi–¥: –ü–†–ò–•–û–î–¨–ö–û –ï.–í. –§–û–ü,"–î–ª—è –ø–æ–ø–æ–≤–Ω–µ–Ω–Ω—è –∫–∞—Ä—Ç–∫–∏ 5375414101190360, –ü—Ä–∏—Ö–æ–¥—å–∫–æ –ï—Ä–Ω–µ—Å—Ç –íi–∫—Ç–æ—Ä–æ–≤–∏—á, 3487403339",4829,4829,7800000,7800000,980,0,0,9378690,True
QWUiNhwDdgJDOKbg,1681373830,LIQPAY*Leilia Bakery o,5812,5812,-214500,-214500,980,0,1608,1578690,False,B36E-K885-4C8K-X49C
9RJ_s_y6f-dqTjiM,1681367944,Bestwaytocup,5814,5814,-6500,-6500,980,0,48,1793190,False,TTT0-67KM-KHTA-CT15
ges4qJCg6038kphK,1681320827,magazin776513,5912,5912,-22659,-22659,980,0,169,1799690,False,5985-6TCT-0HP7-5CCH
RRjQxCeuCRZV2C0J,1681300277,Kafe Right Coffee Bar,5814,5814,-13500,-13500,980,0,101,1822349,False,XH5P-A8MB-4C3M-X1B6
2vXvbHG-kAS3eO_U,1681295150,ZOOLYUKS,742,742,-51000,-51000,980,0,0,1835849,False,8BXM-K34M-5XE9-AA77
YNXi_KRvJCWCicja,1681289627,–°—ñ–ª—å–ø–æ,5411,5411,-13300,-13300,980,0,0,1886849,False,K4AM-AH83-C6B8-TPB2
t68kxoxQVVuOgu_m,1681287487,"Lifecell
+380631692598",4814,4814,-30000,-30000,980,0,0,1900149,True,A894-B8MM-5ET2-T36K
iVOSuz85t3niz9vo,1681285500,–°—ñ–ª—å–ø–æ,5411,5411,-3099,-3099,980,0,0,1930149,False,03HH-HPA2-9XB2-57A9
uoDuTc1FfTSfRTaB,1681285363,–°—ñ–ª—å–ø–æ,5411,5411,-37505,-37505,980,0,0,1933248,False,PK5K-AE40-PC24-AC27
thcv3Db42Q3xzi7K,1681281966,Bolt,4121,4121,-14400,-14400,980,0,0,1970753,False,C294-141K-KET8-0PP6
oqndyFHGtjA1Xb4V,1681234951,–¢–∞–±–∞–∫–µ—Ä–∫–∞,5993,5993,-41000,-41000,980,0,0,1985153,False,MBBA-AA8T-7H9P-EE91
rRpus85Pl9N3DYCN,1681234813,Novus,5411,5411,-50846,-50846,980,0,0,2026153,False,MBEH-T1TH-T0T9-992P
UJDswbvsvkoKUHuF,1681233436,BURGER FARM,5812,5812,-45045,-45045,980,0,900,2076999,False,67XC-AX8X-MX91-X334
K3EDQtMZk_BM7FHC,1681231264,VeterinarniyshpitalGenesi,742,742,-680870,-680870,980,0,0,2122044,False,X6CC-98C8-4326-TC2K
q_UkUJl5uQaOvgo5,1681231065,VeterinarniyshpitalGenesi,742,742,-565960,-565960,980,0,0,2802914,False,0B5B-8C4X-X8EM-XCAA
NClR3daD_JJUbFv7,1681224561,5045Kavjarnja,5814,5814,-8000,-8000,980,0,160,3368874,False,M2A2-1H64-KK03-T5B1
RfblTc4rS_bvZvA7,1681209823,SILPOSHOP 1,5411,5411,-196434,-196434,980,0,0,3376874,False,4HCK-5911-0HH3-T6XB
FT2Ur0Lpybtq2gEW,1681200368,Mates,5812,5812,-35200,-35200,980,0,704,3573308,True,0KBB-P79T-1C56-A149
md18pOpbY48ygmXj,1681195260,Bestwaytocup,5814,5814,-15500,-15500,980,0,310,3608508,False,MM1A-5399-8PB0-M654
dwJ50HQnA9F9TEVG,1681144620,CebuloTbilisi,5814,5814,-63500,-63500,980,0,1270,3624008,False,9K8T-K4A7-BC0X-C728
W769lMDjSSMC80wc,1681123439,Dubler,5814,5814,-45500,-45500,980,0,910,3687508,False,13CX-X2C6-838M-HH90
XFQLOFWT_YHomH1D,1681114650,–íi–¥: –ü–†–ò–•–û–î–¨–ö–û –ï.–í. –§–û–ü,"–î–ª—è –ø–æ–ø–æ–≤–Ω–µ–Ω–Ω—è –∫–∞—Ä—Ç–∫–∏ 5375414101190360, –ü—Ä–∏—Ö–æ–¥—å–∫–æ –ï—Ä–Ω–µ—Å—Ç –íi–∫—Ç–æ—Ä–æ–≤–∏—á, 3487403339",4829,4829,2900000,2900000,980,0,0,3733008,True
0zpxISVnMso-ReNX,1681059273,–ö–æ–ª–æ,5411,5499,-61270,-61270,980,0,0,833008,False,6HB5-PEPA-29TP-EH82
yIn8I7ESvL5ex2kE,1681046248,TOV V REBRO,5812,5812,-66500,-66500,980,0,498,894278,False,5MM2-61P0-39HM-M656
LBJfaERCqXXd-ub5,1681030514,SalonkrasotiHighFive,7230,7230,-85000,-85000,980,0,637,960778,False,MTP2-K8H4-978X-6H3E
hCXfD-vCvWMdI1fg,1681021293,Bestwaytocup,5814,5814,-24000,-24000,980,0,180,1045778,False,MEHM-5HP2-TMHE-721M
n6_wV8qftpVRTs23,1680968691,–ö–æ–ª–æ,5411,5499,-13650,-13650,980,0,0,1069778,False,E868-E4XK-6XHB-667X
5cGZXSIiLz9kS-Sq,1680963565,LIQPAY*Simona Ristoran,5812,5812,-47500,-47500,980,0,356,1083428,False,K5B7-5XTH-6XAP-MT9T
37iiZ6dLZWAbQuv7,1680962989,OK Wine,5411,5411,-43050,-43050,980,0,0,1130928,False,4024-E09P-5391-36A1
biUHuYvjKjDHsq3Z,1680961948,FOTOVRAMKE,5946,5946,-62000,-62000,980,0,0,1173978,False,PA5A-4ATX-M9P0-MCXP
AwpFfAW3aRGRh7pP,1680958629,–°—ñ–ª—å–ø–æ,5411,5411,-126586,-126586,980,0,0,1235978,False,X18C-1301-P935-7A12
rWyTx1x45mKG0EWV,1680957033,Goodwine,5921,5921,-311400,-311400,980,0,0,1362564,False,EM39-045B-AP34-3C81
SSEVzQvtH8ijTdKF,1680947459,FOP Sturova AS,5814,5814,-17800,-17800,980,0,133,1673964,False,8XA8-62T4-08H6-75B9
0LNgxtvMZM_oNYJH,1680941450,–ê–ø—Ç–µ–∫–∞ –ê–ù–¶,5912,5912,-76700,-76700,980,0,575,1691764,False,6X5M-3483-BK67-2BK4
ZwYTCeVoUqtOiPLi,1680940828,OKKO,5541,5541,-163966,-163966,980,0,0,1768464,False,039K-H8KA-H4P0-09B1
53JCFk_poQKsHeNy,1680936072,Bestwaytocup,5814,5814,-9500,-9500,980,0,71,1932430,False,T2M5-E3E9-CBP6-T97K
bpxDYLEvbkD0LT0x,1680900206,Bolt,4121,4121,-28000,-28000,980,0,0,1941930,False,8CH0-MM4H-TPXE-92HA
TFq9jgS_LQDTu8sT,1680897004,Brewers,5814,5814,-3500,-3500,980,0,26,1969930,False,K5XB-X2KA-00AP-BK2B
XwK6eBARSVs9xKq3,1680893524,Brewers,5814,5814,-18000,-18000,980,0,135,1973430,False,5876-9CK7-2X0E-CKK8
qYgrttofogSL4U6I,1680891921,Brewers,5814,5814,-32000,-32000,980,0,532,1991430,False,MXH9-4AX1-P70H-5899
HfPXue0yLrPhBk74,1680882757,–°—ñ–ª—å–ø–æ,5411,5411,-44500,-44500,980,0,0,2023430,False,MK17-XEB7-BAT8-KE36
DSHi8mJbfmnJtEzI,1680881476,–ï–ª–µ–∫—Ç—Ä–æ—Å–∞–º–æ–∫–∞—Ç–∏ Bolt,7999,7999,-1929,-1929,980,0,0,2067930,False,K889-C8BP-CEA5-464H
MpDREDOBMv0ubvYK,1680880916,–ï–ª–µ–∫—Ç—Ä–æ—Å–∞–º–æ–∫–∞—Ç–∏ Bolt,7999,7999,-4255,-4255,980,0,0,2069859,False,86X0-ABC8-2AXT-7KHH
I4gp3lSfhUWIW2_G,1680863325,–°—ñ–ª—å–ø–æ,5411,5411,-46000,-46000,980,0,0,2074114,False,HAAM-6864-XM08-KX90
lvcPif0PMlU1WF7p,1680845958,Bestwaytocup,5814,5814,-13900,-13900,980,0,278,2120114,False,5M82-05TP-945K-20EK
e5imvl6HJ6XlvGny,1680799867,WFP.AQUAMARKET,5411,5411,-68820,-68820,980,0,0,2134014,False,HHTT-087H-0889-H7CB
CTIeEJPIeDi_duQu,1680781368,–ü–µ—Ä–µ–∫–∞–∑ –Ω–∞ –∫–∞—Ä—Ç–∫—É,4829,4829,-900000,-900000,980,0,0,2202834,True
T-HTUl_rpZ2_pdC1,1680781351,–ü–æ–ø–æ–≤–Ω–µ–Ω–Ω—è ¬´–ù–∞ —Ç–µ–ø–ª–æ–≤—ñ–∑–æ—Ä¬ª,4829,4829,-200000,-200000,980,0,0,3102834,True,00X3-1PX0-B51E-E3K4
GJosxG1cWfExerk_,1680771877,–íi–¥: –ü–†–ò–•–û–î–¨–ö–û –ï.–í. –§–û–ü,"–î–ª—è –ø–æ–ø–æ–≤–Ω–µ–Ω–Ω—è –∫–∞—Ä—Ç–∫–∏ 5375414101190360, –ü—Ä–∏—Ö–æ–¥—å–∫–æ –ï—Ä–Ω–µ—Å—Ç –íi–∫—Ç–æ—Ä–æ–≤–∏—á, 3487403339",4829,4829,2100000,2100000,980,0,0,3302834,True
RdQoXQk8eJ58fuY2,1680762682,Bestwaytocup,5814,5814,-15500,-15500,980,0,116,1202834,False,263C-XKT8-CEX4-BABT
lGOoXs1E7hzukmFp,1680710453,–ó–∞–º–æ–≤–ª–µ–Ω–Ω—è —ó–∂—ñ,5499,5499,-66800,-66800,980,0,0,1218334,False,0XX6-XAHX-90EM-7PMA
21WcfqGBkkL0pelJ,1680705935,5045Kavjarnja,5814,5814,-8000,-8000,980,0,60,1285134,False,TXMP-2B9T-0M15-3KA0
PNcN_AOTy21HlX30,1680702934,Flowerbox,5992,5992,-35000,-35000,980,0,0,1293134,False,5214-B6C8-9E5X-T3A6
XfrYvSx3BjHVpuaF,1680702451,Beer Market,5921,5921,-62793,-62793,980,0,0,1328134,False,192X-XT6E-MBC5-83BB
CFq4ugWJV58uoo-e,1680702222,Magazin Master Zoo,5995,5995,-74430,-74430,980,0,0,1390927,False,8B7E-KE76-M1HM-396A
W3diOkHmygf6xNaK,1680684129,–ê–ø—Ç–µ–∫–∞ –ê–ù–¶,5912,5912,-49180,-49180,980,0,368,1465357,False,07H3-7M62-K22A-52PE
DOFigzHH43gm2snL,1680683815,–ö–æ–ª–æ,5411,5499,-10750,-10750,980,0,0,1514537,False,6405-EB80-32EK-X492
ranHO3M99avFHsOL,1680675639,5045Kavjarnja,5814,5814,-4500,-4500,980,0,33,1525287,False,TB64-P558-AP6B-T0BC
4b2eHBHoKsTFw-yq,1680621516,OK Wine,5921,5921,-52920,-52920,980,0,0,1529787,False,A553-5ATA-X8XA-EHK0
iOB1sixWJk7j5b0V,1680602870,–°—ñ–ª—å–ø–æ,5411,5411,-28800,-28800,980,0,0,1582707,False,4K7X-371K-7C4K-06P0
BJUyTlkt_udVSSkh,1680589890,La fabrique,5814,5814,-16500,-16500,980,0,123,1611507,False,C5CA-AKT6-88H5-T0BT
aRVw3YXIcAJ6mMzT,1680589538,Bestwaytocup,5814,5814,-15500,-15500,980,0,116,1628007,False,M750-T619-B3X4-80B9
afqbxXdDQnxtBs85,1680537401,–ó–∞–º–æ–≤–ª–µ–Ω–Ω—è —ó–∂—ñ,5499,5499,-86635,-86635,980,0,0,1643507,False,PCHT-35K5-AXTK-9C1M
GF8Ono1eRI7WxMjn,1680525508,magazin 762597,5912,5912,-53710,-53710,980,0,402,1730142,False,B22B-X1X5-X33M-EKCA
ZDdXGGEHdi2EEuP5,1680502745,Bestwaytocup,5814,5814,-12000,-12000,980,0,90,1783852,False,PAK4-4MTX-AM3M-7624
WRq-FF7wsmgVvj1Q,1680452665,Bolt Food,4215,4215,-59220,-59220,980,0,0,1795852,False,5TBA-5BTX-173A-KTT8
J22h1-bYZMO6ZYhA,1680435987,Urbanisty cafe,5812,5812,-7700,-7700,980,0,57,1855072,True,6HK3-T5HB-51A8-6588
2GCV_onXUtxA-IuO,1680435831,–°—ñ–ª—å–ø–æ,5411,5411,-97190,-97190,980,0,0,1862772,False,129A-2P14-XPPE-HB59
cC_4bflVCuE3_YDQ,1680434720,–ï–ª–µ–∫—Ç—Ä–æ—Å–∞–º–æ–∫–∞—Ç–∏ Bolt,7999,7999,-1626,-1626,980,0,0,1959962,False,99H5-97CK-8BA8-5006
PUsULVmfoPyYk0Xu,1680419984,Bestwaytocup,5814,5814,-6500,-6500,980,0,48,1961588,False,9KXP-21A7-A2AT-610P
dQYmMI4H91UiNMSE,1680354170,OK Wine,5411,5411,-52920,-52920,980,0,0,1968088,False,08A3-6PE8-6P1A-H11P
HQkCi_S0pDJzOOop,1680348453,–°—ñ–ª—å–ø–æ,5411,5411,-87232,-87232,980,0,0,2021008,False,05HH-C7H8-75KH-08H3
KZTRe9U9qi-OhQ9C,1680342324,Mates,5812,5812,-40300,-40300,980,0,0,2108240,True,A0H4-P8B9-AB50-2EMB
sHHA68Xob7u5zNm4,1680334719,Kafe Right Coffee Bar,5814,5814,-17500,-17500,980,0,0,2148540,False,MA07-K22B-88K8-168K
ysPboL_5iIeFhvKq,1680334554,–ü–∏—Ä—ñ–∂–∫–æ–≤–∞ ¬´–¢—ñ—Ç–∫–∞ –ö–ª–∞—Ä–∞¬ª,5814,5814,-17500,-17500,980,0,0,2166040,False,681P-H67K-9TT5-3KKX
D-wpTnvUso781LGY,1680334452,–ê–ø—Ç–µ–∫–∞ –ê–ù–¶,5912,5912,-51800,-51800,980,0,0,2183540,False,64C3-E1KA-XM4E-E870
Ey_4B9xQLNJO667r,1680334251,–ö–æ–ª–æ,5411,5499,-18150,-18150,980,0,0,2235340,False,BT6K-62P4-C7AX-7PT4
_sbsZ8qRFTuaHSB1,1680330478,Tachcard,7399,7399,-61800,-61800,980,0,0,2253490,False,7E81-BXAH-7M57-P6H4
Xdev5ibWG-jWbnYm,1682747866,–ó –ø–ª–∞—Ç–∏–Ω–æ–≤–æ—ó –∫–∞—Ä—Ç–∫–∏,4829,4829,800000,800000,980,0,0,1359199,True
6DZPmlAp6ta9I7nD,1682506100,545708****3380,4829,4829,-20000,-20000,980,0,0,559199,True,0X02-9BP2-E7BX-MPC2
o8BLRMTffDIKOMeb,1682249587,414960****7469,4829,4829,-10000,-10000,980,0,0,579199,True,EMA0-99T2-8BT0-C413
QL2zLUgVBORnno02,1682216401,–†–µ–≥—É–ª—è—Ä–Ω–µ –ø–æ–ø–æ–≤–Ω–µ–Ω–Ω—è ¬´–§–æ–Ω–¥ –ü–æ–≤–µ—Ä–Ω–∏—Å—å –∂–∏–≤–∏–º¬ª,4829,4829,-25000,-25000,980,0,0,589199,True
VWdaEB_qE3oTOVUc,1681611580,–†–µ–≥—É–ª—è—Ä–Ω–µ –ø–æ–ø–æ–≤–Ω–µ–Ω–Ω—è ¬´–§–æ–Ω–¥ –ü–æ–≤–µ—Ä–Ω–∏—Å—å –∂–∏–≤–∏–º¬ª,4829,4829,-25000,-25000,980,0,0,614199,True
yhekuKr-93w-y8t9,1681006742,–†–µ–≥—É–ª—è—Ä–Ω–µ –ø–æ–ø–æ–≤–Ω–µ–Ω–Ω—è ¬´–§–æ–Ω–¥ –ü–æ–≤–µ—Ä–Ω–∏—Å—å –∂–∏–≤–∏–º¬ª,4829,4829,-25000,-25000,980,0,0,639199,True
Ehr3tEQqaRQuLVxX,1680967872,414943****4420,4829,4829,-292800,-292800,980,0,0,664199,True,7C36-M9ME-7X23-A957
7GqO_MiO_q5yho-f,1680781457,–ü–æ–ø–æ–≤–Ω–µ–Ω–Ω—è ¬´–ù–ê –î–†–û–ùüá∫üá¶¬ª,4829,4829,-50000,-50000,980,0,0,956999,True,9P08-8CKT-88EK-TTK3
aTaHL9n_qYI6NFld,1680781368,–ó –ø–ª–∞—Ç–∏–Ω–æ–≤–æ—ó –∫–∞—Ä—Ç–∫–∏,4829,4829,900000,900000,980,0,0,1006999,True
Gr_NAMcQiR0YWAzw,1680696117,Lesya,4829,4829,-400000,-400000,980,0,0,106999,True,7B26-0BM6-0P24-KCKX
YkewI0TupnYqFEI6,1680402022,–†–µ–≥—É–ª—è—Ä–Ω–µ –ø–æ–ø–æ–≤–Ω–µ–Ω–Ω—è ¬´–§–æ–Ω–¥ –ü–æ–≤–µ—Ä–Ω–∏—Å—å –∂–∏–≤–∏–º¬ª,4829,4829,-25000,-25000,980,0,0,506999,True
j04SeSoT8LdsLE-Y,1685470999,–ê–≤—Ç–æ—Å—Ç–∞–Ω—Ü—ñ—è,5812,5812,-115000,-115000,980,0,0,3384516,True,C2XP-5CH8-C6CM-7C1C
Mct1OrsYNUB_42Ur,1685463842,Konteiner,5814,5814,-47000,-47000,980,0,0,3499516,False,52XC-7895-MBH0-PE9C
hTKaHtVedcM33-QI,1685463246,Promn,5651,5651,-88800,-88800,980,0,0,3546516,False,80TX-8X99-347C-78AT
FLi_eAq4PIqXmctS,1685455231,Uklon,4121,4121,-7500,-7500,980,0,0,3635316,False,M4BH-KCA8-6AT2-E2K1
Jh5penIMOpnvX8g6,1685454854,TOVMCDMRT,8099,8099,-150000,-150000,980,0,0,3642816,False,TB7C-X66C-E332-16PH
pOIhA1RMCmA6-L3T,1685453994,Bolt,4121,4121,-9800,-9800,980,0,0,3792816,False,26EP-CEC2-7362-1E52
ZGyCFVRaJc4J_Dkm,1685452150,–ì–∞–Ω–Ω–∞ –ü.,4829,4829,-183600,-183600,980,0,0,3802616,True,P468-381K-91TT-5EXA
s0uPNloUGK55kxXB,1685448002,–ü–æ–ø–æ–≤–Ω–µ–Ω–Ω—è ¬´–î–ª—è –ê–Ω–¥—Ä—ñ—è –ê–ø–æ—Å—Ç–æ–ª–∞¬ª,4829,4829,-1000000,-1000000,980,0,0,3986216,True,2424-1992-5BX4-TP10
O_crRCSPoV0rgFhT,1685447117,–íi–¥: –ü–†–ò–•–û–î–¨–ö–û –ï.–í. –§–û–ü,"–î–ª—è –ø–æ–ø–æ–≤–Ω–µ–Ω–Ω—è –∫–∞—Ä—Ç–∫–∏ 5375414101190360, –ü—Ä–∏—Ö–æ–¥—å–∫–æ –ï—Ä–Ω–µ—Å—Ç –íi–∫—Ç–æ—Ä–æ–≤–∏—á, 3487403339",4829,4829,4300000,4300000,980,0,0,4986216,True
02KcOaBDtsE7-rqq,1685440677,Bolt,4121,4121,-6000,-6000,980,0,0,686216,False,0KH1-AA78-3KKX-855C
EY_pCJrM7eIYhqE_,1685438149,UniversumCoffee,5814,5814,-6000,-6000,980,0,0,692216,False,88MM-T97X-1XE6-8TX6
bBKN1f37Bjbj-WCQ,1685436136,Bolt,4121,4121,-6000,-6000,980,0,0,698216,False,0AB0-0B9K-T203-TE6B
evpV5mrBUiS3kVrP,1685432196,Bolt,4121,4121,-6000,-6000,980,0,0,704216,False,77M7-0H25-M8CT-8CME
_cWrhoV_yqLhWcJa,1685430041,–ï–ª–µ–∫—Ç—Ä–æ—Å–∞–º–æ–∫–∞—Ç–∏ Bolt,7999,7999,-2398,-2398,980,0,0,710216,False,199X-69TE-8CK4-PP87
Q2TkvKOL4bDwxI0t,1685428421,Best way to cup,5814,5814,-9500,-9500,980,0,0,712614,False,BH0X-T5H4-1XM4-E334
p-n623sck60z6mx_,1685428249,Best way to cup,5814,5814,-45500,-45500,980,0,0,722114,False,A931-T792-B8A1-AT0P
kTB2fllmDOfTm6w1,1685427031,Best way to cup,5814,5814,-30000,-30000,980,0,0,767614,False,P9PP-9BE6-AXT3-288H
1C2CDjDfQEKq0wa4,1685424847,ZOOLYUKS,5995,5995,-35000,-35000,980,0,0,797614,False,P49X-0H64-97PB-THTK
l9l7dY1ranWzhsbP,1685390842,ZOOHUB,5995,5995,-36000,-36000,980,0,0,832614,True,7KC6-CC77-A81B-2HM9
fZ0QQWaIGZUEtAFx,1685370481,SHOPSILPO,5411,5411,-87053,-87053,980,0,0,868614,False,HKTE-87T0-E698-M8T3
Uj0VZr_yhHkgRGj1,1685358521,–ü–∏—Ä—ñ–∂–∫–æ–≤–∞ ¬´–¢—ñ—Ç–∫–∞ –ö–ª–∞—Ä–∞¬ª,5814,5814,-23900,-23900,980,0,0,955667,False,C7BK-BP92-2P4T-262C
9fOzAv3m-f_cbQnE,1685353233,–°—ñ–ª—å–ø–æ,5411,5411,-37634,-37634,980,0,0,979567,False,P3EM-TX4B-199B-1K4A
W792rBcNLWaCwir9,1685346050,OkvajnSichovih,5399,5399,-43050,-43050,980,0,0,1017201,False,M9KC-4C9P-9148-H2HP
i1NtZL6JLG8pfcFz,1685345390,Pethouse,5995,5995,-198400,-198400,980,0,0,1060251,False,X693-M9T7-65EB-70K4
2Ltb_B__SfuatxJS,1685344850,5045Kavjarnja,5814,5814,-6000,-6000,980,0,0,1258651,False,5H00-6E8H-TKBE-K0PK
u2g7kTIMX9Slo-IT,1685340684,–û–±—Å–ª—É–≥–æ–≤—É–≤–∞–Ω–Ω—è –ø–ª–∞—Ç–∏–Ω–æ–≤–æ—ó –∫–∞—Ä—Ç–∫–∏,4829,4829,-30000,-30000,980,0,0,1264651,True
KnbBpoSiwKAibcGo,1685339867,LIQPAY*Shine Bright,5977,5977,-40660,-40660,980,0,0,1294651,False
de59WaWNQ1H0TEci,1685290258,Konteiner,5814,5814,-48400,-48400,980,0,0,1335311,False,K1T7-477E-HE0B-M0TP
S9VFRaZ7gIDGRMn2,1685284583,–û–ø–ª–∞—Ç–∞ —à—Ç—Ä–∞—Ñ—É,4900,4900,-17000,-17000,980,0,0,1383711,True,999H-0PAX-KCE7-4654
3OgOwhiv7_lrS0-I,1685280134,OKKO,5541,5541,-210058,-210058,980,0,0,1400711,False,CM73-1524-1834-0509
irxanpQV-YdBlVZY,1685279376,EVA,5977,5977,-13600,-13600,980,0,0,1610769,False,4098-80HC-380H-K0EP
fuECj4C4htCZOyph,1685273927,PARKING KASA (BERESTEI,7523,7523,-2000,-2000,980,0,0,1624369,False,CB42-9281-ECHP-1X1C
8lA_UnL4i2Ii7Hzp,1685269300,BarberPet,7230,7230,-300000,-300000,980,0,0,1626369,False,235H-X2T7-8AB4-855A
cbNWmCHa6tU2U39D,1685268672,Good Girl,5812,5812,-118300,-118300,980,0,0,1926369,True,X5C5-A6X7-8A29-AM2E
0f4_rf3cCKU-cWxm,1685259275,Best way to cup,5814,5814,-9500,-9500,980,0,0,2044669,False,4B5A-B29A-AKBX-0K1T
Kt48VfUZ8v6V825r,1685257925,Octo,5814,5814,-9500,-9500,980,0,0,2054169,False,HEE0-XKT6-97C3-302K
vED5flmuMFLdQ0yB,1685257687,BarberPet,7230,7230,-95000,-95000,980,0,0,2063669,False,KK8M-01TB-1727-H1EM
2tUqijQzmMJDmIjK,1685209922,tisipi,5814,5814,-42000,-42000,980,0,0,2158669,False,EK91-7BB6-27EE-CCME
DU2QB4UFTnfeJhQ5,1685193043,Mates,5812,5812,-35700,-35700,980,0,0,2200669,True,A8PB-5395-M0BM-PP34
BZx4hUcFiUrUYpCw,1685187121,SHVEN massage,7297,7297,-130000,-130000,980,0,0,2236369,False,97MB-0326-T6E3-006A
dLBAnHkf7R0pn1Io,1685181060,magazin 762597,5912,5912,-216160,-216160,980,0,0,2366369,False,CC14-3E48-MTTM-H0X4
O66CFUSg3WS2sQmg,1685179406,Mates,5812,5812,-43100,-43100,980,0,0,2582529,True,P53K-C915-020B-H34T
ToDR_mQBSx9gS_lU,1685119369,–°–∫–∞—Å—É–≤–∞–Ω–Ω—è. BWTC,5814,5814,18000,18000,980,0,0,2625629,False
vkYnCuVUoY32wf_v,1685119369,BWTC,5814,5814,-18000,-18000,980,0,0,2607629,False,X621-A2AB-580X-PKAK
i-j_3LCaE45zAuos,1685119282,BWTC,5814,5814,-18000,-18000,980,0,0,2625629,False
yRZlA7P3FUus69Jr,1685119240,Best way to cup,5814,5814,-30000,-30000,980,0,0,2643629,False,HA39-EMAT-6A49-8HME
CwpY9Wpn69LCflTV,1685084766,OKKO,5541,5541,-4490,-4490,980,0,0,2673629,False,267T-03PP-T2M7-1H6X
vKYCtP46_ekOdVZx,1685038092,–°—ñ–ª—å–ø–æ,5411,5411,-62459,-62459,980,0,0,2678119,False,C662-99C4-7A4A-93X4
O7NeIdk5IfqblBb8,1685036914,–ï–ª–µ–∫—Ç—Ä–æ—Å–∞–º–æ–∫–∞—Ç–∏ Bolt,7999,7999,-1514,-1514,980,0,0,2740578,False,M8X0-H84H-A006-HK69
38XEvgCUVqQ9-n7I,1685034426,Konteiner,5814,5814,-27000,-27000,980,0,0,2742092,False,25CH-955A-AA1B-4891
GZubX4Ipyb5tKG-r,1685034196,Beer Market,5921,5921,-92295,-92295,980,0,0,2769092,False,CB71-1K4P-33E9-PH0E
H5a9Vlm3pOUVB7Ax,1685032599,WOG,5541,5541,-15200,-15200,980,0,0,2861387,False,5X4H-4BB1-6ME6-1CT5
3wLucQLioreSB697,1685032580,–°–∫–∞—Å—É–≤–∞–Ω–Ω—è. WOG,5541,5541,36746,36746,980,0,0,2876587,False
eaCJpKPp5-Gg5uNv,1685032453,WOG,5541,5541,-206756,-206756,980,0,0,2839841,False
0EVEZI3nR70_LTpb,1685030075,–ï–ª–µ–∫—Ç—Ä–æ—Å–∞–º–æ–∫–∞—Ç–∏ Bolt,7999,7999,-2776,-2776,980,0,0,3046597,False,2M8H-2564-XX99-MAEM
xff7OUk5D-a9RYeZ,1685029612,Best way to cup,5814,5814,-33500,-33500,980,0,0,3049373,False,1AX7-5238-07EE-97B2
OwQZ0pnrStQkaCJo,1685009162,Bolt,4215,4215,-101170,-101170,980,0,0,3082873,False,M8BK-4939-XPPM-B07M
THqQvMd-x1AIATjM,1685008259,–°–∫–∞—Å—É–≤–∞–Ω–Ω—è. Bolt Food,4215,4215,80160,80160,980,0,0,3184043,False
UNCAZKCrkqq8exPc,1685008144,–ú–∞–∫—Å–∏–º –°–∞—á–µ–Ω–∫–æ,4829,4829,-700000,-700000,980,0,0,3103883,True,CBBA-7MM3-5P53-K8EB
UO9N910tb7UgM1MM,1685007939,Bolt Food,4215,4215,-80160,-80160,980,0,0,3803883,False
0Z9kv7pQKsFvnzP9,1685007465,–íi–¥: –ü–†–ò–•–û–î–¨–ö–û –ï.–í. –§–û–ü,"–î–ª—è –ø–æ–ø–æ–≤–Ω–µ–Ω–Ω—è –∫–∞—Ä—Ç–∫–∏ 5375414101190360, –ü—Ä–∏—Ö–æ–¥—å–∫–æ –ï—Ä–Ω–µ—Å—Ç –íi–∫—Ç–æ—Ä–æ–≤–∏—á, 3487403339",4829,4829,1500000,1500000,980,0,0,3884043,True
Ns_Mwim1lkZIdHKf,1685003243,–ï–ª–µ–∫—Ç—Ä–æ—Å–∞–º–æ–∫–∞—Ç–∏ Bolt,7999,7999,-2370,-2370,980,0,0,2384043,False,6096-MMX5-E1CA-EKKP
JeyPwWU9EFP5eB6f,1685002595,StomatologijaHidental,8021,8021,-240000,-240000,980,0,0,2386413,False,XM7K-H9B9-463X-M23X
d9E-bhdpokvoz-aU,1685002479,Pethouse,5995,5995,-355000,-355000,980,0,32978,2626413,False,A877-5P88-H7M8-71AK
wb8bUGZ0PFfDk9dM,1684997699,–ï–ª–µ–∫—Ç—Ä–æ—Å–∞–º–æ–∫–∞—Ç–∏ Bolt,7999,7999,-2479,-2479,980,0,0,2981413,False,TBAX-X496-CAA1-7M6A
rBFcTaluYawaTM_k3NMtrw,1684971521,"BIRD UKR* RIDE,Rokin 92,AMSTERDAM,NL",7999,7999,-10000,-10000,980,0,0,2983892,True
JByHk-mmDzijIyYlyU2lKypPAQ,1684971521,–°–∫–∞—Å—É–≤–∞–Ω–Ω—è. Bird,7999,7999,6000,6000,980,0,0,2993892,False
jvy1yo7YBO5bo2pa,1684950588,–ö–∏—ó–≤—Å—å–∫–µ –º–µ—Ç—Ä–æ,4111,4111,-800,-800,980,0,0,2987892,False,8EP8-H9XM-MAA3-K5EE
7SA75gokBp1W_7Z7,1684947318,–ú–µ—Ä–µ–∂–∞ –∞–ø—Ç–µ–∫ D.S.,5912,5912,-17815,-17815,980,0,356,2988692,False,2EHB-01X9-4XE9-M15H
LOvWsTlWquRy2RWy,1684946907,Novus,5411,5411,-20088,-20088,980,0,0,3006507,False,0CT1-331C-472X-6H36
dNtYkCxuBrbvUfuh,1684939652,–ê–ø—Ç–µ–∫–∞—Ä—å,5912,5912,-48230,-48230,980,0,964,3026595,False,MKXC-7XH8-ABX2-430E
47aSm-hujpYQFviF,1684932518,Lesya,4829,4829,-600000,-600000,980,0,0,3074825,True,4AT8-7AT2-8KEK-BM7B
2ROcHpCZsoszPUGD,1684921143,–°—ñ–ª—å–ø–æ,5411,5411,-15425,-15425,980,0,0,3674825,False,P9XK-576E-5671-M3XE
XLGB1EYxZqtp1B7H,1684915848,–í–æ–ª–æ–¥–∏–º–∏—Ä –ë.,4829,4829,-788000,-788000,980,0,0,3690250,True,6HHX-159K-3BXP-6M2H
1uIb1YuJ-4Bfj92N,1684915434,–íi–¥: –ü–†–ò–•–û–î–¨–ö–û –ï.–í. –§–û–ü,"–î–ª—è –ø–æ–ø–æ–≤–Ω–µ–Ω–Ω—è –∫–∞—Ä—Ç–∫–∏ 5375414101190360, –ü—Ä–∏—Ö–æ–¥—å–∫–æ –ï—Ä–Ω–µ—Å—Ç –íi–∫—Ç–æ—Ä–æ–≤–∏—á, 3487403339",4829,4829,3900000,3900000,980,0,0,4478250,True
sVdqvR99-1-5nd2K,1684910719,–°—ñ–ª—å–ø–æ,5411,5411,-8676,-8676,980,0,0,578250,False,93E0-M0E6-6BM2-122M
GsTCtk6vRyqX_Rlh,1684910643,Bila Romashka,5912,5912,-29840,-29840,980,0,223,586926,False,AC46-7P49-EH29-39EA
tKcAhZ0XrN6_w2Tf,1684909505,Best way to cup,5814,5814,-9500,-9500,980,0,0,616766,False,TMMA-7T19-PK5H-T8XC
vUzPw-FpVo9wM2Pp,1684869498,LIQPAY*TOV Akvamarket,5411,5411,-91650,-91650,980,0,0,626266,False,34T6-77XA-5KPA-A5A1
XsBK8WMwV6vyKiqj,1684862264,–í–ö –ï–∫—Å–ø—Ä–µ—Å,5499,5499,-2660,-2660,980,0,0,717916,False,P0P9-A2XX-K68T-EXT2
V3voegTKfmAJwCeS,1684861645,Best way to cup,5814,5814,-12500,-12500,980,0,0,720576,False,8M9H-BCHX-XK2B-MAPK
R_eTetrx5u85CuJO,1684861596,–ï–ª–µ–∫—Ç—Ä–æ—Å–∞–º–æ–∫–∞—Ç–∏ Bolt,7999,7999,-1603,-1603,980,0,0,733076,False,2652-8P53-5K98-6T9C
J4rldpNnTlJJ_cmk,1684857712,–ï–ª–µ–∫—Ç—Ä–æ—Å–∞–º–æ–∫–∞—Ç–∏ Bolt,7999,7999,-3067,-3067,980,0,0,734679,False,MH7E-K6XT-86H6-XX84
5YDS3H_WCduB42t9,1684852783,SHOPSILPO,5411,5411,-65717,-65717,980,0,0,737746,False,65B9-C6P5-XHXX-982X
lZx5fzoNFFRLluuY,1684851783,Honey,5814,5812,-81600,-81600,980,0,0,803463,False,9BB4-AMAP-4P4A-P372
5v5jUXRDIh7_EDGN,1684845203,–°–∫–∞—Å—É–≤–∞–Ω–Ω—è. Bird,7999,7999,8500,8500,980,0,0,885063,False
wf_PPIJ-167EbuNR,1684845199,Bird,7999,7999,-8500,-8500,980,0,0,876563,False
SmkuedMg9l3L3hHt,1684845168,–í–ê–†–¶–ê–ë,5814,5814,-38000,-38000,980,0,0,885063,False,169M-M4PE-0BMX-XKE6
MMhNOTYKzqAl0IY3,1684839257,–ù–æ–≤–∞ –ø–æ—à—Ç–∞,4214,4214,-141500,-141500,980,0,0,923063,False,5P3X-3C16-EHT0-7KMB
WxAUbdVuPZYKzsfA,1684838403,Best way to cup,5814,5814,-18500,-18500,980,0,0,1064563,False,3TMT-K7ME-3H08-X6TX
XCtRTTJnGRW6VAl4,1684833812,Bird,7999,7999,-4000,-4000,980,0,0,1083063,False
iJ2H7PQA4n2hAdPJ,1684833558,–°–∫–∞—Å—É–≤–∞–Ω–Ω—è. Bird,7999,7999,8500,8500,980,0,0,1087063,False
s957u71NR0GW-cuV,1684833556,Bird,7999,7999,-6000,-6000,980,0,0,1078563,False
5K5TLWnW5d82420X,1684833553,Bird,7999,7999,-8500,-8500,980,0,0,1084563,False
36BAuhJh5uySNDfP,1684833477,Watsons,5977,5977,-30260,-30260,980,0,226,1093063,False,XHP8-TKTB-750H-EH24
WLh8WW66mLgDh7E8,1684825114,Best way to cup,5814,5814,-7000,-7000,980,0,0,1123323,False,6EB3-9APE-30C3-7T8A
7-Qw608OSaOcGtHC,1684823143,Best way to cup,5814,5814,-22000,-22000,980,0,0,1130323,False,P9EB-M873-K5BT-TM4X
7x-3ZnYhQ5Cc8ANe,1684774601,–¢–∞–±–∞–∫–µ—Ä–∫–∞,5993,5993,-41000,-41000,980,0,0,1152323,False,P130-6X67-784M-AKB7
TtthcaXIc8EYA7Tl,1684774530,Novus,5411,5411,-34050,-34050,980,0,0,1193323,False,B4TB-MM41-1MT5-560K
BbRgFr7UXs360ceX,1684773495,KnigarnyaKnizhkoviyLev,5942,5942,-6500,-6500,980,0,0,1227373,False,5X9A-K8M7-AT68-HEP5
mT_OgF1x29L3qrOL,1684773412,KnigarnyaKnizhkoviylev,5942,5942,-211500,-211500,980,0,0,1233873,False,H6K8-M9TM-X968-5AAK
dGMT4Ffsg6SK4J8X,1684772775,Best way to cup,5814,5814,-17000,-17000,980,0,0,1445373,False,0691-0BAC-0K06-P352
u8ApS1U-xnGS-bRH,1684772689,–ï–ª–µ–∫—Ç—Ä–æ—Å–∞–º–æ–∫–∞—Ç–∏ Bolt,7999,7999,-1232,-1232,980,0,0,1462373,False,M7BB-40AT-M8AB-PHXK
hgiJQDCDHByP8N72,1684748521,–°—ñ–ª—å–ø–æ,5411,5411,-5599,-5599,980,0,0,1463605,False,8AB9-4BXH-EH13-4504
UUpGf38iOnqcJPNq,1684735485,–°—ñ–ª—å–ø–æ,5411,5411,-38687,-38687,980,0,0,1469204,False,TEMM-84AX-TMP1-C5HK
AyO2dw7xShPT3akV,1684664862,–°—ñ–ª—å–ø–æ,5411,5411,-85842,-85842,980,0,0,1507891,False,BT67-48TT-M88H-53E0
1zCaRAvdqN4NrJCz,1684663463,One love coffee —Ü—É–º,7523,7523,-10000,-10000,980,0,0,1593733,False,EC0A-13TP-ME73-15H0
9rSTWauJnhGtn_IF,1684660514,SEJNOUMO,5814,5814,-6000,-6000,980,0,0,1603733,False,HP66-1B40-T676-0K1A
IzEjqornPJabMjct,1684652217,Best way to cup,5814,5814,-27500,-27500,980,0,0,1609733,False,5B78-8HET-896K-CE4H
SvjpecP2S2RjRAag,1684651535,La fabrique,5814,5814,-11000,-11000,980,0,0,1637233,False,EKA3-8117-TE5T-503K
NlUIHEPN2BNxpy89,1684651357,magazin 762597,5912,5912,-105444,-105444,980,0,790,1648233,False,KTB1-9H2E-845E-C09C
v1qpwlu39eVIprfy,1684605881,RestoranTinTin,5814,5814,-93200,-93200,980,0,0,1753677,False,MA93-65TP-89B5-3B4P
gd_0gZj0KtA8piMI,1684605850,Tin tin,5814,5814,-28000,-28000,980,0,0,1846877,False,B4M5-38KT-6127-275P
WF91fxj1ewxDIJbr,1684583198,Mates,5812,5812,-35200,-35200,980,0,0,1874877,True,4027-HM18-A89P-9E99
4KuQxjmrvzZzD9cZ,1684582972,–ï–ª–µ–∫—Ç—Ä–æ—Å–∞–º–æ–∫–∞—Ç–∏ Bolt,7999,7999,-1930,-1930,980,0,0,1910077,False,X76A-7C31-9909-2X9K
ZnnCMy5OlbWFTeOx,1684577905,Garage | Mirali,5812,5812,-125300,-125300,980,0,0,1912007,True,59E8-H208-P8PC-P210
mijxI83VfHtTaaNu,1684511928,–ï–ª–µ–∫—Ç—Ä–æ—Å–∞–º–æ–∫–∞—Ç–∏ Bolt,7999,7999,-2348,-2348,980,0,0,2037307,False,6224-HE59-B7AC-MC95
qp4zKkFb0JzdMplI,1684511632,LIQPAY*Prosto Mykolka,5947,5947,-80000,-80000,980,0,0,2039655,False,2CPE-XAM5-5XP0-40C8
cln9kgW1DBY00tsI,1684511357,–¢–∞–±–∞–∫–µ—Ä–∫–∞,5993,5993,-82000,-82000,980,0,0,2119655,False,3M3X-BTT5-88EP-BP89
KhK8qb3I52qMWlEG,1684510845,–ü–µ—Ä–µ–∫–∞–∑ –Ω–∞ –∫–∞—Ä—Ç–∫—É,4829,4829,-400000,-400000,980,0,0,2201655,True
ubUQXqw7l9d8J3Ux,1684509063,BWTC,5814,5814,-13000,-13000,980,0,0,2601655,False,E7X3-7M08-A63E-6A9E
eeRMl6qsF_xL5SSH,1684504499,–íi–¥: –ü–†–ò–•–û–î–¨–ö–û –ï.–í. –§–û–ü,"–î–ª—è –ø–æ–ø–æ–≤–Ω–µ–Ω–Ω—è –∫–∞—Ä—Ç–∫–∏ 5375414101190360, –ü—Ä–∏—Ö–æ–¥—å–∫–æ –ï—Ä–Ω–µ—Å—Ç –íi–∫—Ç–æ—Ä–æ–≤–∏—á, 3487403339",4829,4829,2200000,2200000,980,0,0,2614655,True
a0Cx0nNWie8ug7QO,1684497754,Fotovramke,5946,5946,-215000,-215000,980,0,0,414655,False,A3EE-M2P8-AP5H-KME3
5JA0C_F23eXrOnpf,1684477281,Best way to cup,5814,5814,-6500,-6500,980,0,0,629655,False,07AK-E16C-A230-06TK
bGdLD4avGf6Qgkoj,1684430193,Bolt,4121,4121,-11300,-11300,980,0,0,636155,False,X993-82T4-8XH5-AXBE
JBho6pTqIbCqvZt7,1684425888,Bolt,4121,4121,-8400,-8400,980,0,0,647455,False,BT08-A61T-A619-64M8
2QzIwy9jb3RDGm59,1684416030,Bolt,4121,4121,-10800,-10800,980,0,0,655855,False,73CH-8T89-T57X-BCM5
A3FBkY3gaTvUCFlY,1684403539,–°—ñ–ª—å–ø–æ,5411,5411,-36786,-36786,980,0,0,666655,False,247E-EAXH-A1MX-TA7X
oD-cMnzJjMxB1_Og,1684397699,Bolt,4121,4121,-9300,-9300,980,0,0,703441,False,96PP-AE6T-00MH-4C57
LvYthb7Mc53MFQbP,1684395452,StomatologijaHidental,8021,8021,-100000,-100000,980,0,750,712741,False,B48H-2390-8695-TBX0
6Zs2KlIuVNcV0Xdp,1684393304,Coffeereligia,5812,5812,-15000,-15000,980,0,0,812741,False,H0E8-A45T-BX6H-T18H
WDS2Q_q9tR-4C5ov,1684393180,Rozetka,5399,5399,-109900,-109900,980,0,0,827741,False,HX6T-XB4P-7X5X-6471
o9XyA91IhdBU2nIV,1684392773,–ï–ª–µ–∫—Ç—Ä–æ—Å–∞–º–æ–∫–∞—Ç–∏ Bolt,7999,7999,-2289,-2289,980,0,0,937641,False,50AK-6BMX-B28P-H8AX
iA5SemHABiCEQGO_,1684350569,–ï–ª–µ–∫—Ç—Ä–æ—Å–∞–º–æ–∫–∞—Ç–∏ Bolt,7999,7999,-3759,-3759,980,0,0,939930,False,88B2-34TX-H487-HEM0
yC_b0rrpyEwGiQwt,1684345571,–ï–ª–µ–∫—Ç—Ä–æ—Å–∞–º–æ–∫–∞—Ç–∏ Bolt,7999,7999,-1835,-1835,980,0,0,943689,False,BPPH-80B3-ETC0-58MB
46ol_XNb0gvz7j9S,1684342267,The Cinematographer‚Äôs Party,5814,5814,-84000,-84000,980,0,0,945524,False,CK5B-434E-8C9C-2T95
9RxhjxZLX69FD6vh,1684339691,–ï–ª–µ–∫—Ç—Ä–æ—Å–∞–º–æ–∫–∞—Ç–∏ Bolt,7999,7999,-1722,-1722,980,0,0,1029524,False,0C6P-2PE0-A35E-573E
f56VB7WShe5dApFj,1684320081,magazin 762597,5912,5912,-51180,-51180,980,0,383,1031246,False,PCM2-HKC7-XE01-C29A
q-kRgF1BMSoRoETM,1684319059,Mates,5812,5812,-123200,-123200,980,0,0,1082426,True,T6AA-26HT-E1EP-4XP3
mmhBTMmxSJc8S1ul,1684317584,–ï–ª–µ–∫—Ç—Ä–æ—Å–∞–º–æ–∫–∞—Ç–∏ Bolt,7999,7999,-2043,-2043,980,0,0,1205626,False,5K84-8E33-4B7P-4BKA
uUYSKeuVTd9e0JDg,1684317225,–í—ñ–¥: –ú–∏–∫–æ–ª–∞ –û–≥–æ–π–∫–æ,4829,4829,9000,9000,980,0,0,1207669,True
G4Ozade0JnJoysja,1684316613,Bolt,4121,4121,-12400,-12400,980,0,0,1198669,False,PKP9-1CBX-TK9K-A43M
Zr8DGuUIs6kreTrU,1684315871,Mates,5812,5812,-35200,-35200,980,0,0,1211069,True,X0B0-P21T-T2EB-9K1K
l2EHZU9BoqthNWU4,1684313822,Fdclinic,8021,8021,-120000,-120000,980,0,900,1246269,False,97XH-891X-1C4K-XM5B
1ien5ZskieWorIvA,1684310978,Bolt,4121,4121,-8200,-8200,980,0,0,1366269,False,K7KB-2480-61H4-5CB8
1JawcebYjBrQCpHW,1684305823,Best way to cup,5814,5814,-13000,-13000,980,0,0,1374469,False,76P7-276M-3BPE-7103
7Malu9lB1J-s9VXb,1684304568,Best way to cup,5814,5814,-15500,-15500,980,0,0,1387469,False,80C1-EKC6-8CP8-4BE1
foFGtUJczr0Uw80O,1684232105,–ï–ª–µ–∫—Ç—Ä–æ—Å–∞–º–æ–∫–∞—Ç–∏ Bolt,7999,7999,-2569,-2569,980,0,0,1402969,False,KCE1-8B3K-6048-3AM9
wJJPANjY0OcvxUUx,1684231631,StomatologijaHidental,8021,8021,-125000,-125000,980,0,937,1405538,False,BTCA-7K78-P31H-5PC2
9F21Ou2LldISED6-,1684228975,–ï–ª–µ–∫—Ç—Ä–æ—Å–∞–º–æ–∫–∞—Ç–∏ Bolt,7999,7999,-3192,-3192,980,0,0,1530538,False,B8BH-0541-M24B-TB56
Abs5zmt8WUQMZkWx,1684228138,Pethouse,5995,5995,-398100,-398100,980,0,2985,1533730,False,973H-KPBB-4E5C-M88T
nGbDrYEqlOBiE1-V,1684224149,FOP Sturova AS,5814,5814,-15000,-15000,980,0,0,1931830,False,5E9K-21HA-871A-B768
d9Ljy5M3-GqpH1FY,1684217989,Best way to cup,5814,5814,-6500,-6500,980,0,0,1946830,False,098E-X042-69CE-KX2K
E52NyCxgrc6F7nnV,1684215977,–ï–ª–µ–∫—Ç—Ä–æ—Å–∞–º–æ–∫–∞—Ç–∏ Bolt,7999,7999,-3269,-3269,980,0,0,1953330,False,P4MC-4C4T-A23M-0B4E
z-Z22xAK26sze-WT,1684170423,–¢–∞–±–∞–∫–µ—Ä–∫–∞,5993,5993,-41000,-41000,980,0,0,1956599,False,403C-5AB7-P9PC-2E8M
r92Itxo3e4BbUPak,1684170270,Novus,5411,5411,-160613,-160613,980,0,0,1997599,False,9098-TPKT-KP6C-THEC
iTBcBfVjQNnMsIr5,1684167283,Bolt,4121,4121,-15600,-15600,980,0,0,2158212,False,BXA8-95M3-03XA-486M
Dn0-zXf1fG3IKA2R,1684143736,–°—ñ–ª—å–ø–æ,5411,5411,-9459,-9459,980,0,0,2173812,False,XT9K-EAMC-7P49-447T
t3V4PLGnjqyNW6f1,1684138116,–ü–µ—Ä–µ–∫–∞–∑ –Ω–∞ –∫–∞—Ä—Ç–∫—É,4829,4829,-400000,-400000,980,0,0,2183271,True
8LW5MPWBuQJMWtFB,1684138103,Lesya,4829,4829,-600000,-600000,980,0,0,2583271,True,59X8-7C67-21T2-TH82
lXtDqde4Q2JFG8D4,1684137383,–íi–¥: –ü–†–ò–•–û–î–¨–ö–û –ï.–í. –§–û–ü,"–î–ª—è –ø–æ–ø–æ–≤–Ω–µ–Ω–Ω—è –∫–∞—Ä—Ç–∫–∏ 5375414101190360, –ü—Ä–∏—Ö–æ–¥—å–∫–æ –ï—Ä–Ω–µ—Å—Ç –íi–∫—Ç–æ—Ä–æ–≤–∏—á, 3487403339",4829,4829,2800000,2800000,980,0,0,3183271,True
-eHCRWzV2myWQ1oH,1684134080,–°—ñ–ª—å–ø–æ,5411,5411,-20551,-20551,980,0,0,383271,False,BPM1-BM3B-B63A-MTK2
5zmNg1qSY6PPUMMb,1684132312,–ö–∏—ó–≤—Å—å–∫–µ –º–µ—Ç—Ä–æ,4111,4111,-800,-800,980,0,0,403822,False,MM9X-32C1-587X-23T0
5qUcRCSGTQ3K3FZS,1684132049,Bolt,4121,4121,-12200,-12200,980,0,0,404622,False,51B0-3XPT-M7TE-B0K7
RTBc5_xCzRvz-0uF,1684132012,Best way to cup,5814,5814,-6500,-6500,980,0,0,416822,False,0CP4-0TA1-467P-TT7C
Joli2jnm8qpovHC7,1684079392,5045Kavjarnja,5814,5814,-6000,-6000,980,0,0,423322,False,MC2A-64B8-5A35-C86H
YCD8dyI5X85yxP8o,1684077812,5045Kavjarnja,5814,5814,-6000,-6000,980,0,0,429322,False,AMMB-34A2-5AA8-643E
tQ_nmVQUJ9r2AU7n,1684069922,Novus,5411,5411,-16400,-16400,980,0,0,435322,False,5210-42CK-P5M4-T6CH
8buWztPFoZvNBzzS,1684069668,Magazin Master Zoo,5995,5995,-122200,-122200,980,0,6110,451722,False,BBKH-222A-C123-0XPB
bdwhQ2sWGvL1hDto,1684065645,TOV V REBRO,5812,5812,-72000,-72000,980,0,0,573922,False,CHM0-4T0X-PKMK-8679
m8WgdGiVtvDbPCaC,1684063752,Bolt,4121,4121,-15600,-15600,980,0,0,645922,False,M0XB-K7AX-ATT3-TK1C
hIqiLqQLoPFqgEAw,1684056685,t.c.pizza,5812,5812,-90800,-90800,980,0,0,661522,True,9A93-TC50-E117-T0E0
7279Mo4YsrhxGYOV,1684053193,–ï–ª–µ–∫—Ç—Ä–æ—Å–∞–º–æ–∫–∞—Ç–∏ Bolt,7999,7999,-1635,-1635,980,0,0,752322,False,41P3-5701-9EM7-B81X
yoS1EKoSoJlpwYTO,1684051402,–¢–∞–±–∞–∫–µ—Ä–∫–∞,5993,5993,-41000,-41000,980,0,0,753957,False,21BA-KCCB-503X-905B
8QpMKaMqswNKSXa4,1684051304,Novus,5411,5411,-27197,-27197,980,0,0,794957,False,8AMP-BHTB-MC48-0T5P
FvopapgffuRZZWCf,1684050349,Best way to cup,5814,5814,-9500,-9500,980,0,0,822154,False,PTB6-EA45-BBHT-9M50
mxJpTZAkG7rooIJG,1684047801,Best way to cup,5814,5814,-9500,-9500,980,0,0,831654,False,785P-135A-7XE6-X5CP
NKdGF94aIY1IAYAI,1683999799,Goodwine,5921,5921,-280200,-280200,980,0,0,841154,False,KC30-B8PH-3XC8-BE86
MlBedjJ8WKyH96Fb,1683963424,–°—ñ–ª—å–ø–æ,5411,5411,-87300,-87300,980,0,0,1121354,False,8EB3-00A3-A2KT-9C6C
DEvc10EVROkqs7s3,1683963355,–°—ñ–ª—å–ø–æ,5411,5411,-48046,-48046,980,0,0,1208654,False,P29H-0X5T-4P2P-6072
tBlOZQlOvdIIZB8g,1683959243,Best way to cup,5814,5814,-18000,-18000,980,0,0,1256700,False,C64P-9795-P80X-4CH3
cY4lU6LqLvNq7EJv,1683917491,The Cinematographer‚Äôs Party,5814,5814,-87000,-87000,980,0,0,1274700,False,C87M-TCA6-2T6H-9K2T
BMotHTzUyUNq2wpY,1683914083,The Cinematographer‚Äôs Party,5814,5814,-63000,-63000,980,0,0,1361700,False,T965-42CC-6K18-31H1
FoB2ONQ8aN3XIOii,1683911106,The Cinematographer‚Äôs Party,5814,5814,-42000,-42000,980,0,0,1424700,False,EM24-29P4-XK4M-5XMH
MlXyXqM2aGg1rdrt,1683910959,–ï–ª–µ–∫—Ç—Ä–æ—Å–∞–º–æ–∫–∞—Ç–∏ Bolt,7999,7999,-2779,-2779,980,0,0,1466700,False,MC39-7X0C-7K30-H62X
q5pTxRnIF2-k3fTg,1683896896,OK Wine,5411,5411,-111200,-111200,980,0,0,1469479,False,X5TC-7T1B-P46T-EHM5
Cx5y3YPsmFSbR4QL,1683896409,PershaRestoraciyaShaurmi,5814,5814,-25800,-25800,980,0,0,1580679,False,B1P6-4TBP-PP6B-9266
qR0C9V9Z0HMfnWwV,1683879447,Novapay,8999,8999,-5000,-5000,980,0,0,1606479,False,CBKC-75EP-X3XM-AKTH
ZaIe3bbm7HIDfdRb,1683877873,Best way to cup,5814,5814,-25500,-25500,980,0,0,1611479,False,MTPX-5B8C-3X4H-9040
K4uDxtw-1R9kfalO,1683874470,KISHMISH,5499,5499,-6200,-6200,980,0,0,1636979,False,H9TC-5H69-P7CA-K7C1
whvHTVkEKeR2C-Jo,1683874366,Novus,5411,5411,-59237,-59237,980,0,0,1643179,False,H6H0-4TE1-5C6P-21TK
xaWnwVc-s62ObK_7,1683873251,LayrelLav,8099,8099,-380000,-380000,980,0,3880,1702416,False,5T93-5645-60MH-48H1
7XrufLSJ5tyTkifR,1683797854,–°—ñ–ª—å–ø–æ,5411,5411,-54397,-54397,980,0,0,2082416,False,AK17-28B8-K4XX-14X0
VxUyR21EiAHFh7pc,1683738870,Konteiner,5814,5814,-29000,-29000,980,0,0,2136813,False,8A3T-HHH6-1302-8K22
cyg2SeSpxMbsLlgr,1683738810,Konteiner,5814,5814,-25400,-25400,980,0,0,2165813,False,P795-456C-C53T-364B
a5sTZv8zRTkDsbwF,1683737011,–ó–∞–º–æ–≤–ª–µ–Ω–Ω—è —ó–∂—ñ,5499,5499,-77290,-77290,980,0,0,2191213,False,1HKK-TX9B-6X4H-139A
tgZqb1ryPljvn4sr,1683736042,Lesya,4829,4829,-400000,-400000,980,0,0,2268503,True,4XKA-3659-8022-6808
2Y7iau43hhq-EFI5,1683729421,Novapay,8999,8999,-6000,-6000,980,0,0,2668503,False,3572-E7E0-3MAH-2XM8
HlnKOvNaAzXsV54N,1683720142,–°—ñ–ª—å–ø–æ,5411,5411,-53883,-53883,980,0,0,2674503,False,X0X0-14HA-4E8B-06B7
8x_JSnTvfeRNMd6p,1683719570,–ï–ª–µ–∫—Ç—Ä–æ—Å–∞–º–æ–∫–∞—Ç–∏ Bolt,7999,7999,-1835,-1835,980,0,0,2728386,False,MKCH-T5B8-AA6X-108P
M9zG6I_uECTqBHUh,1683719309,Mates,5812,5812,-6000,-6000,980,0,0,2730221,True,358B-85TP-H1X4-HCX2
x8y_QRfaKQZMY3AM,1683719059,Mates,5812,5812,-30000,-30000,980,0,0,2736221,True,MM0A-33M1-0843-9A78
mMpIDiJrpTbnRph-,1683716532,–ï–ª–µ–∫—Ç—Ä–æ—Å–∞–º–æ–∫–∞—Ç–∏ Bolt,7999,7999,-1954,-1954,980,0,0,2766221,False,155X-PKPK-M6TX-HT9K
hLnVRNRhzzz6Ky_B,1683713613,—Ñ–æ–ø –¢–∏—Ç–∞—Ä–µ–Ω–∫–æ –¢–µ—Ç—è–Ω–∞ –ê–Ω–∞—Ç–æ–ª—ñ—ó–≤–Ω–∞,4829,4829,-81900,-81900,980,0,0,2768175,True,E533-X2CM-8P16-P5B9
W3hoDwycdgYjtczo,1683709919,–íi–¥: –ü–†–ò–•–û–î–¨–ö–û –ï.–í. –§–û–ü,"–î–ª—è –ø–æ–ø–æ–≤–Ω–µ–Ω–Ω—è –∫–∞—Ä—Ç–∫–∏ 5375414101190360, –ü—Ä–∏—Ö–æ–¥—å–∫–æ –ï—Ä–Ω–µ—Å—Ç –íi–∫—Ç–æ—Ä–æ–≤–∏—á, 3487403339",4829,4829,2500000,2500000,980,0,0,2850075,True
tsTfSQJCyy6CQsr5,1683702540,Best way to cup,5814,5814,-43000,-43000,980,0,0,350075,False,E1E6-3597-78A3-27TP
TT1pgtHvlvLRIcjm,1683642092,Kafe Right Coffee Bar,5814,5814,-8000,-8000,980,0,0,393075,False,P3EE-X618-HC0H-KHA0
CnCP8Ki8EZZyZOVH,1683641020,Kafe Right Coffee Bar,5814,5814,-8500,-8500,980,0,0,401075,False,M17K-5HTM-01MK-H976
kweHa3MPpahdaqnc,1683640859,APTEKA7,5912,5912,-18150,-18150,980,0,136,409575,False,151M-TK4H-P58E-X531
o0O0udhJxWjIWBo9,1683640756,Beer Market,5921,5921,-105840,-105840,980,0,0,427725,False,B54E-E1K9-MC2X-E6A7
o_dA9Q9Rhwg3cTqa,1683640585,Novus,5411,5411,-8296,-8296,980,0,0,533565,False,1944-CT47-1H69-7KT6
3zZj1J7SCA7ZCE27,1683640311,30880,5912,5912,-33440,-33440,980,0,250,541861,False,H241-4K95-HB8B-XME8
ehmFW67rPT58Xln_,1683637338,IDEALIST COFFEE CO,5814,5814,-9800,-9800,980,0,0,575301,False,725C-B7H5-P59K-K883
L-PteN6e-W7ng24r,1683636167,–ï–ª–µ–∫—Ç—Ä–æ—Å–∞–º–æ–∫–∞—Ç–∏ Bolt,7999,7999,-1998,-1998,980,0,0,585101,False,0MB0-4A5C-X544-H383
unKjZDOXzfrqzy3n,1683636153,–ï–ª–µ–∫—Ç—Ä–æ—Å–∞–º–æ–∫–∞—Ç–∏ Bolt,7999,7999,-1903,-1903,980,0,0,587099,False,KC08-2C55-2XB1-9MBP
sNNPb2ndpUGXA8r2,1683635554,RestoranTinTin,5814,5814,-93100,-93100,980,0,0,589002,False,TTM1-9X02-0129-MBX3
gcEnt7iycjbZPLIk,1683635537,Tin tin,5814,5814,-24700,-24700,980,0,0,682102,False,HC90-MB2A-A91T-X55H
MDU72tTq37DIgYOA,1683632177,–ï–ª–µ–∫—Ç—Ä–æ—Å–∞–º–æ–∫–∞—Ç–∏ Bolt,7999,7999,-1731,-1731,980,0,0,706802,False,74EM-200K-1KM6-MAT6
e6Tm18zaXHTnveeE,1683632170,–ï–ª–µ–∫—Ç—Ä–æ—Å–∞–º–æ–∫–∞—Ç–∏ Bolt,7999,7999,-2583,-2583,980,0,0,708533,False,M2H1-71XM-2PPT-0229
SqXDnIIcEiL-UGuB,1683617336,Best way to cup,5814,5814,-16500,-16500,980,0,0,711116,False,17HT-MXT4-79CH-KA41
Iy0YPJMrCSQRHZSQ,1683560650,–ï–ª–µ–∫—Ç—Ä–æ—Å–∞–º–æ–∫–∞—Ç–∏ Bolt,7999,7999,-1576,-1576,980,0,0,727616,False,E0H4-E1KH-22B5-3XM7
LF8IkMERBnyunhx2,1683560411,–°—ñ–ª—å–ø–æ,5411,5411,-108177,-108177,980,0,0,729192,False,086K-6MA6-449H-3A6A
QWd-yw7XEmtaL_bs,1683559670,–ï–ª–µ–∫—Ç—Ä–æ—Å–∞–º–æ–∫–∞—Ç–∏ Bolt,7999,7999,-1576,-1576,980,0,0,837369,False,399X-CE3P-CB7C-CM4K
RFAArb6LaVxe62D-,1683551782,Pethouse,5995,5995,-306100,-306100,980,0,2295,838945,False,H829-X4KE-3A83-E6TH
JP3Bejj8n9WBplmX,1683548239,–ï–ª–µ–∫—Ç—Ä–æ—Å–∞–º–æ–∫–∞—Ç–∏ Bolt,7999,7999,-2434,-2434,980,0,0,1145045,False,70T3-588P-EP0B-14AP
d8Xdcy80kCGL8Y8W,1683546348,Konteyner,5814,5814,-33600,-33600,980,0,0,1147479,False,6800-HTP6-A449-P71H
ijdEgBlBWCpI6f3u,1683544879,Kitaika.Kitchen | –ó–æ–ª–æ—Ç–æ—É—Å—Ç—ñ–≤—Å—å–∫–∞,5812,5812,-33690,-33690,980,0,0,1181079,True,35PM-87M6-ABBP-MC38
PoyAgpZsYZVKt7N5,1683543262,–ï–ª–µ–∫—Ç—Ä–æ—Å–∞–º–æ–∫–∞—Ç–∏ Bolt,7999,7999,-4056,-4056,980,0,0,1214769,False,7HAX-21PK-5T2E-8P85
pifHoDKF902yw5iF,1683538616,–°—ñ–ª—å–ø–æ,5411,5411,-21403,-21403,980,0,0,1218825,False,221B-B9PX-221H-5X30
1DtqqgPtiYnIRXak,1683528615,–ö–æ–ª–æ,5411,5499,-8350,-8350,980,0,0,1240228,False,2581-6716-0KPE-7BPM
d1n8Jm4Lg7T8qb6D,1683527137,Best way to cup,5814,5814,-25500,-25500,980,0,0,1248578,False,86A6-H3H0-50T1-KHXT
-wF43V-4TASxCDpa,1683472909,–°—ñ–ª—å–ø–æ,5411,5411,-17712,-17712,980,0,0,1274078,False,051H-MBHP-B0HE-5XHX
00Uu7AU6ade8zQOY,1683458412,Konteiner,5814,5814,-75900,-75900,980,0,0,1291790,False,00M1-3E07-B7C8-0BE0
4HbgsdlVVf8_7q8O,1683458053,–ó–∞–º–æ–≤–ª–µ–Ω–Ω—è —ó–∂—ñ,5499,5499,-76450,-76450,980,0,0,1367690,False,B6B5-C00X-EE51-0CK5
Xnt3NPPOInQjmcVq,1683457682,Beer Market,5921,5921,-14798,-14798,980,0,0,1444140,False,C1AA-KP8B-M0C2-75BP
zmB5N4-Px1rECgTn,1683457069,ZAVOD,5944,5944,-360800,-360800,980,0,0,1458938,False,TC7T-0B39-PCEH-64TE
NeHPPvwVSif1lSj6,1683447281,SP ARCIVR LIVE,7929,7929,-64585,-1725,840,0,0,1819738,False,57PX-M988-P54X-75A0
vtX4-B_Icl_WfBNx,1683443957,KnigarnyaKnizhkoviyLev,5942,5942,-8500,-8500,980,0,0,1884323,False,82XK-P46E-3BMA-3K71
CYXpeWEc20lgcr96,1683443938,KnigarnyaKnizhkoviylev,5942,5942,-60000,-60000,980,0,0,1892823,False,H5BX-B4A0-28E5-0292
Pfc3ur0ueHiJrmAR,1683443088,KnigarnyaKnizhkoviyLev,5942,5942,-9500,-9500,980,0,0,1952823,False,128P-P5EC-2557-MP3X
6ObriLd01nxRASGC,1683443062,KnigarnyaKnizhkoviylev,5942,5942,-34500,-34500,980,0,0,1962323,False,A947-E2M2-0KKA-9AAC
7qlfxWrgVP7tumfP,1683392898,LIQPAY*TC Pizza Kyiv,5812,5812,-78225,-78225,980,0,0,1996823,False,4E28-5ACA-KPX3-MX9X
YXT7c_hEQe6WCAO7,1683372641,–í–ê–†–¶–ê–ë,5814,5814,-35000,-35000,980,0,0,2075048,False,50M9-B7M2-C7P7-M648
0CjrGcUsjZFsZr0r,1683372264,OK Wine,5411,5411,-48510,-48510,980,0,0,2110048,False,BTMT-2XPK-1TTP-3MA9
GvIP1F7g9drZ6W9c,1683371003,Mates,5812,5812,-84200,-84200,980,0,0,2158558,True,55HB-TB8E-CX4X-P59H
b0zw_cCmOREKSplj,1683369106,–ï–ª–µ–∫—Ç—Ä–æ—Å–∞–º–æ–∫–∞—Ç–∏ Bolt,7999,7999,-1811,-1811,980,0,0,2242758,False,1XPB-CM45-3B4B-5AP8
yn6L782jk_hwrlod,1683365208,Best way to cup,5814,5814,-5500,-5500,980,0,0,2244569,False,54M5-28XB-K7X2-5911
s2e3_BE0hAtDPQZC,1683365086,Best way to cup,5814,5814,-53500,-53500,980,0,0,2250069,False,3207-P4A0-432E-1377
4ryDJUca7jGcM7di,1683361784,OKKO,5541,5541,-181541,-181541,980,0,0,2303569,False,H6A3-E496-84A0-H7C8
xnySs0Z3OnkYGcnA,1683352964,Best way to cup,5814,5814,-19200,-19200,980,0,0,2485110,False,BHBA-262P-4T3K-MBA4
N4ZqtcERESMumM7_,1683281588,–íi–¥: –ü–†–ò–•–û–î–¨–ö–û –ï.–í. –§–û–ü,"–î–ª—è –ø–æ–ø–æ–≤–Ω–µ–Ω–Ω—è –∫–∞—Ä—Ç–∫–∏ 5375414101190360, –ü—Ä–∏—Ö–æ–¥—å–∫–æ –ï—Ä–Ω–µ—Å—Ç –íi–∫—Ç–æ—Ä–æ–≤–∏—á, 3487403339",4829,4829,2300000,2300000,980,0,0,2504310,True
IpMaUZeDuciiZD19,1683281392,–°–∫–∞—Å—É–≤–∞–Ω–Ω—è. Bird,7999,7999,6000,6000,980,0,0,204310,False
-ZC6Rtbl5ncJXSRy,1683281383,Bird,7999,7999,-6000,-6000,980,0,0,198310,False
3jyCskWJX9Gt6u0g,1683281082,–°–∫–∞—Å—É–≤–∞–Ω–Ω—è. Bird,7999,7999,8500,8500,980,0,0,204310,False
XS1L94SyH3hud1uP,1683281080,Bird,7999,7999,-8500,-8500,980,0,0,195810,False
DbAsPUrxFH-YTmDX,1683279287,HUMANS COFFEE IN TECH,5814,5814,-8000,-8000,980,0,0,204310,False,3BBM-8B20-6095-0HE7
HPKHTWYU2xxyQ9F_,1683276852,t.c.pizza,5812,5812,-112200,-112200,980,0,0,212310,True,T921-B8XX-47HP-7705
JjwrJODKDXi7MDlh,1683272659,–ï–ª–µ–∫—Ç—Ä–æ—Å–∞–º–æ–∫–∞—Ç–∏ Bolt,7999,7999,-1695,-1695,980,0,0,324510,False,X28E-14M4-X494-28K2
RcJqPojZJjgRGhaU,1683272624,–ï–ª–µ–∫—Ç—Ä–æ—Å–∞–º–æ–∫–∞—Ç–∏ Bolt,7999,7999,-2212,-2212,980,0,0,326205,False,96T8-E75H-9C33-87C5
vGsk0eSmP5-JWkZ1,1683268605,Best way to cup,5814,5814,-23000,-23000,980,0,0,328417,False,4309-XTK9-556K-4ECX
M4JCTVYJTZGGO73l,1683212374,Beer Market,5921,5921,-111539,-111539,980,0,0,351417,False,AB3P-HHX8-2B8B-BM46
r_v3gTZ9mEyTg1ek,1683212042,30880,5912,5912,-259725,-259725,980,0,1947,462956,False,8PBE-AKA6-65PA-79ET
09eTWL4x6NLSo-ws,1683211596,Novus,5411,5411,-10700,-10700,980,0,0,722681,False,4749-6E59-CCX3-P59H
yIaex2cHLtv38CN8,1683211094,Novus,5411,5411,-7298,-7298,980,0,0,733381,False,X4E9-E6XH-T86P-5T55
Z-_SZLiflSKYeiu9,1683207764,SHOPSILPO,5411,5411,-103925,-103925,980,0,0,740679,False,13CC-C4A3-3A0T-359P
cPQxMP-P7zyfXyvm,1683203432,BWTC,5814,5814,-36000,-36000,980,0,0,844604,False,8MAC-09X4-HK43-5T87
TECLUkHfKJay4Pdr,1683203407,Best way to cup,5814,5814,-19000,-19000,980,0,0,880604,False,E5CC-CBA6-C72E-P5P9
4fGICZk8VZxX7WSs,1683198316,18shop,7221,7221,-17500,-17500,980,0,0,899604,False,TC7K-EH4A-X8MC-086C
kGJJ_EN9SsSVURFY,1683187150,–°—ñ–º–µ–π–Ω–∞ –ü–µ–∫–∞—Ä–Ω—è,5462,5462,-127500,-127500,980,0,0,917104,False,1651-PMC1-HK08-4BPE
jEB72LNhuG6y33il,1683135367,–ó–∞–º–æ–≤–ª–µ–Ω–Ω—è —ó–∂—ñ,5499,5499,-87675,-87675,980,0,0,1044604,False,96TT-X688-8XA0-E75B
PNQKKT2KMn_pAmf0,1683114089,Novus,5411,5411,-11602,-11602,980,0,0,1132279,False,TH8A-MP34-1EA5-C1C2
wdRAaceiBHy3g_aZ,1683112347,Best way to cup,5814,5814,-41500,-41500,980,0,0,1143881,False,A63H-1M58-C290-79BP
4i-k-VE3IruGMRpr,1683108119,Novapay,8999,8999,-5000,-5000,980,0,0,1185381,False,2P4X-848C-961X-M8B1
10qJ8NcjbEbdQK3X,1682953616,–í—ñ–¥: –û–ª–µ—Å—è –°–∞—á–µ–Ω–∫–æ,—Å—ñ—Ä–æ–∂–∫–∏,4829,4829,620000,620000,980,0,0,1190381,True
Gz9_48FgoLzWnfJv,1682949823,FDY*Jewelry_SSL,5944,5944,-620000,-620000,980,0,0,570381,False,5BCK-XT82-T6KC-13T5
2NmwBynAaZ64zKXP,1682933632,Beer Market,5921,5921,-73417,-73417,980,0,0,1190381,False,900B-46EX-08TK-TXK0
WR8K91jeYQoaFcPK,1682931951,–°—ñ–ª—å–ø–æ,5411,5411,-52900,-52900,980,0,0,1263798,False,K4BT-M1E8-1T49-7253
ODKUguGGAp95WSVv,1682931885,–°—ñ–ª—å–ø–æ,5411,5411,-66597,-66597,980,0,0,1316698,False,MTC7-XH1T-A98M-PMAP
coKSUhxT8MtBfKRw,1682931034,AVANGARDEN,5812,5812,-65100,-65100,980,0,0,1383295,True,A00K-KBKB-4X50-T4EH
hcLIBoxcBgmbMmXP,1682928641,–ï–ª–µ–∫—Ç—Ä–æ—Å–∞–º–æ–∫–∞—Ç–∏ Bolt,7999,7999,-1454,-1454,980,0,0,1448395,False,MT0E-04E3-221X-C1MC
75bcd2FGUcp1NHEV,1682927640,–ï–ª–µ–∫—Ç—Ä–æ—Å–∞–º–æ–∫–∞—Ç–∏ Bolt,7999,7999,-2370,-2370,980,0,0,1449849,False,B5AC-5C42-BPP9-CM6A
6iPfVmkkIbHQNPgo,1682927177,–°—ñ–ª—å–ø–æ,5411,5411,-72802,-72802,980,0,0,1452219,False,9M83-HK67-3X48-7H3C
TXq_wlyt60NsKCWy,1682926198,–ï–ª–µ–∫—Ç—Ä–æ—Å–∞–º–æ–∫–∞—Ç–∏ Bolt,7999,7999,-5710,-5710,980,0,0,1525021,False,6P5X-3HE2-6960-PT7B
fkcmEYhPqE9IYfYv,1682926036,TOV Flagman Stor M,5499,5499,-189724,-189724,980,0,0,1530731,False,73CH-280A-8H56-P4MP
W_aYHs13eN9JP7Qs,1685243967,–†–µ–≥—É–ª—è—Ä–Ω–µ –ø–æ–ø–æ–≤–Ω–µ–Ω–Ω—è ¬´–§–æ–Ω–¥ –ü–æ–≤–µ—Ä–Ω–∏—Å—å –∂–∏–≤–∏–º¬ª,4829,4829,-25000,-25000,980,0,0,695799,True
R5pWH3U6vNGCw6ul,1684849901,–ú–∞–∫—Å–∏–º –°–∞—á–µ–Ω–∫–æ,4829,4829,-350000,-350000,980,0,0,720799,True,K151-5AA9-ABK4-4B49
-LWT3U6l22wKlw71,1684635659,–†–µ–≥—É–ª—è—Ä–Ω–µ –ø–æ–ø–æ–≤–Ω–µ–Ω–Ω—è ¬´–§–æ–Ω–¥ –ü–æ–≤–µ—Ä–Ω–∏—Å—å –∂–∏–≤–∏–º¬ª,4829,4829,-25000,-25000,980,0,0,1070799,True
p5AvVTbwzfJMesOf,1684585402,–ü–æ–ø–æ–≤–Ω–µ–Ω–Ω—è ¬´Mates üåº¬ª,4829,4829,-137000,-137000,980,0,0,1095799,True,H9H7-B3A6-963X-K393
YEV9d8m0dBQsIz8H,1684575165,–Ü—Ä–∏–Ω–∞ –Ü.,4829,4829,-62000,-62000,980,0,0,1232799,True,C074-12BT-2P63-M37M
2KDmr5npR-BC3SCm,1684575142,–ü–æ–ø–æ–≤–Ω–µ–Ω–Ω—è ¬´Garage¬ª,4829,4829,-54000,-54000,980,0,0,1294799,True,H2X3-9669-CTX1-H44B
YcvHSC7qzezToOS8,1684523357,–ü–æ–ø–æ–≤–Ω–µ–Ω–Ω—è ¬´–¢–°–ü after hours¬ª,4829,4829,-70000,-70000,980,0,0,1348799,True,XH19-603E-6E13-9128
KtHTtMwT7sRDUZJa,1684510845,–ó –ø–ª–∞—Ç–∏–Ω–æ–≤–æ—ó –∫–∞—Ä—Ç–∫–∏,4829,4829,400000,400000,980,0,0,1418799,True
rtVX9zSJmVvjei6h,1684233331,–ü–æ–ø–æ–≤–Ω–µ–Ω–Ω—è ¬´ANTIDRON KVS G-6¬ª,4829,4829,-250000,-250000,980,0,0,1018799,True,X2HM-03A4-3PCA-T536
4rDAbSZG9DQNJM7N,1684138116,–ó –ø–ª–∞—Ç–∏–Ω–æ–≤–æ—ó –∫–∞—Ä—Ç–∫–∏,4829,4829,400000,400000,980,0,0,1268799,True
8HWQ55LnrbMcHsrh,1684046989,Lesya,4829,4829,-200000,-200000,980,0,0,868799,True,512E-7HT1-367P-21EK
MaNHT_Z4PPXcjtWM,1684030822,–†–µ–≥—É–ª—è—Ä–Ω–µ –ø–æ–ø–æ–≤–Ω–µ–Ω–Ω—è ¬´–§–æ–Ω–¥ –ü–æ–≤–µ—Ä–Ω–∏—Å—å –∂–∏–≤–∏–º¬ª,4829,4829,-25000,-25000,980,0,0,1068799,True
IsL9YmqoSF72bf_b,1683646364,–ü–æ–ø–æ–≤–Ω–µ–Ω–Ω—è ¬´–ë–ê–ì–ê–¢–û –º–µ–¥–∏—Ü–∏–Ω–∏!¬ª,4829,4829,-50000,-50000,980,0,0,1093799,True,6427-EXEH-654X-5AKB
L9SM9CEJFGdc0FPH,1683640156,–õ—é–¥–º–∏–ª–∞ –í.,4829,4829,-15400,-15400,980,0,0,1143799,True,00EC-X47E-MCAM-BC01
aThHDqweIIhxStYM,1683426076,–†–µ–≥—É–ª—è—Ä–Ω–µ –ø–æ–ø–æ–≤–Ω–µ–Ω–Ω—è ¬´–§–æ–Ω–¥ –ü–æ–≤–µ—Ä–Ω–∏—Å—å –∂–∏–≤–∏–º¬ª,4829,4829,-25000,-25000,980,0,0,1159199,True
MUlCcU2ruyAsLpvc,1683371595,–ü–æ–ø–æ–≤–Ω–µ–Ω–Ω—è ¬´üå∏ü´∂üèªüåº¬ª,4829,4829,-43000,-43000,980,0,0,1184199,True,25T0-CTP0-1P17-0HXM
qSw6kNMSKSc5JVSQ,1683210683,–õ—é–¥–º–∏–ª–∞ –í.,4829,4829,-11000,-11000,980,0,0,1227199,True,T143-P6A5-PTK5-P5HX
xtdbnLpLDht3pu6V,1683205015,–ú–∞—Ä—ñ–∞–Ω–Ω–∞ –î.,4829,4829,-96000,-96000,980,0,0,1238199,True,5221-28E9-CE38-88B6
96cdbKqg57rEy4d9,1688056158,IdealistCoffeCo,5814,5814,-3900,-3900,980,0,78,2125874,False,AT6M-ET3E-6M4M-3K57
-ux8ohBdbnzlH240,1688025023,–ü–µ—Ä–µ–∫–∞–∑ –Ω–∞ –∫–∞—Ä—Ç–∫—É,4829,4829,-1100000,-1100000,980,0,0,2129774,True
Dbi1iPkLsgaqq-w_,1688024988,–íi–¥: –ü–†–ò–•–û–î–¨–ö–û –ï.–í. –§–û–ü,"–î–ª—è –ø–æ–ø–æ–≤–Ω–µ–Ω–Ω—è –∫–∞—Ä—Ç–∫–∏ 5375414101190360, –ü—Ä–∏—Ö–æ–¥—å–∫–æ –ï—Ä–Ω–µ—Å—Ç –íi–∫—Ç–æ—Ä–æ–≤–∏—á, 3487403339",4829,4829,2500000,2500000,980,0,0,3229774,True
_5iDdBuIR5mnacFK,1688022687,–ê—Ñ—Ç–µ—Ä–Ω—É–Ω,5814,5814,-52800,-52800,980,0,396,729774,False,XET8-X085-K66E-H75A
D4A94BDwG7d6YCPk,1688019549,–ê—Ñ—Ç–µ—Ä–Ω—É–Ω,5814,5814,-27000,-27000,980,0,202,782574,False,2XPE-2888-9H7T-EMC2
yiHcAsLirUHQhAMS,1688019084,–û–±—Å–ª—É–≥–æ–≤—É–≤–∞–Ω–Ω—è –ø–ª–∞—Ç–∏–Ω–æ–≤–æ—ó –∫–∞—Ä—Ç–∫–∏,4829,4829,-30000,-30000,980,0,0,809574,True
6x0NyIBieccep5S_,1687976919,Pethouse,5995,5995,-306100,-306100,980,0,0,839574,False,9597-27T5-B86H-H15P
_XkgBJ7o14djPATb,1687972361,–ê–ø—Ç–µ–∫–∞ –ê–ù–¶,5912,5912,-351280,-351280,980,0,0,1145674,False,1M41-1K78-2EH6-394B
-gXu6JLgORxzGpNA,1687962075,SHOPSILPO,5411,5411,-224383,-224383,980,0,0,1496954,False,5P64-H294-62AB-81C3
idao5S9HaUEK-bsr,1687960396,–ï–ª–µ–∫—Ç—Ä–æ—Å–∞–º–æ–∫–∞—Ç–∏ Bolt,7999,7999,-2725,-2725,980,0,0,1721337,False,T03H-4A3K-06EM-9PCB
i4L33RcPA_ARcwtF,1687960182,MagazinAkademkniga7NAN,5942,5942,-11200,-11200,980,0,0,1724062,False,C507-E2B9-8BM3-E521
wUswZ2uL27bRJ7gb,1687958003,FOP Sturova AS,5814,5814,-21500,-21500,980,0,161,1735262,False,0P29-512B-K81C-47K2
SKcmR_ZK6_5xatPR,1687957882,–ï–ª–µ–∫—Ç—Ä–æ—Å–∞–º–æ–∫–∞—Ç–∏ Bolt,7999,7999,-4990,-4990,980,0,0,1756762,False,648K-1K24-97HA-409M
iu5cxlk_9Nsf-DVl,1687955712,HUMANS COFFEE IN TECH,5814,5814,-11000,-11000,980,0,82,1761752,False,M49P-0B6C-4903-KMCA
vCieMHUV4do600AJ,1687955606,–ï–ª–µ–∫—Ç—Ä–æ—Å–∞–º–æ–∫–∞—Ç–∏ Bolt,7999,7999,-1604,-1604,980,0,0,1772752,False,XBPM-4B3T-C7T2-B6C8
JFGL2y22eeTyxhPp,1687955355,Kitaika.Kitchen | –ó–æ–ª–æ—Ç–æ—É—Å—Ç—ñ–≤—Å—å–∫–∞,5812,5812,-28170,-28170,980,0,211,1774356,True,1MBX-T98M-CH7A-611C
V8u4tBImFgipehbE,1687953441,–ï–ª–µ–∫—Ç—Ä–æ—Å–∞–º–æ–∫–∞—Ç–∏ Bolt,7999,7999,-3109,-3109,980,0,0,1802526,False,22M8-2HH3-XX77-PK4E
kwaUPEosp27zU6JM,1687935977,Lesya,4829,4829,-406573,-406573,980,6573,0,1805635,True,64XH-4483-BBKP-9EA3
8NpVRUOTll0an2SG,1687932065,–ù–æ–≤–∞ –ø–æ—à—Ç–∞,7399,7399,-5400,-5400,980,0,0,2212208,False,6BCB-E74A-BE7B-6TPP
tqarFzfeVyD-g9kq,1687887401,Novapay,8999,8999,-11400,-11400,980,0,0,2217608,False,EHK9-8959-6TT3-BP56
R0mEVOa446XFWNlw,1687872780,–ë—É—Ä–≥–µ—Ä–Ω–∞ –Ω—ñ—à–∞ / Fresh Black,5812,5812,-112100,-112100,980,0,2242,2229008,True,4684-T7B3-T6B8-KMH5
0_u-LITMR4tl6Iq0,1687869747,–ï–ª–µ–∫—Ç—Ä–æ—Å–∞–º–æ–∫–∞—Ç–∏ Bolt,7999,7999,-2239,-2239,980,0,0,2341108,False,4A4E-H100-E5HP-73M9
0rcphq0sxijhfGCY,1687869505,–ï–ª–µ–∫—Ç—Ä–æ—Å–∞–º–æ–∫–∞—Ç–∏ Bolt,7999,7999,-10000,-10000,980,0,0,2343347,False
gklFmS_7E9_AMjvd,1687858646,KAVIARNIA 16,5814,5814,-6000,-6000,980,0,120,2353347,False,7265-8763-27AX-T92P
OOcOybwb0Y-wgRYu,1687799020,PHOPTitova,7230,7230,-265000,-265000,980,0,0,2359347,False,11X5-2K8E-3KXA-BE26
Qq2LMh-M7Kpk09b-,1687798891,Best way to cup,5814,5814,-57010,-57010,980,0,1140,2624347,False,K8EK-1X5H-BE5B-0B09
l6bi2RwP7JEE94Te,1687796498,WFP.GROCERY1,5499,5499,-68870,-68870,980,0,0,2681357,False,5P8T-CPPM-9914-9398
HSw1lHxkH4dZG_6B,1687787235,LIQPAY*Funkeys,5045,5045,-79900,-79900,980,0,0,2750227,False,HC41-883E-P89C-CBK2
3-3Of6p_sdgKTgx9,1687768414,Lesya,4829,4829,-6300000,-6300000,980,0,0,2830127,True,1X6A-TP10-2X2E-M8BB
Xl3NxrR6jJ6nvh_8,1687767457,"–ë—ñ–¥—é–∫ –Ñ–≤–≥–µ–Ω –ú–∏–∫–æ–ª–∞–π–æ–≤–∏—á, –§–û–ü",4829,4829,-40000,-40000,980,0,0,9130127,True,X8XH-0H8X-M9XB-18EM
WV77TDvqtlCPtlDy,1687765269,–íi–¥: –ü–†–ò–•–û–î–¨–ö–û –ï.–í. –§–û–ü,"–î–ª—è –ø–æ–ø–æ–≤–Ω–µ–Ω–Ω—è –∫–∞—Ä—Ç–∫–∏ 5375414101190360, –ü—Ä–∏—Ö–æ–¥—å–∫–æ –ï—Ä–Ω–µ—Å—Ç –íi–∫—Ç–æ—Ä–æ–≤–∏—á, 3487403339",4829,4829,7000000,7000000,980,0,0,9170127,True
G0mszs4fKjBXt1gt,1687718879,–°—ñ–ª—å–ø–æ,5411,5411,-14900,-14900,980,0,0,2170127,False,B76X-XH02-5P91-1XHT
K4GhD3p3vwCOvRN9,1687718811,–°—ñ–ª—å–ø–æ,5411,5411,-11798,-11798,980,0,0,2185027,False,MPBH-639C-1A30-MM3B
Qucp6z7VCEzcSJyj,1687718773,–°—ñ–ª—å–ø–æ,5411,5411,-201165,-201165,980,0,0,2196825,False,TAM0-20XK-9KKH-1178
WEc8hKlZXROBbYSK,1687715606,ParkuvmaydanchikPeredvist,7999,7999,-14250,-14250,980,0,0,2397990,False,K3HA-A719-146X-225E
ljb9YIyZQhzs4-it,1687702250,Lesya,4829,4829,-300000,-300000,980,0,0,2412240,True,E317-MXT6-BE7K-BT29
x0j00MHG9ct62hjs,1687701055,–°—ñ–ª—å–ø–æ,5411,5411,-15200,-15200,980,0,0,2712240,False,10TH-439A-57A3-HP23
ll4qUThdNv97y8gb,1687698386,–ü–æ–ø–æ–≤–Ω–µ–Ω–Ω—è ¬´–Ω–∞ –ü–ù–ë ü§ç¬ª,4829,4829,-700000,-700000,980,0,0,2727440,True,35C2-0067-P018-CM24
B9DALfk8WScwd9k5,1687695635,AVANGARDEN,5812,5812,-454900,-454900,980,0,9098,3427440,True,MC54-22M8-6HTB-XP3H
KROuQ8YdDJEh0N3M,1687635408,–ü–æ–ø–æ–≤–Ω–µ–Ω–Ω—è ¬´–ù–∞ –ª—ñ–∫—É–≤–∞–Ω–Ω—è¬ª,4829,4829,-120000,-120000,980,0,0,3882340,True,AC29-CCX0-7AC4-EK2C
-L9c9dX81n1oDpMo,1687627801,OK Wine,5411,5411,-19800,-19800,980,0,0,4002340,False,MPPB-E65X-K8XE-A912
De2Hl9thEeNg2p3y,1687624656,OK Wine,5921,5921,-14000,-14000,980,0,0,4022140,False,PBPX-8AP6-XE1P-4A08
s2swkIuSyUyTqGGA,1687624478,magazin 762597,5912,5912,-194107,-194107,980,0,0,4036140,False,1611-X80K-MP6T-AETB
wImJnA1MKVVI_so1,1687608197,–ì–ê–õ–ï–ù–ö–û –î–ï–ù–ò–°,4829,4829,-80000,-80000,980,0,0,4230247,True,440B-25AK-90P5-PCPM
sNrQkOEzAQWePjAh,1687545887,kafe Zigzag,5812,5812,-10000,-10000,980,0,200,4310247,False,P314-X2M5-8PX0-460K
eFoYQlGseEcbjXbh,1687545868,kafe Zigzag,5812,5812,-95900,-95900,980,0,1918,4320247,False,EB0X-44C0-1C30-75P2
ikjm0PnJWpy7Rcqr,1687538182,5045Kavjarnja,5814,5814,-12000,-12000,980,0,240,4416147,False,XMXM-4XH1-KBT5-9T7E
LRnCTbR_r3qD2TI0,1687536655,SEJNOUMO,5814,5814,-110000,-110000,980,0,2200,4428147,False,KE63-5A0B-4T42-BBKC
oXzVgnu-t7yuQWwE,1687506797,OK Wine,5411,5411,-80550,-80550,980,0,0,4538147,False,71BT-98XP-HCE1-A6AB
fCUxwmKI13OgYiAk,1687502140,Best way to cup,5814,5814,-8000,-8000,980,0,160,4618697,False,T71C-0T4X-T2MC-XAHT
FuwrRWFepeUwvpQZ,1687456322,–ó–∞–º–æ–≤–ª–µ–Ω–Ω—è —ó–∂—ñ,5499,5499,-41895,-41895,980,0,0,4626697,False,EKBA-X0A7-E59M-51AH
j-Iv6IOA4UwLVKtT,1687455273,ZAKAPELOKknigiikava,5942,5942,-57800,-57800,980,0,0,4668592,False,K213-25AC-1K7A-75HE
isEeF5HGmbCO-17t,1687453502,FOPDZYuBAIRINABORISIVN,4215,4215,-85500,-85500,980,0,0,4726392,False,TP2X-8602-5H48-7K7A
84cdL7WJWlxAjif4,1687451581,Knizhkoviylev,5942,5942,-40000,-40000,980,0,0,4811892,False,69M3-02X6-P156-C52T
PntM9oTxFlwv4KCL,1687450130,MYSTETSK ARSENAL_MAG,7991,7991,-6000,-6000,980,0,0,4851892,False,1XTK-9B36-3E9C-9P58
cWUq-ddDhlG4p2X2,1687420256,–ü–æ–ø–æ–≤–Ω–µ–Ω–Ω—è ¬´–ù–∞ —Ä–µ–º–æ–Ω—Ç –∞–≤—Ç–æ¬ª –≤i–¥ –ê–ù–î–†–Ü–ô –ö. ,–ü—Ä–∏–≤—ñ—Ç –≤—ñ–¥ –î—ñ–º–∏ –ö,4829,4829,-200000,-200000,980,0,0,4857892,True,HE5C-MB5A-764B-TM3P
UEtdsSFIrg7AboCs,1687416042,Best way to cup,5814,5814,-21500,-21500,980,0,430,5057892,False,123P-XX82-K894-X845
fMrGTdKEiBssySrA,1687410479,–°—ñ–ª—å–ø–æ,5411,5411,-71752,-71752,980,0,0,5079392,False,E2T6-6T0M-199X-KH7C
b1FbHER11wAssw8M,1687364091,Yaroslaviv Val 37-1,5921,5921,-55100,-55100,980,0,0,5151144,False,CP36-681K-8A3E-MHH4
a5U7LnFBFeK9awgV,1687363891,–ú–µ—Ä–µ–∂–∞ –∞–ø—Ç–µ–∫ D.S.,5912,5912,-93225,-93225,980,0,0,5206244,False,3A6B-M2B9-EEM8-1A2E
CeCEncs1EXtnURNi,1687335961,–íi–¥: –ü–†–ò–•–û–î–¨–ö–û –ï.–í. –§–û–ü,"–î–ª—è –ø–æ–ø–æ–≤–Ω–µ–Ω–Ω—è –∫–∞—Ä—Ç–∫–∏ 5375414101190360, –ü—Ä–∏—Ö–æ–¥—å–∫–æ –ï—Ä–Ω–µ—Å—Ç –íi–∫—Ç–æ—Ä–æ–≤–∏—á, 3487403339",4829,4829,5000000,5000000,980,0,0,5299469,True
5TgmCkOZyffzQXTD,1687329821,Best way to cup,5814,5814,-18000,-18000,980,0,135,299469,False,T6AA-TT07-E8XX-HX8X
805G9f1Y_t3GcngD,1687325085,Novapay,8999,8999,-6700,-6700,980,0,0,317469,False,A73X-61TK-70MM-5B7B
wV90wDY3wWOGQspr,1687325041,Pethouse,5995,5995,-306100,-306100,980,0,0,324169,False,1PTE-EPE3-5M8A-M4CM
pjkeVj2NlMg4Z6CX,1687324935,Novapay,8999,8999,-7000,-7000,980,0,0,630269,False,TB8C-2T61-55EX-XAE6
TCUtYsI2bzDi8UU_,1687282693,Coffee nerds,5814,5814,-6000,-6000,980,0,45,637269,False,E98C-25CC-6375-3EPP
9m8dcHjuzk7D4TZn,1687281830,–ï–ª–µ–∫—Ç—Ä–æ—Å–∞–º–æ–∫–∞—Ç–∏ Bolt,7999,7999,-5317,-5317,980,0,0,643269,False,63KP-EM7B-METH-0KEE
ZQ4e3YyTW5kMtFMF,1687281827,–°–∫–∞—Å—É–≤–∞–Ω–Ω—è. –ï–ª–µ–∫—Ç—Ä–æ—Å–∞–º–æ–∫–∞—Ç–∏ Bolt,7999,7999,4065,4065,980,0,0,648586,False
kyH80xXm4DquzvzX,1687281030,–ï–ª–µ–∫—Ç—Ä–æ—Å–∞–º–æ–∫–∞—Ç–∏ Bolt,7999,7999,-4065,-4065,980,0,0,644521,False
GOQAiebJvNpH-C4-,1687281023,–ï–ª–µ–∫—Ç—Ä–æ—Å–∞–º–æ–∫–∞—Ç–∏ Bolt,7999,7999,-2065,-2065,980,0,0,648586,False,392E-1CMA-67CX-A7P6
IdNQ4PMRC-xqY9Ul,1687270348,–°—ñ–ª—å–ø–æ,5411,5411,-62093,-62093,980,0,0,650651,False,3CAT-B94B-T6B8-HEPM
UyqiyH2JwLWyJmXO,1687269567,–ö–æ–ª–æ,5411,5499,-2050,-2050,980,0,0,712744,False,5PK1-K00X-208H-2M5T
DSN1l7B0-vMyK6O7,1687269040,Novus,5411,5411,-56992,-56992,980,0,0,714794,False,453M-CM3T-CMC6-8MXE
QUBfLRP_1mist2p5,1687263090,PHotosalonMAN,7221,7221,-2000,-2000,980,0,0,771786,False,C6EC-6X7B-KB8C-BBH0
QOJou-Ua4_uJ3dfR,1687262859,Novus,5411,5411,-5214,-5214,980,0,0,773786,False,X886-TE73-55BE-1382
4VEt8W6GHdNu7nVa,1687248054,ZOOHUB,5995,5995,-36000,-36000,980,0,0,779000,True,1HC4-6H81-K02P-C972
nvINsLh5cAk36RkB,1687246718,–ï–ª–µ–∫—Ç—Ä–æ—Å–∞–º–æ–∫–∞—Ç–∏ Bolt,7999,7999,-3009,-3009,980,0,0,815000,False,52HT-B054-4364-0KB3
KrclODRmR0-b6L5p,1687244407,–ï–ª–µ–∫—Ç—Ä–æ—Å–∞–º–æ–∫–∞—Ç–∏ Bolt,7999,7999,-4179,-4179,980,0,0,818009,False,PETT-3K1T-T5BP-97BX
pBrIHuCb69XP5-af,1687243076,Best way to cup,5814,5814,-19000,-19000,980,0,142,822188,False,CK1H-1HEK-M6ET-01X6
uoiSpLsGsrDJkR8C,1687196682,EVA,5977,5977,-2299,-2299,980,0,0,841188,False,B733-33B6-P86C-CM2T
wjwlAgMJzsY5e43E,1687196640,EVA,5977,5977,-54908,-54908,980,0,0,843487,False,X4E6-T3EC-2CE0-H947
-qlL7YcuOhvfknY7,1687195621,t.c.pizza,5812,5812,-124800,-124800,980,0,936,898395,True,61BB-7ET1-CTC9-C3EE
iMcg-kMpIEHRRwpY,1687168526,OK Wine,5411,5411,-85550,-85550,980,0,0,1023195,False,TC50-KBAC-9AX1-6B0A
jxVUDFFgDveT6Xxi,1687168191,FOP Zhukov,5814,5814,-16900,-16900,980,0,126,1108745,False,B14C-3573-5P96-E9H3
FUtSX5wgRMQSt_If,1687167013,–°—ñ–ª—å–ø–æ,5411,5411,-18997,-18997,980,0,0,1125645,False,KP01-7P0M-PTEE-A4EK
ITyzK9JHrvrp5C80,1687154926,LIQPAY*ZL Vet,742,742,-65000,-65000,980,0,0,1144642,False,5X5H-8P8M-3P8C-5625
X6jEE0Ju-1ijO9H1,1687096815,KavyarnyaPeremoga,5814,5814,-39500,-39500,980,0,296,1209642,False,9A36-36EC-3P25-A0A4
IDleT7dqHyavX8E1,1687083844,Fresh Dzhus end Babl T,5812,5812,-34000,-34000,980,0,255,1249142,False,XEXM-1897-HX4C-7K27
xpaKAZuXIrd7t94i,1687075716,Veterinarniyshpital,742,742,-175000,-175000,980,0,0,1283142,False,474H-13CH-74EB-H0PX
QA_7CeKXzFXVr31U,1687069144,–°—ñ–ª—å–ø–æ,5411,5411,-15661,-15661,980,0,0,1458142,False,4K86-PX04-6M2X-1XE4
q7bfCS4Y4ymNP7ia,1687025278,Best way to cup,5814,5814,-19000,-19000,980,0,142,1473803,False,29AB-38K9-18K1-4CC6
D9_WaptDGfutuMpl,1687018084,SHOPSILPO,5411,5411,-60615,-60615,980,0,0,1492803,False,A09M-3KCK-CPEX-832T
oRv7O-Rxv4P6w1gy,1687012646,Pryimalnyy punkt khimc,7216,7216,-247000,-247000,980,0,0,1553418,False,4PK2-6H17-5HTB-9PXC
oWV3CJy1BouPNKNp,1687012329,MasterZoo,5995,5995,-32500,-32500,980,0,1625,1800418,False,9A36-46KH-KHPK-T383
iq62D3sD5T-yt2uI,1687010723,Dubler,5814,5814,-8400,-8400,980,0,63,1832918,False,T6EB-B15M-432M-A068
78ouv4QAZpMM7-V_,1687010705,Dubler,5814,5814,-84500,-84500,980,0,633,1841318,False,TK96-EAE6-0BBE-T51A
ebOVnN8nevko5Dio,1686997400,–íi–¥: –ü–†–ò–•–û–î–¨–ö–û –ï.–í. –§–û–ü,"–î–ª—è –ø–æ–ø–æ–≤–Ω–µ–Ω–Ω—è –∫–∞—Ä—Ç–∫–∏ 5375414101190360, –ü—Ä–∏—Ö–æ–¥—å–∫–æ –ï—Ä–Ω–µ—Å—Ç –íi–∫—Ç–æ—Ä–æ–≤–∏—á, 3487403339",4829,4829,1900000,1900000,980,0,0,1925818,True
njSsEK3OdKCFekm4,1686997038,–ï–ª–µ–∫—Ç—Ä–æ—Å–∞–º–æ–∫–∞—Ç–∏ Bolt,7999,7999,-1186,-1186,980,0,0,25818,False,612B-695B-91TX-B2P2
y6emgutYZY_owDIn,1686996777,–ï–ª–µ–∫—Ç—Ä–æ—Å–∞–º–æ–∫–∞—Ç–∏ Bolt,7999,7999,-2486,-2486,980,0,0,27004,False,3ECX-7M0M-X1M9-XTCP
iWTbFMj4ADAAgv3c,1686994798,WFP.AQUAMARKET,5411,5411,-90770,-90770,980,0,0,29490,False,0KKX-BT13-MKXM-3CK2
E9HGOEn7nmaU6XQy,1686993476,Rebornhimchistka,7216,7216,-162500,-162500,980,0,0,120260,False,BH39-0MEB-4P86-4T6M
LCWmHWOskdDuaKOp,1686933195,–¢–∞–±–∞–∫–µ—Ä–∫–∞,5993,5993,-71000,-71000,980,0,0,282760,False,XXAB-6A7M-80E2-87MX
ZuvxLu1YFa3aZTZg,1686932832,Novus,5411,5411,-41999,-41999,980,0,0,353760,False,577E-9EX1-XEH1-C3CC
tFsmANTWTomYKoji,1686932697,OK Wine,5411,5411,-14000,-14000,980,0,0,395759,False,7741-908C-1EHT-CHEC
kxKiAsYaMIiuO7xG,1686932535,magazin 762597,5912,5912,-67680,-67680,980,0,0,409759,False,PK9B-KECC-X3M3-1T33
D5HLdlyHkZK2uOGT,1686930549,HUMANS COFFEE IN TECH,5814,5814,-13000,-13000,980,0,97,477439,False,7E5A-KK96-2255-7HP5
zaw7WBAVdbBJnmME,1686917138,KLO,5541,5541,-188900,-188900,980,0,0,490439,False,9HM1-256M-96XM-2H34
gTxJr0_OIeBXUuVi,1686896568,SHOPSILPO,5411,5411,-104540,-104540,980,0,0,679339,False,KC29-92E1-ATCH-49A5
iU6BRnNEio3qQ6nj,1686850288,BWTC,5814,5814,-27000,-27000,980,0,202,783879,False,344H-17P2-MK98-C86P
zP5bYMpUw7DncWf1,1686850272,Best way to cup,5814,5814,-12500,-12500,980,0,93,810879,False,C32A-A7H1-0363-1A0M
kkHGeIhOm3HzgbV-,1686840938,FOP YaSTREB O.O.,5944,5944,-259000,-259000,980,0,0,823379,False,K768-6A69-CM1H-A6H5
FmaKlrmrTHvahgxP,1686839710,SHOP SINGLEPRINT,5691,5691,-79000,-79000,980,0,0,1082379,False,72T8-H1CH-A41K-4889
4YGCu-sYcg1HHkP9,1686806390,–ú–µ–¥–∏—á–Ω–∞ –ª–∞–±–æ—Ä–∞—Ç–æ—Ä—ñ—è ¬´–î—ñ–ª–∞¬ª,8062,8099,-130000,-130000,980,0,0,1161379,False,X998-M55A-9110-998X
-WVt9pP65jjs2hBt,1686762633,Best way to cup,5814,5814,-22000,-22000,980,0,165,1291379,False,9T6M-B4T2-1H71-408E
FAUO6lGpvCbExlAa,1686758679,Novapay,8999,8999,-5000,-5000,980,0,0,1313379,False,0C64-2BT2-5TBK-E6CM
t8Y7WaIoecgw5-Bt,1686758646,Novapay,8999,8999,-5400,-5400,980,0,0,1318379,False,3155-T93M-82AX-2A2P
vDNsUzllJQlPX3Y8,1686722284,Best way to cup,5814,5814,-36000,-36000,980,0,270,1323779,False,EEAH-A992-1T3A-5CX0
nee1BlvFlkeJLPeR,1686677832,–û—Ñ—ñ—Å-—á–∞–π,5812,5812,-10400,-10400,980,0,78,1359779,True,1TK5-B0PB-C8X6-6674
7bET3PEJF96L1aEN,1686675557,Yaroslaviv Val 37-1,5921,5921,-171750,-171750,980,0,0,1370179,False,7CXE-389H-T6C1-XXPB
EKaNLubkP0hZUvgc,1686675033,Rozetka,5399,5399,-24300,-24300,980,0,0,1541929,False,ACHC-MB6P-2502-4BE2
Ia5JOVEkcOxaKpAV,1686647537,Best way to cup,5814,5814,-54510,-54510,980,0,408,1566229,False,P0BP-57MM-HA13-CTP7
LSe2lY82i1yb8RRA,1686647393,–ï–ª–µ–∫—Ç—Ä–æ—Å–∞–º–æ–∫–∞—Ç–∏ Bolt,7999,7999,-3118,-3118,980,0,0,1620739,False,5AH3-A845-79P4-XBXK
uBFLEwj0XbYWA-Tb,1686639723,–ï–ª–µ–∫—Ç—Ä–æ—Å–∞–º–æ–∫–∞—Ç–∏ Bolt,7999,7999,-2989,-2989,980,0,0,1623857,False,7H48-8047-E6BT-E5AB
I8GHCzuUPztr6KH9,1686591987,Yaroslaviv Val 37-1,5921,5921,-51850,-51850,980,0,0,1626846,False,EP76-X8KC-05P4-34CP
orimByv444MfYl2_,1686591565,–í–ê–†–¶–ê–ë,5814,5814,-36000,-36000,980,0,270,1678696,False,3MH5-AB9E-939T-CMC9
V99ttKwUlC6XH6wT,1686582684,Pethouse,5995,5995,-369000,-369000,980,0,0,1714696,False,4EAK-XB1K-6H69-X355
vAIwhuQTdn6TArou,1686572578,SHOPSILPO,5411,5411,-284792,-284792,980,0,0,2083696,False,C4TH-5CPB-1A40-T8C2
dRGv6RIGAFwe6AQk,1686565806,–ü–µ—Ä–µ–∫–∞–∑ –Ω–∞ –∫–∞—Ä—Ç–∫—É,4829,4829,-700000,-700000,980,0,0,2368488,True
07kXYFx30pt7oBlq,1686559750,–íi–¥: –ü–†–ò–•–û–î–¨–ö–û –ï.–í. –§–û–ü,"–î–ª—è –ø–æ–ø–æ–≤–Ω–µ–Ω–Ω—è –∫–∞—Ä—Ç–∫–∏ 5375414101190360, –ü—Ä–∏—Ö–æ–¥—å–∫–æ –ï—Ä–Ω–µ—Å—Ç –íi–∫—Ç–æ—Ä–æ–≤–∏—á, 3487403339",4829,4829,2000000,2000000,980,0,0,3068488,True
lYBwsLXGoLVqGSjd,1686558401,–û–ø–ª–∞—Ç–∞ —à—Ç—Ä–∞—Ñ—É,4900,4900,-17000,-17000,980,0,0,1068488,True,10M0-15KC-XE7C-90B7
7olISTBv7oRnLRmg,1686557916,–û–ø–ª–∞—Ç–∞ —à—Ç—Ä–∞—Ñ—É,4900,4900,-17000,-17000,980,0,0,1085488,True,PHE8-BPA6-H119-ABB1
mYFDawF0fEbgpFpy,1686552593,Best way to cup,5814,5814,-7000,-7000,980,0,52,1102488,False,5C8P-3298-BTE3-B546
1Rb1wk7mIGYQPKuC,1686509994,–û–ø–ª–∞—Ç–∞ —à—Ç—Ä–∞—Ñ—É,4900,4900,-17000,-17000,980,0,0,1109488,True,M42E-1P30-7CXK-H348
yvCe8LVz8y-kEfzE,1686497881,WOG,5541,5541,-126130,-126130,980,0,0,1126488,False,B39K-455E-B32K-5KEE
9H9mDH1wJ_gTuAUi,1686487108,WOG,5541,5541,-6700,-6700,980,0,0,1252618,False,1P67-74EX-8EXP-AEP0
Dt0vmHH8p8zkd0pj,1686484720,–¢–æ–≤–∞—Ä–∏—Å—Ç–≤–æ —Ä–æ–∑–≤–∏—Ç–∫—É —ñ –ø—Ä–∏–∫—Ä–∞—à–∞–Ω–Ω—è –º—ñ—Å—Ç–∞,5812,5812,-26300,-26300,980,0,197,1259318,True,H84A-3C7A-T27A-E77T
vhWTPMYTwrtzf-ca,1686483641,StudijaKvitivtadekoruS,5992,5992,-119000,-119000,980,0,892,1285618,False,P89K-59K2-E7T9-X56K
sIuRtA003E_Etzv3,1686480163,Forum Lviv Parking,7523,7523,-2000,-2000,980,0,0,1404618,False,1364-M134-B2MC-C2X9
y4Bum6T8_cL1K-Iy,1686479596,–ï–ª–µ–∫—Ç—Ä–æ—Å–∞–º–æ–∫–∞—Ç–∏ Bolt,7999,7999,-2434,-2434,980,0,0,1406618,False,963X-C870-1A6X-925H
9-ALMsaYP_PcAaLP,1686472952,Best way to cup,5814,5814,-13000,-13000,980,0,97,1409052,False,9B54-4403-CXAT-A6E0
w1KYELNRZ0nTR-ag,1686421988,Novapay,8999,8999,-7600,-7600,980,0,0,1422052,False,927X-CMPX-6H73-1E48
O10cYlB_COALOp7T,1686421426,Marevo Craft,5812,5812,-166700,-166700,980,0,1250,1429652,True,3E17-4589-96X2-7EKC
8wU2Z2XQfeFe8-eX,1686419081,–°—ñ–ª—å–ø–æ,5411,5411,-112165,-112165,980,0,0,1596352,False,T989-A939-1KK3-5H11
aT_6UPMaQ7Q8TmO7,1686418294,–ï–ª–µ–∫—Ç—Ä–æ—Å–∞–º–æ–∫–∞—Ç–∏ Bolt,7999,7999,-1357,-1357,980,0,0,1708517,False,010H-161C-B7CK-E98H
FYwMvtIyUB0ii6Yt,1686402628,LaFabrique,5814,5814,-5500,-5500,980,0,41,1709874,False,8931-E235-KPX1-2A3T
L9Ux-GrGGP__5s_0,1686400905,–ú–µ—Ä–µ–∂–∞ –∞–ø—Ç–µ–∫ D.S.,5912,5912,-2835,-2835,980,0,0,1715374,False,512B-4087-C98B-5C42
XYf3NVXJ6VzIzgSP,1686400607,Best way to cup,5814,5814,-23000,-23000,980,0,172,1718209,False,M7M7-015A-7CKK-8EEX
WjL4LRAIBDXwCpxC,1686400603,BWTC,5814,5814,-18000,-18000,980,0,135,1741209,False,3881-BC8H-CM0H-25A4
1K20qiILYh7PQfob,1686390327,SHOP A-SHOP,5631,5631,-9800,-9800,980,0,0,1759209,False,CCH1-B74K-28E5-M26H
q-AQFoiQMz605szU,1686386999,Best way to cup,5814,5814,-9500,-9500,980,0,71,1769009,False,T60T-4192-1107-0MA6
qkpDWPlqeOX5BAUi,1686385769,–ö–∞–≤‚Äô—è—Ä–Ω—è ¬´–°–≤—ñ—Ç –∫–∞–≤–∏¬ª,5814,5814,-9500,-9500,980,0,71,1778509,False,5440-KTM9-A5PE-8H9X
k0FWoLK2dQfUo70s,1686383288,"–ê–ø—Ç–µ–∫–∞ ""–ü–æ–¥–æ—Ä–æ–∂–Ω–∏–∫""",5912,5912,-34799,-34799,980,0,0,1788009,False,53C7-TE9A-62P6-E7EK
jZrG89fdR7sqoeHW,1686378379,Cheese Bakery 2.0,5812,5812,-88200,-88200,980,0,661,1822808,True,6K0K-XC16-M83K-06X6
UwenWkApGmcPFu0-,1686329030,Beerplace,5814,5814,-11000,-11000,980,0,82,1911008,False,BMAB-A6M7-4E60-3147
qJd5N8Glh1FOeH-S,1686328637,Novus,5411,5411,-67239,-67239,980,0,0,1922008,False,5196-83A9-726C-HKC9
wxTvq-oh-6S-dMo_,1686327868,–ú–û–†–ï –†–ò–ë–ò,5812,5812,-136400,-136400,980,0,2593,1989247,True,XPCC-43C0-C5M9-M8K2
J_VsuK3--QGrYJiL,1686326194,Best way to cup,5814,5814,-9500,-9500,980,0,190,2125647,False,T84K-BM4P-2BXA-7M82
wxP1q956I4Dinqas,1686322324,Skin desserts,5977,5977,-24500,-24500,980,0,0,2135147,False,2BMH-PKC2-9335-M244
Y987Q8iVaA6DWe9S,1686320527,boba&black | –ë—Ä–∞—Ç—ñ–≤ –†–æ–≥–∞—Ç–∏–Ω—Ü—ñ–≤,5812,5812,-12000,-12000,980,0,240,2159647,True,74CA-C8K3-92BA-K19C
ztiFqQcj_p6PdnAY,1686317465,–ü–µ—Ä–µ–∫–∞–∑ –Ω–∞ –∫–∞—Ä—Ç–∫—É,4829,4829,-400000,-400000,980,0,0,2171647,True
hSAu5S4l21SC0p_B,1686314512,ON THE SQUARE GUESTHOU,7011,7011,-500000,-500000,980,0,0,2571647,False,766T-0E78-H52T-A3ME
kxbhbS1lrSEGy0yH,1686312868,EasyPay,7523,7523,-4783,-4783,980,0,0,3071647,False,P1BM-E54X-6ETT-7BKP
RfS11ceFvOmBIzl3,1686306526,WOG,5541,5541,-185213,-185213,980,0,0,3076430,False,3TH5-K737-MB7B-P3TE
S-KFep8hMm0zMeKy,1686305443,–íi–¥: –ü–†–ò–•–û–î–¨–ö–û –ï.–í. –§–û–ü,"–î–ª—è –ø–æ–ø–æ–≤–Ω–µ–Ω–Ω—è –∫–∞—Ä—Ç–∫–∏ 5375414101190360, –ü—Ä–∏—Ö–æ–¥—å–∫–æ –ï—Ä–Ω–µ—Å—Ç –íi–∫—Ç–æ—Ä–æ–≤–∏—á, 3487403339",4829,4829,2200000,2200000,980,0,0,3261643,True
X45EGic5UXCCcCgx,1686305041,–û–ø–ª–∞—Ç–∞ —à—Ç—Ä–∞—Ñ—É,4900,4900,-17000,-17000,980,0,0,1061643,True,THPB-33H7-C8XM-AC5B
V7H85VjB4pWNbBbF,1686294304,–¢–∞–±–∞–∫–µ—Ä–∫–∞,5993,5993,-142000,-142000,980,0,0,1078643,False,THHH-1PT4-B529-ABBE
If-uBZz5TA0qNHt9,1686294224,WOG,5541,5541,-28870,-28870,980,0,0,1220643,False,M5C5-4C8X-X64H-EK83
FA6_In8H5nFRiACH,1686292631,Best way to cup,5814,5814,-22000,-22000,980,0,165,1249513,False,2753-BECA-0P7C-P5E1
teka6UDK46xWhuCg,1686282596,OKKO,5541,5541,-115027,-115027,980,0,0,1271513,False,X0EP-TCTP-5106-734P
t0R4VJ7-LeAl2fxb,1686246868,Yaroslaviv Val 37-1,5921,5921,-4500,-4500,980,0,0,1386540,False,0KM7-1EH8-66BC-TKC0
YNgPaObVFsXY1JZR,1686246490,Restoran ChChKO,5814,5814,-41000,-41000,980,0,307,1391040,False,917B-C7BP-P16H-7120
1F8R8HM68dutYRqI,1686246472,Restoran ChChKO,5814,5814,-171520,-171520,980,0,1286,1432040,False,5547-HEXK-T2AM-PB24
1DZ4MgIRYMUGbt3N,1686241438,Yaroslaviv Val 37-1,5921,5921,-45800,-45800,980,0,0,1603560,False,9261-TH0B-84EC-A6TB
M8MSNtuBrKW8ZpU2,1686229056,–ï–ª–µ–∫—Ç—Ä–æ—Å–∞–º–æ–∫–∞—Ç–∏ Bolt,7999,7999,-2701,-2701,980,0,0,1649360,False,X28B-E0T1-92M6-2K1X
-rQtgzMZMJ4mgkL1,1686216674,–ï–ª–µ–∫—Ç—Ä–æ—Å–∞–º–æ–∫–∞—Ç–∏ Bolt,7999,7999,-2400,-2400,980,0,0,1652061,False,XAKC-T301-02TM-87TE
Ca9MfVBtpRr79fVP,1686216075,StomatologijaHidental,8021,8021,-400000,-400000,980,0,0,1654461,False,71HX-51KP-65H5-M5B1
zZ4M9pXTJWxSsxpY,1686207564,–ï–ª–µ–∫—Ç—Ä–æ—Å–∞–º–æ–∫–∞—Ç–∏ Bolt,7999,7999,-2835,-2835,980,0,0,2054461,False,1CA5-BAP7-P2KX-253P
ErOqiugqtlNXZZaC,1686206250,UNIVERSUMCLINIK,8099,8099,-35000,-35000,980,0,0,2057296,False,MEX0-6B9C-6B28-H0E6
49VkLhByzW-ncdOw,1686204224,Best way to cup,5814,5814,-9500,-9500,980,0,190,2092296,False,9AC5-E4BP-9E6M-4E68
wc2deHXpENABkzub,1686156875,FDY*FOOD,5499,5499,-58300,-58300,980,0,0,2101796,False,3730-0A59-P1KH-C1AA
p3PeOImOWPS3EdOm,1686130767,–°—ñ–ª—å–ø–æ,5411,5411,-5885,-5885,980,0,0,2160096,False,E8KH-328M-88T9-K641
QQg9-LftP68u11bI,1686130010,Gulliver6,5814,5814,-24000,-24000,980,0,480,2165981,False,99C5-8E60-41AC-9T8A
UylEaOMW21ujya41,1686117819,LaFabrique,5814,5814,-5500,-5500,980,0,110,2189981,False,X128-57C1-9450-4BC2
lCNKdlOLu470GTsP,1686117665,Best way to cup,5814,5814,-7000,-7000,980,0,140,2195481,False,TT69-C26M-A523-106H
nNsYr8gnavoKJRum,1686071302,LIQPAY*TC Pizza Kyiv,5812,5812,-31350,-31350,980,0,627,2202481,False,B2A0-A8BB-9CHP-PCPE
W06RZsQCjyMezZJD,1686070943,Bubbly,5814,5814,-8000,-8000,980,0,160,2233831,False,A77K-CC32-95EA-TK57
BacDM3Kik2-bNdlS,1686070275,Novapay,8999,8999,-7900,-7900,980,0,0,2241831,False,EA2K-K6E3-CT20-4KB2
ROwx1OebEZOoYCrU,1686060179,–ü–µ—Ä–µ–∫–∞–∑ –Ω–∞ –∫–∞—Ä—Ç–∫—É,4829,4829,-800000,-800000,980,0,0,2249731,True
X9s_Zug3QPQV9MWe,1686060170,Lesya,4829,4829,-400000,-400000,980,0,0,3049731,True,B9EX-2A9X-A96A-AB37
mYC3qte1MQSjbLmt,1686055626,Best way to cup,5814,5814,-19000,-19000,980,0,380,3449731,False,34K2-PE2K-XK93-KEP3
Qwr-7p51WWNl_Mbf,1686054895,Best way to cup,5814,5814,-8500,-8500,980,0,170,3468731,False,6H00-B6K0-83CP-4M8K
0KjttFa4CEeWbS0Y,1686039160,–íi–¥: –ü–†–ò–•–û–î–¨–ö–û –ï.–í. –§–û–ü,"–î–ª—è –ø–æ–ø–æ–≤–Ω–µ–Ω–Ω—è –∫–∞—Ä—Ç–∫–∏ 5375414101190360, –ü—Ä–∏—Ö–æ–¥—å–∫–æ –ï—Ä–Ω–µ—Å—Ç –íi–∫—Ç–æ—Ä–æ–≤–∏—á, 3487403339",4829,4829,3300000,3300000,980,0,0,3477231,True
9Hzzfh5vYpyqwolb,1686038525,StomatologijaHidental,8021,8021,-120000,-120000,980,0,0,177231,False,P06P-KABP-AH3H-P6H4
1WEs9v1OhUFSvxae,1686032265,"Lifecell
+380631692598",4814,4814,-30000,-30000,980,0,0,297231,True,AEPB-1H14-HCMX-BXME
lYVBUASQ-YLYU4PS,1685992950,MAKEUP,5977,5977,-102600,-102600,980,0,0,327231,False,P80X-28HH-BEAB-EC3K
dtO4moAPjWbVbSVC,1685985917,–°–ø–∏—Å–∞–Ω–Ω—è IPAY TIPS,6012,6012,-10940,-10940,980,370,0,429831,False,XB5A-XBT9-16ET-CXTA
tb7d5uAMJH1bNPPC,1685985890,This is –ü–∏–≤–±–∞—Ä,5812,5812,-105700,-105700,980,0,792,440771,False,53P1-XTH1-6098-H593
qKHxDheRCTustMIF,1685976312,Best way to cup,5814,5814,-9500,-9500,980,0,71,546471,False,KX4A-266B-M2XP-MPBK
KlcbOs2v79kwUobe,1685961914,–°—ñ–ª—å–ø–æ,5411,5411,-19686,-19686,980,0,0,555971,False,16E2-10X5-2201-HTB8
d0uXPh_sbMkB-FEE,1685960941,LIQPAY*Xa.food oplata,5812,5812,-32800,-32800,980,0,246,575657,False,EMCT-0AEM-P5EH-PX13
REiDrVpFuW-_CDO7,1685954746,LIQPAY*TOV Akvamarket,5411,5411,-28310,-28310,980,0,0,608457,False,984H-CM85-AEX1-74M0
Yu3qICNtKLiXe-am,1685951204,–ö–æ–ª–æ,5411,5499,-2700,-2700,980,0,0,636767,False,PMEP-K927-K91X-K0TX
HOd9_6iwhQuAw2z4,1685948987,5045Kavjarnja,5814,5814,-4500,-4500,980,0,33,639467,False,3358-C2H5-0EX2-62AX
NPsFnO4b3jcFCfQg,1685900426,–°—ñ–ª—å–ø–æ,5411,5411,-17300,-17300,980,0,0,643967,False,K430-KB80-42C6-KBM8
RpQA57rF9fFAJOfI,1685898847,SEJNOUMO,5814,5814,-115000,-115000,980,0,862,661267,False,EXHP-EMTP-C728-CP88
l4k1aiNJBr4Refet,1685891653,mjasnijraj,5499,5499,-10500,-10500,980,0,0,776267,False,XP7C-C371-8A6H-H4PH
namt9CFnEoVzJsJR,1685890849,–ü–∏—Ä—ñ–∂–∫–æ–≤–∞ ¬´–¢—ñ—Ç–∫–∞ –ö–ª–∞—Ä–∞¬ª,5814,5814,-4600,-4600,980,0,34,786767,False,A2M0-B677-3338-B972
FQ-p2A89eUSlzNey,1685887340,BlackSwan,5814,5814,-8500,-8500,980,0,63,791367,False,B6X0-KAEM-7E22-73K1
ukKwv7GBHdq4Q1QF,1685881472,–ê–ø—Ç–µ–∫–∞ –ê–ù–¶,5912,5912,-99600,-99600,980,0,0,799867,False,418K-641H-23TT-28KK
U6MHBd7pJacTX2OE,1685879184,Best way to cup,5814,5814,-9500,-9500,980,0,71,899467,False,8TTC-T313-E59H-835P
njylCxEwNBeY6CPM,1685877335,Pethouse,5995,5995,-306100,-306100,980,0,0,908967,False,8859-A43H-TXXP-5CC3
OlRxGrnKQf0v4hoo,1685875025,MAHAZYN-BAR,5462,5462,-37700,-37700,980,0,0,1215067,False,6MTH-34P1-9K99-E7EE
TZfjtZBAz3Hnm8WL,1685874666,Garage,5921,5921,-189000,-189000,980,0,0,1252767,False,39XM-H8MK-3305-6AEP
bfzYY8ZyTmP76o8N,1685855000,–ê–ø—Ç–µ–∫–∞ –ê–ù–¶,5912,5912,-11600,-11600,980,0,0,1441767,False,9C8M-A32H-48EK-XX67
ApY6PYmIUbTOQO8u,1685811323,Best way to cup,5814,5814,-13000,-13000,980,0,97,1453367,False,552B-PBXA-34T5-BX54
I8I7Mo08gZAz4Jy4,1685811312,BWTC,5814,5814,-48000,-48000,980,0,360,1466367,False,T9EE-K581-K375-9EB8
iVrNAnNUzlCmpes0,1685805817,–°–ü√â–õ–¨–¢–ê,5812,5812,-76500,-76500,980,0,573,1514367,True,4E19-9E03-82M5-K816
Eb_ImpVA945Nd6nK,1685798022,–£–∫—Ä–ø–æ—à—Ç–∞,9402,9402,-4500,-4500,980,0,0,1590867,False,X020-98P8-00E5-9329
wesBJ94BzVk1DiXw,1685795657,Fresh Dzhus end Babl T,5812,5812,-28500,-28500,980,0,213,1595367,False,78BE-8324-414P-K433
wl1Ib3RW9bcXyOX5,1685795397,ITIS CAFE,5814,5814,-18700,-18700,980,0,140,1623867,False,E375-M4H1-8420-A121
OrX6IOwq7Tn1PinW,1685779049,Beer Market,5921,5921,-108150,-108150,980,0,0,1642567,False,85B6-72B2-CTX5-5M44
tK-GKBw5BVtHixKq0R_PAIitew,1685748591,–°–∫–∞—Å—É–≤–∞–Ω–Ω—è. Bird,7999,7999,4000,4000,980,0,0,1750717,False
8zXvZV1wKPV04VBk,1685736312,–í—ñ–¥: –ú–∏–∫–æ–ª–∞ –û–≥–æ–π–∫–æ,4829,4829,190000,190000,980,0,0,1746717,True
FTI58jKXdn3BHiu9,1685735602,GRAMM BAR,5814,5814,-73000,-73000,980,0,547,1556717,False,039K-80PH-EXPM-H46E
mUImTp5srgbkR9yg,1685735581,GRAMM BAR,5814,5814,-773000,-773000,980,0,10831,1629717,False,0KHA-9840-T0XX-25H5
wKww4PeJqKHAvH2I,1685717486,Novapay,8999,8999,-7000,-7000,980,0,0,2402717,False,TP06-T1H6-THMH-0716
H7pC57HgZotUQY75,1685717259,–í–ê–†–¶–ê–ë,5814,5814,-10000,-10000,980,0,200,2409717,False,9T9H-666K-A15B-0M70
xwX-7uE_29pvlB_G,1685689905,Dodo Socks,5651,5651,-121000,-121000,980,0,0,2419717,False,9601-T55P-M79C-H6BC
MQXcV_gICWpTKhbE,1685687950,Best way to cup,5814,5814,-19500,-19500,980,0,0,2540717,False,191X-3MC6-TT37-K1PM
QwJ8N3KciS-K-A3w,1685686236,UNIVERSUMCLINIK,8099,8099,-379200,-379200,980,0,0,2560217,False,B2H7-T6AA-10E6-2HK1
nyqa4BorlIOuxzp9SZpYCg,1685663425,"–°–∫–∞—Å—É–≤–∞–Ω–Ω—è. LIQPAY*Shine Bright,LIQPAY*Shine Bright,DNIPRO,UA,DNIPRO,UA",5977,5977,40660,40660,980,0,0,2939417,False
5KrJPD2pasIqRDJ8,1685631141,Bolt,4121,4121,-11200,-11200,980,0,0,2898757,False,3C9M-HB3B-2958-H2AH
LOlYnCKUcUDGwfcN,1685627120,Bolt,4121,4121,-9700,-9700,980,0,0,2909957,False,9TXM-50C7-5T0P-PKA2
1Oa5Q6xwZESg8e7R,1685602979,Yaroslaviv Val 37-1,5921,5921,-31200,-31200,980,0,0,2919657,False,EH77-T590-8P02-825B
-8yGNZ1YorkMLQbz,1685602672,Rozetka,5399,5399,-47500,-47500,980,0,0,2950857,False,E658-CXC4-0E95-0P47
3hEnEJzVoY9stlON,1685602489,EasyPay,4816,4816,-30900,-30900,980,0,0,2998357,False,41P2-640C-99BP-CH61
LTZoyW4JNPf3LnDj,1685600918,Best way to cup,5814,5814,-6000,-6000,980,0,0,3029257,False,MX8C-HEAB-9MPK-3KTB
FxB221PTV1CMTQkJ,1685599650,Best way to cup,5814,5814,-28500,-28500,980,0,0,3035257,False,B9A3-65E6-T3PA-8E52
p6r9rRqT4FIum-6X,1688032744,Lesya,4829,4829,-500000,-500000,980,0,0,770399,True,M5P2-1THC-0151-B443
DWniaZduXAU1Fodl,1688025023,–ó –ø–ª–∞—Ç–∏–Ω–æ–≤–æ—ó –∫–∞—Ä—Ç–∫–∏,4829,4829,1100000,1100000,980,0,0,1270399,True
s7J4tpebNHH6SZXR,1687962106,421113****7062,4829,4829,-15000,-15000,980,0,0,170399,True,CHB1-06MH-5473-HK45
G0P4aeT8p-YcgMTv,1687957727,414949****7171,4829,4829,-90000,-90000,980,0,0,185399,True,AME2-3K0X-P5TM-E274
I8qLhjhT79kssEDM,1687659687,–†–µ–≥—É–ª—è—Ä–Ω–µ –ø–æ–ø–æ–≤–Ω–µ–Ω–Ω—è ¬´–§–æ–Ω–¥ –ü–æ–≤–µ—Ä–Ω–∏—Å—å –∂–∏–≤–∏–º¬ª,4829,4829,-25000,-25000,980,0,0,275399,True
FihgUdkFJA1_g46F,1687352638,–ü–æ–≥–∞—à–µ–Ω–Ω—è –æ–±–ª—ñ–≥–∞—Ü—ñ–π,4829,4829,100000,100000,980,0,0,300399,True
X3Iiib9RYH7WRwYq,1687350239,–ü—Ä–æ—Ü–µ–Ω—Ç –≤—ñ–¥ –æ–±–ª—ñ–≥–∞—Ü—ñ–π,4829,4829,5500,5500,980,0,0,200399,True
3BXhsqL1x71S-Zlo,1687246193,–ù–∞–¥—ñ—è –°.,4829,4829,-400000,-400000,980,0,0,194899,True,80T7-030K-4C68-9K59
gp2UdxoQeDNoj4Nn,1687081093,Lesya,4829,4829,-50000,-50000,980,0,0,594899,True,1P4T-17PP-8X5E-48EM
us3kKu2ufgrt1-0h,1687054872,–†–µ–≥—É–ª—è—Ä–Ω–µ –ø–æ–ø–æ–≤–Ω–µ–Ω–Ω—è ¬´–§–æ–Ω–¥ –ü–æ–≤–µ—Ä–Ω–∏—Å—å –∂–∏–≤–∏–º¬ª,4829,4829,-25000,-25000,980,0,0,644899,True
1dCy5Y3ey3tIUdVg,1686735864,Lesya,4829,4829,-400000,-400000,980,0,0,669899,True,C6P2-9HKP-C4E8-1B7B
JWa-Nb8hAaW93CR0,1686646886,–ù–∞–¥—ñ—è –°.,4829,4829,-150000,-150000,980,0,0,1069899,True,TK10-M532-TP86-47BP
Q6GOij4JtM62ST4W,1686582396,–ü–∞–ø–∞ –õ–µ—Å–∏,4829,4829,-340000,-340000,980,0,0,1219899,True,38CH-P5MH-T34A-KH3M
GpA2xSjWywzKMFnt,1686578217,–ü–æ–ø–æ–≤–Ω–µ–Ω–Ω—è ¬´–ù–∞ –∞–≤—Ç–æ –¥–ª—è 74 –û–†–ë¬ª,4829,4829,-250000,-250000,980,0,0,1559899,True,0EKT-TC7K-2E3M-X6B9
kQ1AXxnwprlrTww7,1686572146,–§–û–ü –Ø–∫–∏–º–µ–Ω–∫–æ –û–ª–µ–Ω–∞ –í–æ–ª–æ–¥–∏–º–∏—Ä—ñ–≤–Ω–∞,4829,4829,-360900,-360900,980,0,0,1809899,True,C9C9-B17B-7XX1-55HX
cBSVUkp8LflhneiO,1686565806,–ó –ø–ª–∞—Ç–∏–Ω–æ–≤–æ—ó –∫–∞—Ä—Ç–∫–∏,4829,4829,700000,700000,980,0,0,2170799,True
e88ezwdk9xFXqiPR,1686450013,–†–µ–≥—É–ª—è—Ä–Ω–µ –ø–æ–ø–æ–≤–Ω–µ–Ω–Ω—è ¬´–§–æ–Ω–¥ –ü–æ–≤–µ—Ä–Ω–∏—Å—å –∂–∏–≤–∏–º¬ª,4829,4829,-25000,-25000,980,0,0,1470799,True
P16rkxa17mY4zIB2,1686317465,–ó –ø–ª–∞—Ç–∏–Ω–æ–≤–æ—ó –∫–∞—Ä—Ç–∫–∏,4829,4829,400000,400000,980,0,0,1495799,True
9exlvExGOLUjaizW,1686162443,–ü–æ–ø–æ–≤–Ω–µ–Ω–Ω—è ¬´–ù–∞ —á–æ–≤–Ω–∏ —Ç–∞ –º–æ—Ç–æ—Ä–∏¬ª,4829,4829,-150000,-150000,980,0,0,1095799,True,H05B-PE69-9T48-370P
zKucmkGc4krOW5Aa,1686075234,536354****5204,4829,4829,-6000,-6000,980,0,0,1245799,True,B91B-P518-1E6C-68X2
RC_mofAG-5M6bVuo,1686060179,–ó –ø–ª–∞—Ç–∏–Ω–æ–≤–æ—ó –∫–∞—Ä—Ç–∫–∏,4829,4829,800000,800000,980,0,0,1251799,True
Rhu5YlEnL2CV7VI7,1685881966,–Æ–ª—ñ—è –Ø.,4829,4829,-19000,-19000,980,0,0,451799,True,E0K4-E517-H1B3-667H
-q0ucBRBaajoIJAt,1685845139,–†–µ–≥—É–ª—è—Ä–Ω–µ –ø–æ–ø–æ–≤–Ω–µ–Ω–Ω—è ¬´–§–æ–Ω–¥ –ü–æ–≤–µ—Ä–Ω–∏—Å—å –∂–∏–≤–∏–º¬ª,4829,4829,-25000,-25000,980,0,0,470799,True
WEG-GwRPUcAMCS5o,1685720953,–ü–æ–ø–æ–≤–Ω–µ–Ω–Ω—è ¬´–ù–∞ DJI Mavic 3T¬ª,4829,4829,-200000,-200000,980,0,0,495799,True,9P77-BC14-6AH4-C85B
CFdHMmEhxyinpnyS,1690738366,–°—ñ–ª—å–ø–æ,5411,5411,-189215,-189215,980,0,0,731146,False,532H-KXCB-A217-M6HE
9pt8bhd-9iBRi-6U,1690735083,VeterinarniyshpitalGen,742,742,-233500,-233500,980,0,0,920361,False,803A-A6BA-478C-2E51
JA9CQGJcByH7YfDK,1690714763,RestoranPapafeta,5814,5814,-31300,-31300,980,0,0,1153861,False,XXAC-6185-914M-0A2B
F_LaEm7prMx4ekdQ,1690713813,FDY*Merchandise,5399,5399,-123590,-123590,980,0,0,1185161,False,63M7-KC5P-XBHM-M978
X5cBW8E77rdp0hjV,1690706380,Yaroslaviv Val 37-1,5921,5921,-25400,-25400,980,0,0,1308751,False,989E-3PHP-MC1K-4A46
0INqUAZYmNAECp_y,1690700889,Best way to cup,5814,5814,-30500,-30500,980,0,0,1334151,False,T6T7-22MM-CP36-ECT5
hs1bxc3UnwyMpnw4,1690647178,Salonkrasi,7230,7230,-265000,-265000,980,0,0,1364651,False,E0H9-KA9H-C47T-C35E
N-rSalSBtlYgbUyW,1690633873,VeterinarnaklinikaPets,8099,8099,-28000,-28000,980,0,0,1629651,False,PM5H-7A5E-273P-636T
rbeJeKxsFnSaW0pz,1690630288,Diletant,5814,5814,-46500,-46500,980,0,0,1657651,False,8C1M-BBK6-M7B5-KX43
N--j1zexzOs8XTVJ,1690626092,magazin 762597,5912,5912,-2010,-2010,980,0,0,1704151,False,41EB-04XT-MT46-99M3
T6rWE_e_WuJD1TU2,1690614107,Novapay,8999,8999,-9900,-9900,980,0,0,1706161,False,M95H-6168-T40E-3T4T
z-5D4DnYFPFVl5o5,1690611084,–û–±—Å–ª—É–≥–æ–≤—É–≤–∞–Ω–Ω—è –ø–ª–∞—Ç–∏–Ω–æ–≤–æ—ó –∫–∞—Ä—Ç–∫–∏,4829,4829,-30000,-30000,980,0,0,1716061,True
UwCbze2b3VR2CAzD,1690561787,–¢–∞–±–∞–∫–µ—Ä–∫–∞,5993,5993,-78000,-78000,980,0,0,1746061,False,MPET-MPT3-E2XT-T21X
ZGH3lF7zuXuB0kKs,1690561515,Novus,5411,5411,-43093,-43093,980,0,0,1824061,False,KP5P-5385-E68M-M1ET
Z5cDJgN6J60eIbZ9,1690561292,Veterinarniyshpital,742,742,-89000,-89000,980,0,0,1867154,False,770C-2344-9AEE-334P
Pxn51RcRRu7oU8PK,1690561073,Veterinarniyshpital,742,742,-46000,-46000,980,0,0,1956154,False,1CAK-6XET-8HK8-405X
lsTm7rQu3D0WGEbU,1690553235,Novapay,8999,8999,-5000,-5000,980,0,0,2002154,False,21K2-A1AH-4P21-XBMB
QVL-_sLM6Dy5FxIE,1690537285,–°—ñ–ª—å–ø–æ,5411,5411,-10183,-10183,980,0,0,2007154,False,M04T-CX1E-29MX-XCH0
dfKJv6XTTEIl3tG3,1690530689,–ü–µ—Ä–µ–∫–∞–∑ –Ω–∞ –∫–∞—Ä—Ç–∫—É,4829,4829,-100000,-100000,980,0,0,2017337,True
WR8L-FXcZgIUGMDI,1690529127,Veterinarniyshpital,742,742,-322000,-322000,980,0,0,2117337,False,46P0-MBET-17TH-6CH5
bN8AHdyEcx-HQR2M,1690526796,–ï–ª–µ–∫—Ç—Ä–æ—Å–∞–º–æ–∫–∞—Ç–∏ Bolt,7999,7999,-2513,-2513,980,0,0,2439337,False,4P8A-ME58-9M7E-KPPM
PTFX7g3YhBZQ1IOe,1690466210,–ï–ª–µ–∫—Ç—Ä–æ—Å–∞–º–æ–∫–∞—Ç–∏ Bolt,7999,7999,-1795,-1795,980,0,0,2441850,False,C12A-M273-3A2P-AXA9
mk4Uf4e-A5H0FV5j,1690461867,Bowl,5814,5814,-31500,-31500,980,0,0,2443645,False,PEBC-C1TC-639E-EETM
6oPx4IshDUbC6B9d,1690459694,TheCupsEespressobar,5814,5814,-8500,-8500,980,0,0,2475145,False,B012-561K-4968-EA83
NJfSPT7EOP_lmOvf,1690458235,–ö–∞—Å–∞ –£–Ωi–≤–µ—Ä—Å–∞–ª –ë–∞–Ω–∫—É,6010,6010,-10090000,-10090000,980,90000,0,2483645,True,ET7A-8X9E-45EC-3A56
4TRDNfdrBNI3WqES,1690458197,Pethouse,5995,5995,-420400,-420400,980,0,6990,12573645,False,HBPP-3352-BB1C-3PBB
cW9Ru4Z5JkyoJaWq,1690458171,–ü–µ—Ä–µ–∫–∞–∑ –Ω–∞ –∫–∞—Ä—Ç–∫—É,4829,4829,-10000000,-10000000,980,0,0,12994045,True
F3rnjN1fFWykTpmo,1690458121,–ï–ª–µ–∫—Ç—Ä–æ—Å–∞–º–æ–∫–∞—Ç–∏ Bolt,7999,7999,-3334,-3334,980,0,0,22994045,False,947P-371H-52T0-6AXA
oIRomz2y4Sbx4f5V,1690457085,–ê–ª—å—Ç—Ä—É—ñ—Å—Ç ,5812,5812,-34100,-34100,980,0,0,22997379,True,B62A-E4KP-C35P-5M95
4Y031GFkDRjlfQvL,1690457033,Lesya,4829,4829,-20400000,-20400000,980,0,0,23031479,True,TKA8-KM0H-0BEP-8333
q8EmQ9qHgqXyuxE1,1690364399,–íi–¥: –ü–†–ò–•–û–î–¨–ö–û –ï.–í. –§–û–ü,"–î–ª—è –ø–æ–ø–æ–≤–Ω–µ–Ω–Ω—è –∫–∞—Ä—Ç–∫–∏ 5375414101190360, –ü—Ä–∏—Ö–æ–¥—å–∫–æ –ï—Ä–Ω–µ—Å—Ç –íi–∫—Ç–æ—Ä–æ–≤–∏—á, 3487403339",4829,4829,41000000,41000000,980,0,0,43431479,True
dJ6uNMvJ4uGzVnRB,1690354678,–ï–ª–µ–∫—Ç—Ä–æ—Å–∞–º–æ–∫–∞—Ç–∏ Bolt,7999,7999,-3443,-3443,980,0,0,2431479,False,AM59-1HH3-7294-9EBC
nluzPxIDRyGHnHXm,1690354051,COFFEERELIGIA,5814,5814,-25000,-25000,980,0,0,2434922,False,7E2A-9T90-3E5E-H857
AcquOkcq95Yxe_K-,1690353324,–ö–∞—Å–∞ –£–Ωi–≤–µ—Ä—Å–∞–ª –ë–∞–Ω–∫—É,6010,6010,-10047700,-10047700,980,47700,0,2459922,True,45C7-P6M6-532A-P5H3
n6Ehuf8Lc2LA65Di,1690349325,–ü–æ–ø–æ–≤–Ω–µ–Ω–Ω—è ¬´–ö–≤–∞–¥—Ä–æ–∫–æ–ø—Ç–µ—Ä –º–∞–≤—ñ–∫¬ª,4829,4829,-100000,-100000,980,0,0,12507622,True,TPB1-3KM3-8XHT-K0BP
mIvOFI_jcG6dZZG-,1690315235,–ü–µ—Ä–µ–∫–∞–∑ –Ω–∞ –∫–∞—Ä—Ç–∫—É,4829,4829,-10200000,-10200000,980,0,0,12607622,True
tck1y84CfUukHx0V,1690312266,Lesya,4829,4829,-20400000,-20400000,980,0,0,22807622,True,A04K-XCCM-P23E-AXKA
cX9OZdd2h-t5tx23,1690300830,–°—ñ–ª—å–ø–æ,5411,5411,-187525,-187525,980,0,0,43207622,False,2M45-2XCX-56T1-28KE
g3qW-2rs2EVdjrsf,1690280598,–íi–¥: –ü–†–ò–•–û–î–¨–ö–û –ï.–í. –§–û–ü,"–î–ª—è –ø–æ–ø–æ–≤–Ω–µ–Ω–Ω—è –∫–∞—Ä—Ç–∫–∏ 5375414101190360, –ü—Ä–∏—Ö–æ–¥—å–∫–æ –ï—Ä–Ω–µ—Å—Ç –íi–∫—Ç–æ—Ä–æ–≤–∏—á, 3487403339",4829,4829,30500000,30500000,980,0,0,43395147,True
e6pmegSg9MC8dNx9,1690278681,–íi–¥: –ü–†–ò–•–û–î–¨–ö–û –ï.–í. –§–û–ü,"–î–ª—è –ø–æ–ø–æ–≤–Ω–µ–Ω–Ω—è –∫–∞—Ä—Ç–∫–∏ 5375414101190360, –ü—Ä–∏—Ö–æ–¥—å–∫–æ –ï—Ä–Ω–µ—Å—Ç –íi–∫—Ç–æ—Ä–æ–≤–∏—á, 3487403339",4829,4829,11000000,11000000,980,0,0,12895147,True
uK2dOfXjU1pxKrCg,1690269121,Best way to cup,5814,5814,-40010,-40010,980,0,0,1895147,False,3TCM-8EK2-29CX-KMA2
rXrkJhJJSdb0U99i,1690267841,Best way to cup,5814,5814,-9500,-9500,980,0,0,1935157,False,T24B-760C-E889-X9E2
r9CSD4wKdzF7f-uk,1690263724,Leilia Bakery,5814,5814,-27200,-27200,980,0,0,1944657,False,65P7-7HP4-T672-966M
tc4guXJLEVwoi7LI,1690263410,t.c.pizza,5812,5812,-29200,-29200,980,0,0,1971857,True,4322-PT5H-B3KT-P4H5
5P7FqFpQHNJ6bzKi,1690234627,–ü–µ—Ä–µ–∫–∞–∑ –Ω–∞ –∫–∞—Ä—Ç–∫—É,4829,4829,-200000,-200000,980,0,0,2001057,True
SXl87H_30ax1fsEn,1690234614,Lesya,4829,4829,-300000,-300000,980,0,0,2201057,True,8516-68E8-1B4E-1801
RQu7167YH__mM41m,1690223439,–ü–∞—Ä–∫–æ–≤–∫–∞ –¢–†–¶ ¬´Respublika Park¬ª,5511,5511,-6000,-6000,980,0,0,2501057,False,4K0T-002B-905E-KPB5
4ft8_prLHN4t-1Wt,1690215964,Multiplex,7832,7832,-22800,-22800,980,0,0,2507057,False,PM68-H6HP-6BT7-37P4
JnS-_G2Q8M8MM8E2,1690214549,PHILADELPHIA,5812,5812,-25900,-25900,980,0,0,2529857,False,9HEK-B9XB-TKBC-5KBB
0S2AGq9KT_DDYlrj,1690214155,ITIS CAFE,5814,5814,-18700,-18700,980,0,0,2555757,False,8P09-XM8A-C7A0-BCB7
cs8JX81h-kDPC_7C,1690190017,–°—ñ–ª—å–ø–æ,5411,5411,-13936,-13936,980,0,0,2574457,False,MH5E-ABTH-590E-AX72
kD9achqwR5h_ugaQ,1690181912,–íi–¥: –ü–†–ò–•–û–î–¨–ö–û –ï.–í. –§–û–ü,"–î–ª—è –ø–æ–ø–æ–≤–Ω–µ–Ω–Ω—è –∫–∞—Ä—Ç–∫–∏ 5375414101190360, –ü—Ä–∏—Ö–æ–¥—å–∫–æ –ï—Ä–Ω–µ—Å—Ç –íi–∫—Ç–æ—Ä–æ–≤–∏—á, 3487403339",4829,4829,2500000,2500000,980,0,0,2588393,True
cHP0MZTETk8Zw-ho,1690181851,Best way to cup,5814,5814,-7000,-7000,980,0,0,88393,False,X5EE-B44H-2005-P311
KclJm3kWlET00MiG,1690178537,Best way to cup,5814,5814,-12500,-12500,980,0,0,95393,False,0P7X-B08H-09MK-484H
fRUqlQwhaqurhSJz,1690125844,FDY*FOOD,5499,5499,-50400,-50400,980,0,0,107893,False,B9E1-8HK5-0HHE-0HMH
kzNse7kEK7kgE9F8,1690123955,–ï–ª–µ–∫—Ç—Ä–æ—Å–∞–º–æ–∫–∞—Ç–∏ Bolt,7999,7999,-3570,-3570,980,0,0,158293,False,XP2X-0TT8-B4A0-0968
_w86iUGAhUWJa0I2,1690122816,Mahazyn kvity,5992,5992,-18000,-18000,980,0,0,161863,False,0TKA-5XKM-6E73-EKA5
Em0A9-XpH3kXittO,1690122694,–°—ñ–ª—å–ø–æ,5411,5411,-60448,-60448,980,0,0,179863,False,XTA3-4436-KAM5-P128
HTH0J5_887OrUl37,1690121649,Konteyner,5814,5814,-9200,-9200,980,0,0,240311,False,PPC4-XE7C-BBEC-X8XC
8LkmoTUx8FuM60M5,1690120683,Konteyner,5814,5814,-11100,-11100,980,0,0,249511,False,ETAP-EXB4-A8AB-K636
KItIHZdk3nPzFeae,1690119109,Konteyner,5814,5814,-22200,-22200,980,0,0,260611,False,8B2H-3XH7-7EKH-2970
gqDLtuPUmrUccosq,1690117933,Konteyner,5814,5814,-16200,-16200,980,0,0,282811,False,0418-B4X6-33H5-4CMM
9see-8yaaqh6ZJre,1690117037,Konteyner,5814,5814,-5400,-5400,980,0,0,299011,False,9H40-H1AX-EE2T-2X84
qu8vMcIyIXWkhAb7,1690116636,–ï–ª–µ–∫—Ç—Ä–æ—Å–∞–º–æ–∫–∞—Ç–∏ Bolt,7999,7999,-1494,-1494,980,0,0,304411,False,TP73-CX03-P862-H835
04vJbWZBqL59pkBD,1690116445,–ï–ª–µ–∫—Ç—Ä–æ—Å–∞–º–æ–∫–∞—Ç–∏ Bolt,7999,7999,-2117,-2117,980,0,0,305905,False,EB05-4P71-EE75-MX3E
3Sr1EP1p_RN3RRGs,1690102903,–ö—ñ–Ω–æ–º–∞—Ä–∫–µ—Ç –ü–ª–∞–Ω–µ—Ç–∞ –ö—ñ–Ω–æ,5411,5411,-15900,-15900,980,0,0,308022,False,E2X3-833E-AM46-9AK8
zGzvy9ANchEShOWC,1690095231,Best way to cup,5814,5814,-22000,-22000,980,0,0,323922,False,X5TB-371B-0X58-TPXX
kclxjI0gIZmFqaOt,1690090215,–°—ñ–ª—å–ø–æ,5411,5411,-54868,-54868,980,0,0,345922,False,68EC-8033-MM90-55EB
3FKlVv-PRyqAo1y-,1690046268,Yaroslaviv Val 37-1,5921,5921,-105140,-105140,980,0,0,400790,False,7T7P-H209-9H1E-X82H
jkF1ZZJhXQxQ9CzL,1690045699,–í–ê–†–¶–ê–ë,5814,5814,-19000,-19000,980,0,0,505930,False,91BK-HT17-3K6A-B387
Dt7bB-pcp4Lz4O1X,1690033939,Best way to cup,5814,5814,-16500,-16500,980,0,0,524930,False,91MB-B560-017H-P468
CTcFS-nqs-DOS3S9,1690016260,Best way to cup,5814,5814,-15500,-15500,980,0,0,541430,False,9XHB-5MXE-22M8-877P
tci3Vj7I6Oycbyv8,1689971648,–ï–ª–µ–∫—Ç—Ä–æ—Å–∞–º–æ–∫–∞—Ç–∏ Bolt,7999,7999,-4596,-4596,980,0,0,556930,False,B752-872A-3EPE-KBCC
fy4t3Rhw9qVONCw1,1689955728,–ï–ª–µ–∫—Ç—Ä–æ—Å–∞–º–æ–∫–∞—Ç–∏ Bolt,7999,7999,-2742,-2742,980,0,0,561526,False,E48X-094P-A876-5K26
0L6md7gLZcI5zuFl,1689954486,OKKO,5541,5541,-206712,-206712,980,0,0,564268,False,HEBA-3150-T5PM-XBHC
5tNcKH4ecNvABFEs,1689939456,OK Wine,5411,5411,-9900,-9900,980,0,0,770980,False,CP9M-A92M-129P-8TET
hpyvw82eLLvLvNjM,1689939182,FOPAbdullaevSH,5814,5814,-14000,-14000,980,0,0,780880,False,5EH0-CP0X-4AP3-MB1P
U2VJDMgY1O4h1pbs,1689930922,–°—ñ–ª—å–ø–æ,5411,5411,-7710,-7710,980,0,0,794880,False,T20E-85EX-03TX-CEA6
DJbJTjvURGt0LCmZ,1689922764,Best way to cup,5814,5814,-10500,-10500,980,0,0,802590,False,0M0K-9MET-CE95-14XT
YcRJvlGHsdjcXI8U,1689922614,–¢–∞–±–∞–∫–µ—Ä–∫–∞,5993,5993,-149000,-149000,980,0,0,813090,False,9A6K-75M7-A1TK-6KBA
lrJVbY8_mPLi7-Cb,1689922482,Novus,5411,5411,-15196,-15196,980,0,0,962090,False,7EM3-7HXT-9CBT-238B
QKs8PCds-l4fF3rx0BBQ,1689895806,–ï–ª–µ–∫—Ç—Ä–æ—Å–∞–º–æ–∫–∞—Ç–∏ Bolt,7999,7999,-4425,-4425,980,0,0,977286,True
LeS0Mt1E1fp5NueFCrfo,1689895806,–ï–ª–µ–∫—Ç—Ä–æ—Å–∞–º–æ–∫–∞—Ç–∏ Bolt,7999,7999,-1624,-1624,980,0,0,981711,True
FLEirS99FTfL5z_rKZy6p0tOLg,1689895806,–°–∫–∞—Å—É–≤–∞–Ω–Ω—è. –ï–ª–µ–∫—Ç—Ä–æ—Å–∞–º–æ–∫–∞—Ç–∏ Bolt,7999,7999,5000,5000,980,0,0,983335,False
8-2d54uxErodgvVp2cKxebSC-A,1689895806,–°–∫–∞—Å—É–≤–∞–Ω–Ω—è. –ï–ª–µ–∫—Ç—Ä–æ—Å–∞–º–æ–∫–∞—Ç–∏ Bolt,7999,7999,5000,5000,980,0,0,978335,False
xtR_H61m_hn0t_17,1689875552,–ó–∞–º–æ–≤–ª–µ–Ω–Ω—è —ó–∂—ñ,5499,5499,-108370,-108370,980,0,0,973335,False,P6E6-32K3-7E1M-4C9B
FVZ07sbgPMNhQrUB,1689866305,VeterinarnaklinikaPets,8099,8099,-65000,-65000,980,0,487,1081705,False,8P5X-3BK0-A9X3-7259
_UoOsxJDBOQKpcSJ,1689863224,VeterinarnaklinikaPets,8099,8099,-65000,-65000,980,0,487,1146705,False,M5MH-6P7X-01BK-697T
GTi4wPwMEfMSxVjw,1689854967,–ú—ñ–∫—Å –ú–∞—Ä—Ç,5499,5499,-8800,-8800,980,0,0,1211705,False,1B97-HB16-10X6-BPKB
TMQswJZLOkgsS2UN,1689854736,Leilia Bakery,5814,5814,-12500,-12500,980,0,0,1220505,False,C3PA-52A4-XA62-4A7P
HMze7cWx2IeChduX,1689852077,BURGER FARM,5812,5812,-31815,-31815,980,0,0,1233005,False,P81X-X18B-4MXA-HEP0
L9ciPmrNNGgNrxiV,1689851730,–ö–∏—ó–≤–ø–∞—Å—Ç—Ä–∞–Ω—Å,4111,4111,-800,-800,980,0,0,1264820,False,2H5C-ABA7-134P-37BB
wdx426wb63mGEg7i,1689841790,VeterinarnaklinikaPets,8099,8099,-285000,-285000,980,0,2137,1265620,False,6PC6-BM24-4CCK-1PP9
a0-zpCRxKT1sJCmk,1689840511,magazin 762597,5912,5912,-237145,-237145,980,0,1778,1550620,False,0XX5-PEKE-07EE-54A5
mTIyYSEQL9HIPASN,1689840105,PetStoryZootovari,5995,5995,-76100,-76100,980,0,570,1787765,False,324E-8H37-1K17-AX1X
K_3kXcVHBIMAaQqk,1689799981,Novapay,8999,8999,-5500,-5500,980,0,0,1863865,False,9A5B-89TH-4A4E-BCP1
oS0V8LWjI6lD83YM,1689799950,Novapay,8999,8999,-5500,-5500,980,0,0,1869365,False,T833-CCAB-28BT-BTA7
4ExoP7ShaU-e2jRb,1689793661,–°—ñ–ª—å–ø–æ,5411,5411,-88509,-88509,980,0,0,1874865,False,XC9C-3P8T-CM8H-BP00
N3oybKS-OtvijwfL,1689770803,–°—ñ–ª—å–ø–æ,5411,5411,-3844,-3844,980,0,0,1963374,False,XE8T-K8EP-7B28-A10E
jndsLGVoxUn8zBhu,1689763769,Best way to cup,5814,5814,-43000,-43000,980,0,0,1967218,False,7354-0K08-TA3P-9B4B
wesBI9YHz1kyCyrz,1689760199,FDY*Merchandise,5399,5399,-97640,-97640,980,0,0,2010218,False,C05H-HMBA-E5AM-CT53
_6sehHNF697M9-si,1689751906,Best way to cup,5814,5814,-29500,-29500,980,0,0,2107858,False,BCEK-E8H4-4CHE-4800
zcJb1XAQeU-ACQxD,1689750309,–ï–ª–µ–∫—Ç—Ä–æ—Å–∞–º–æ–∫–∞—Ç–∏ Bolt,7999,7999,-2212,-2212,980,0,0,2137358,False,8E16-3924-A40T-507X
72dOtWtJWAlgFcZc,1689712013,Novapay,8999,8999,-7000,-7000,980,0,0,2139570,False,1159-5MM4-7311-EEBT
KX8wAB0P-YSbuuSU,1689706560,–ï–ª–µ–∫—Ç—Ä–æ—Å–∞–º–æ–∫–∞—Ç–∏ Bolt,7999,7999,-5000,-5000,980,0,0,2146570,False
5-JSSeTuMH2ZMMRI,1689706399,–ï–ª–µ–∫—Ç—Ä–æ—Å–∞–º–æ–∫–∞—Ç–∏ Bolt,7999,7999,-5000,-5000,980,0,0,2151570,False
PlducgcoqEzlmBrX,1689706389,–ï–ª–µ–∫—Ç—Ä–æ—Å–∞–º–æ–∫–∞—Ç–∏ Bolt,7999,7999,-4794,-4794,980,0,0,2156570,False,105K-BA3H-6B36-3414
-vQXErIs0QxGcyYD,1689696139,–ï–ª–µ–∫—Ç—Ä–æ—Å–∞–º–æ–∫–∞—Ç–∏ Bolt,7999,7999,-4924,-4924,980,0,0,2161364,False,1CKX-0X82-527X-81B5
dy8jAc-T53wU5Gyw,1689669609,–ü–µ—Ä–µ–∫–∞–∑ –Ω–∞ –∫–∞—Ä—Ç–∫—É,4829,4829,-700000,-700000,980,0,0,2166288,True
S7xO2TOiUKtLm5O9,1689669585,Best way to cup,5814,5814,-18500,-18500,980,0,0,2866288,False,X3X7-24H2-0KB2-26T7
wEQKWweZkdYDp2Wp,1689655859,–°—ñ–ª—å–ø–æ,5411,5411,-58108,-58108,980,0,0,2884788,False,MC3E-794X-47PH-400M
HAVDzn2vPtjJIiGG,1689610909,Roshen,5441,5441,-5067,-5067,980,0,0,2942896,False,T42A-EAM5-M348-8A35
MP_C_HTTkJZqzM0r,1689608340,Avi –∫—ñ–æ—Å–∫,5812,5812,-32500,-32500,980,0,0,2947963,True,00K8-10EK-664X-B2A5
rUbd54eJbbTo4CkJ,1689581975,–íi–¥: –ü–†–ò–•–û–î–¨–ö–û –ï.–í. –§–û–ü,"–î–ª—è –ø–æ–ø–æ–≤–Ω–µ–Ω–Ω—è –∫–∞—Ä—Ç–∫–∏ 5375414101190360, –ü—Ä–∏—Ö–æ–¥—å–∫–æ –ï—Ä–Ω–µ—Å—Ç –íi–∫—Ç–æ—Ä–æ–≤–∏—á, 3487403339",4829,4829,2800000,2800000,980,0,0,2980463,True
R7qBdsi6_gG8_n0F,1689578308,OK Wine,5921,5921,-74550,-74550,980,0,0,180463,False,X5AX-4X16-EP1P-904H
qLBdZ-q4Nl3POYAb,1689577548,Novapay,8999,8999,-36600,-36600,980,0,0,255013,False,3M03-540C-11CM-8CC3
Ws2oesoWnIEyyen2,1689576824,Best way to cup,5814,5814,-9500,-9500,980,0,0,291613,False,EX93-08H0-2788-4EA1
4hS-HMctDqbhMY_p,1689576257,Best way to cup,5814,5814,-26000,-26000,980,0,0,301113,False,5XHC-PBP7-0811-APEB
whWyjIFDNU0ssmEt,1689532278,Salateira,5814,5814,-21501,-21501,980,0,0,327113,False,XP5H-AEPB-9016-B200
GjGB-sgX5-4tlyar,1689516892,–ê–ø—Ç–µ–∫–∞ –ê–ù–¶,5912,5912,-3400,-3400,980,0,25,348614,False,176B-1CE2-3TAX-PXPP
XMJipBvRIvo2FN1m,1689510062,Yaroslaviv Val 37-1,5921,5921,-15200,-15200,980,0,0,352014,False,6TA0-0P7P-C79B-385H
bX6Ex7Z41PedVOxC,1689509608,–í–ê–†–¶–ê–ë,5814,5814,-40000,-40000,980,0,0,367214,False,669B-H9M0-MX61-P670
PQN4y0gasLMTzUNI,1689498541,Best way to cup,5814,5814,-8000,-8000,980,0,0,407214,False,E42M-928E-XX40-ECHK
6axBWK3_sGAWkCWA,1689492738,LeiliaBakery,5462,5462,-32500,-32500,980,0,0,415214,False,KB1A-9201-MX6P-4HHX
DWQjfUM8WImSMRAV,1689492670,TC&LB,5812,5812,-31000,-31000,980,0,0,447714,True,755A-MK7B-7E4T-C602
DfFAfGtKpx5mSzjn,1689492040,Leilia Bakery,5814,5814,-47500,-47500,980,0,0,478714,False,APH7-T0BC-T9H1-696T
F_GyWRIl6Rx0W3JH,1689491663,TC&LB,5812,5812,-63600,-63600,980,0,0,526214,True,2TM6-7A2B-57BC-3T06
9gZ1JDY1bUae3XMP,1689446745,Pethouse,5995,5995,-437200,-437200,980,0,3279,589814,False,38P3-CCM3-P5KM-85BX
lSeszBG-J5Nk9lNs,1689430331,Best way to cup,5814,5814,-21500,-21500,980,0,0,1027014,False,E7X0-B2TK-E4KM-PX09
BaKeY5UvZkkirYNQ,1689430260,–ï–ª–µ–∫—Ç—Ä–æ—Å–∞–º–æ–∫–∞—Ç–∏ Bolt,7999,7999,-5427,-5427,980,0,0,1048514,False,15AC-4XB4-CA77-0KTT
tIVRgaprEzfcsg4r,1689430097,–ê–ø—Ç–µ–∫–∞ –ê–ù–¶,5912,5912,-40900,-40900,980,0,306,1053941,False,ET89-M3HX-E6HK-EEE6
MWjLUdAQ0foIQxQt,1689429655,magazin 762597,5912,5912,-84100,-84100,980,0,630,1094841,False,X7AT-9E34-E4K7-9304
usb0freg6WjhETh0,1689429096,Food Spot,5812,5812,-78000,-78000,980,0,0,1178941,True,7MC1-5193-7CK4-P607
edBT8n-Mr9jfVs2X,1689426084,–ï–ª–µ–∫—Ç—Ä–æ—Å–∞–º–æ–∫–∞—Ç–∏ Bolt,7999,7999,-1877,-1877,980,0,0,1256941,False,B3P6-BHKX-CK0B-95K7
OyOJvVC7_JF6Uwsh,1689425803,–ï–ª–µ–∫—Ç—Ä–æ—Å–∞–º–æ–∫–∞—Ç–∏ Bolt,7999,7999,-2632,-2632,980,0,0,1258818,False,4K6P-7KB3-X1C6-4HXT
UHz4ggvKUjBXsPnr,1689422558,StudijaKvitivtadekoruS,5992,5992,-130200,-130200,980,0,0,1261450,False,A3K1-AH18-K9ET-E57C
9788cZNzAvutWHTz,1689421708,–ê–≤—Ç–æ—Å—Ç–∞–Ω—Ü—ñ—è,5812,5812,-18200,-18200,980,0,0,1391650,True,T0A1-3HP3-AB0M-K952
yW4DnHp5lQFArXrN,1689418568,Best way to cup,5814,5814,-9500,-9500,980,0,0,1409850,False,M2XX-T245-2H2P-2PB0
gBRAvyHVV9Z1e4cd,1689411937,magazin 762597,5912,5912,-86380,-86380,980,0,647,1419350,False,B05X-MH58-1X82-M84E
Cc-QXYMUFW19CNbT,1689410492,SEJNOUMO,5814,5814,-5000,-5000,980,0,0,1505730,False,KTKC-KCBE-5932-BA3B
FbKowEexxUu_ek5Q,1689410474,SEJNOUMO,5814,5814,-200000,-200000,980,0,0,1510730,False,8CP4-0PM0-K07A-81T8
3s5DUQxWaLcAFUk3,1689355985,Novus,5411,5411,-55025,-55025,980,0,0,1710730,False,X274-M49H-13AX-0264
KMTcC8bFHgW7ftj8,1689355728,Novapay,8999,8999,-8000,-8000,980,0,0,1765755,False,K7B3-19AT-5115-0977
77mZI-VKO69ZlkKH,1689350181,WFP.CHARITY,8398,8398,-10000,-10000,980,0,0,1773755,False,E701-68MK-C5PA-8A28
TdBaMMbiBIhVlo-s,1689348623,Best way to cup,5814,5814,-13000,-13000,980,0,0,1783755,False,B4AB-3M44-7HX3-02XC
iolmAHLQM7OSLdqe,1689270508,Best way to cup,5814,5814,-9500,-9500,980,0,0,1796755,False,TB3B-0AK3-HKBT-8TC4
PLc-GFhFvxxVtu5M,1689269085,BWTC,5814,5814,-15500,-15500,980,0,0,1806255,False,E649-0CT2-C144-4BC4
cbXJS7E-fectRceL,1689269077,Best way to cup,5814,5814,-20000,-20000,980,0,0,1821755,False,MX63-77K9-B4H9-TTMB
U-tn6Cf3Z5sY7u9-,1689268758,–¢–∞–±–∞–∫–µ—Ä–∫–∞,5993,5993,-71000,-71000,980,0,0,1841755,False,87C5-P07K-MCEB-2X49
gPQhfqiNRTwVi3v1,1689268614,Novus,5411,5411,-30975,-30975,980,0,0,1912755,False,X0CX-K309-296H-EE6T
tMEfpwMR-9sTd_fh,1689268046,LaFabrique,5814,5814,-5500,-5500,980,0,0,1943730,False,65B8-H96B-T84H-PTHH
MAOoUlBaYAZKKcfE,1689267859,magazin 762597,5912,5912,-155930,-155930,980,0,2483,1949230,False,5CXP-APHC-7B37-X306
AYJ_g_UIua6l5hja,1689248725,AVANGARDEN,5812,5812,-15300,-15300,980,0,0,2105160,True,BTCC-PHA3-T4PX-4062
PyHMyh_iM1oCCRrb,1689236025,–ü–µ—Ä–µ–∫–∞–∑ –Ω–∞ –∫–∞—Ä—Ç–∫—É,4829,4829,-400000,-400000,980,0,0,2120460,True
mgaPGABQGc3ZO3e2,1689235853,–ë–∞–Ω–∫–æ–º–∞—Ç BRANCH 10026-0159,6011,6011,-300000,-300000,980,0,0,2520460,False,T92M-E94T-A0MC-9CX3
HR86BrtiqqI-lVLM,1689229502,Best way to cup,5814,5814,-7000,-7000,980,0,0,2820460,False,0K6B-4E93-T44T-5C3A
ruIeAV_S_Ecx3ssN,1689228870,Best way to cup,5814,5814,-14000,-14000,980,0,0,2827460,False,BA3M-8910-B39C-A7C8
v2xU1Y4Js_-ly6xV,1689228573,Best way to cup,5814,5814,-11000,-11000,980,0,0,2841460,False,085M-23C6-0296-P90P
9Md_YmVqdubwl81V,1689228475,Best way to cup,5814,5814,-19500,-19500,980,0,0,2852460,False,E167-4PB9-2HAC-702P
9nn8YuUDPJXhNGdY,1689180533,Veterinarniyshpital,742,742,-180200,-180200,980,0,18020,2871960,False,54PA-CB40-X93B-71CH
h0IZOGbWfmIdpmZb,1689154352,SHOPSILPO,5411,5411,-75790,-75790,980,0,0,3052160,False,K9P9-EH83-4868-XB78
ZB1xGMUVHDO271vT,1689151615,–íi–¥: –ü–†–ò–•–û–î–¨–ö–û –ï.–í. –§–û–ü,"–î–ª—è –ø–æ–ø–æ–≤–Ω–µ–Ω–Ω—è –∫–∞—Ä—Ç–∫–∏ 5375414101190360, –ü—Ä–∏—Ö–æ–¥—å–∫–æ –ï—Ä–Ω–µ—Å—Ç –íi–∫—Ç–æ—Ä–æ–≤–∏—á, 3487403339",4829,4829,2000000,2000000,980,0,0,3127950,True
ulpv7Wvee4dYb5Rw,1689099244,–ê–≤—Ç–æ—Å—Ç–∞–Ω—Ü—ñ—è,5812,5812,-132000,-132000,980,0,0,1127950,True,4H1H-8694-C691-BA7C
s2yOj6qLYbO_qZ9H,1689074042,SHOPSILPO,5411,5411,-206784,-206784,980,0,0,1259950,False,732H-P02X-C44K-97MA
hF5qrndlGRESzxoa,1689055124,Best way to cup,5814,5814,-21000,-21000,980,0,0,1466734,False,PXCX-9HM8-43X3-9804
vlGqntreOcOsBBoE,1689054685,Best way to cup,5814,5814,-19500,-19500,980,0,0,1487734,False,8X23-3E97-M4KH-XKK1
_aa7_ylVAZnl-Cr8,1689012076,Novapay,8999,8999,-3600,-3600,980,0,0,1507234,False,H4B0-341A-E2H5-BPTB
qzbgrUyLV1EbCG7m,1689002149,–ï–ª–µ–∫—Ç—Ä–æ—Å–∞–º–æ–∫–∞—Ç–∏ Bolt,7999,7999,-2229,-2229,980,0,0,1510834,False,XX77-C4EA-BTK2-K79T
eWygRMzG0NBJjpos,1688981606,APTEKAR,5912,5912,-129640,-129640,980,0,972,1513063,False,92CP-8TB9-BCMC-9HP0
UVCGVr_gvBAVoWCe,1688978028,Mates,5812,5812,-9500,-9500,980,0,0,1642703,True,9236-183P-76B0-2900
5SV-S9hJg0fU0tdm,1688976307,–ï–ª–µ–∫—Ç—Ä–æ—Å–∞–º–æ–∫–∞—Ç–∏ Bolt,7999,7999,-2513,-2513,980,0,0,1652203,False,X146-M3EE-5641-P5K6
L_33OgHxR5rW9IDY,1688924718,–ö–æ–ª–æ,5499,5499,-2900,-2900,980,0,0,1654716,False,0H36-T61T-B44X-37BT
kmCPwoMg-TJ1RCuv,1688913281,–ï–ª–µ–∫—Ç—Ä–æ—Å–∞–º–æ–∫–∞—Ç–∏ Bolt,7999,7999,-2930,-2930,980,0,0,1657616,False,E583-38X5-K0TK-3E2X
tmUN-KN1y9AxpUMd,1688912706,FOP Kovtun VV,5814,5814,-52000,-52000,980,0,0,1660546,False,A4HB-C7BK-4BE9-PCH6
Xcjd_bEh-MY_V1ub,1688912667,Bilyardna,5814,5814,-37000,-37000,980,0,0,1712546,False,C311-T7C2-3K07-A6B2
m993UyF9Dda9CgcI,1688907802,–ï–ª–µ–∫—Ç—Ä–æ—Å–∞–º–æ–∫–∞—Ç–∏ Bolt,7999,7999,-2051,-2051,980,0,0,1749546,False,TKPE-BH7T-2K1M-918C
YGO-Vo0eZIk6FbR1,1688896058,Best way to cup,5814,5814,-16500,-16500,980,0,0,1751597,False,3A1C-XX2C-0EEA-X521
eZlm-rJ6gwZF5ttj,1688895848,Novus,5411,5411,-45290,-45290,980,0,0,1768097,False,14H0-MH4A-2524-9437
ZNc5KERQd6DxirkO,1688890840,TOV PARYTET,5511,5511,-235870,-235870,980,0,0,1813387,False,B265-T664-66PA-M31C
TZfjspdAyHrjm8CK,1688890827,–ü–µ—Ä–µ–∫–∞–∑ –Ω–∞ –∫–∞—Ä—Ç–∫—É,4829,4829,-300000,-300000,980,0,0,2049257,True
QWpvQtTp-FAMORrQ,1688890787,TOV PARYTET,5511,5511,-347500,-347500,980,0,0,2349257,False,P540-KT51-B407-AHCX
LxD6G5GdympGLnoe,1688882573,LIQPAY*ZL Vet,742,742,-70000,-70000,980,0,7000,2696757,False,602A-6MP9-0T2E-0B46
xdXaNbZ_b-K5Sfd5,1688882431,Best way to cup,5814,5814,-10000,-10000,980,0,0,2766757,False,T8MH-PP1P-024X-BXT8
ps7KhxNJvAiV_3Kh,1688839910,OK Wine,5411,5411,-28500,-28500,980,0,0,2776757,False,M5PE-ME55-EATH-34MH
eM6NKHecAgEv62Tm,1688839501,AVANGARDEN,5812,5812,-123800,-123800,980,0,0,2805257,True,5TEE-32MX-4210-X5KP
gc80ikvZnYMs2Mhn,1688825851,Best way to cup,5814,5814,-14000,-14000,980,0,0,2929057,False,83AE-A3C0-77KM-H9XH
UD4DHzrk8iBXQZ_4,1688825350,Best way to cup,5814,5814,-27000,-27000,980,0,0,2943057,False,9ET7-T596-6408-CKP1
D5AHtPbmO5AdQ7oi,1688825056,–û–ª—å–≥–∞ –ö.,–ß–∞–π–æ–≤—ñ,4829,4829,-15000,-15000,980,0,0,2970057,True,T9P8-M677-AP2C-95HH
zlUjg-en5EeseTcl,1688825027,–û–ª—å–≥–∞ –ö.,4829,4829,-60000,-60000,980,0,0,2985057,True,84P0-XB5X-K75X-X62X
tiFYK71G9zgBpmb6,1688813259,Rebornhimchistka,7216,7216,-72500,-72500,980,0,0,3045057,False,44XM-5BK0-39PM-A817
O4CQtGPx0r1_Sb0w,1688812279,FOP YaSTREB O.O.,5944,5944,-628000,-628000,980,0,0,3117557,False,MT70-TA13-T1A5-607E
NS1nXnT_LGDThEad,1688804266,Best way to cup,5814,5814,-22000,-22000,980,0,0,3745557,False,10P1-KE99-EX1C-800K
iylqEi1uol3m8mk1,1688796776,–°—ñ–ª—å–ø–æ,5411,5411,-30189,-30189,980,0,0,3767557,False,AAT3-MX67-56A5-B015
eZ1h2k9NFzmZVQZN,1688749502,"Apteka""TOVANRIGRUP""",5912,5912,-50800,-50800,980,0,1016,3797746,False,E55A-TXEM-515T-MBB5
t4nBESLcqj9SrCMn,1688745891,OK Wine,5411,5411,-141350,-141350,980,0,0,3848546,False,755E-B31A-P2PM-HT1M
RUc0XvITRS2ULQC_,1688739500,SKLAD-MAGAZYN,5949,5949,-42450,-42450,980,0,0,3989896,False,B5XE-A9M0-1HC3-HC5M
YGICXX1Wi4oyx4uS,1688711674,Best way to cup,5814,5814,-6000,-6000,980,0,0,4032346,False,P280-PK99-HB35-77H4
DiIssfEeifxnk4M6,1688710913,Best way to cup,5814,5814,-8500,-8500,980,0,0,4038346,False,19T9-X47E-KBAH-HX7A
T5UIuGBmO72Pe_-c,1688710705,Best way to cup,5814,5814,-7000,-7000,980,0,0,4046846,False,M8C4-X0TP-BHE2-XA41
tMLygxH9iZWGy5Q_,1688709880,Best way to cup,5814,5814,-21500,-21500,980,0,0,4053846,False,MPP2-0T44-M3KB-XK6K
qLi1gbnxZEm2DtLG,1688706578,Novapay,8999,8999,-5000,-5000,980,0,0,4075346,False,7P1X-6869-5HP6-TT2T
sMKppob0FMstCWfR,1688661384,Best way to cup,5814,5814,-29500,-29500,980,0,0,4080346,False,H01M-EE61-4THT-MEBC
TUg9qrJi7_gkGWkH,1688661070,–ù–æ–≤–∞ –ø–æ—à—Ç–∞,4214,4214,-5500,-5500,980,0,0,4109846,False,4X56-E2A7-BB7T-68XC
Jb8B5IibkK5w5Hrk,1688660356,–ù–æ–≤–∞ –ø–æ—à—Ç–∞,4214,4214,-6000,-6000,980,0,0,4115346,False,KH2X-PT1M-4M12-T406
BWQJ6sIF44OEhBMW,1688650950,–û—Ñ—ñ—Å-—á–∞–π,5812,5812,-15800,-15800,980,0,0,4121346,True,B2HC-T6XT-PHE1-8646
AZc0Gn8FZD_Owd-l,1688633778,–íi–¥: –ü–†–ò–•–û–î–¨–ö–û –ï.–í. –§–û–ü,"–î–ª—è –ø–æ–ø–æ–≤–Ω–µ–Ω–Ω—è –∫–∞—Ä—Ç–∫–∏ 5375414101190360, –ü—Ä–∏—Ö–æ–¥—å–∫–æ –ï—Ä–Ω–µ—Å—Ç –íi–∫—Ç–æ—Ä–æ–≤–∏—á, 3487403339",4829,4829,4000000,4000000,980,0,0,4137146,True
v8jqVicvyZYnuzvM,1688632734,FDY*Merchandise,5399,5399,-137870,-137870,980,0,0,137146,False,E74M-36KX-B2BE-7PP6
9DO5CSiVAjG971HW,1688632665,–ó –±—ñ–ª–æ—ó –∫–∞—Ä—Ç–∫–∏,4829,4829,200000,200000,980,0,0,275016,True
i1cTiZh5DhdpBtoR,1688631826,Mates,5812,5812,-28400,-28400,980,0,0,75016,True,828B-5M22-563X-XM77
u2CaIYoomh_synPR,1688592768,Pethouse,5995,5995,-408200,-408200,980,0,3061,103416,False,CP6K-6CC6-7275-760P
B8vKFuffXorN5Nll,1688580360,–ê–≤—Ç–æ—Å—Ç–∞–Ω—Ü—ñ—è,5812,5812,-84500,-84500,980,0,0,511616,True,83MH-K1TE-1EMB-E82B
4AMaB4L8krQq2VAL,1688540837,Best way to cup,5814,5814,-25000,-25000,980,0,0,596116,False,B096-8KMX-203H-A59H
BkAwn-sH_Pf7mn30,1688539497,Best way to cup,5814,5814,-29500,-29500,980,0,0,621116,False,M34T-M97X-K243-9A03
Jsyvi7BDO5lUnu4l,1688491840,–°—ñ–ª—å–ø–æ,5411,5411,-31800,-31800,980,0,0,650616,False,TH86-C1T7-HAB0-9T3E
nyDgnm5xol6Phbdu,1688490562,–ï–ª–µ–∫—Ç—Ä–æ—Å–∞–º–æ–∫–∞—Ç–∏ Bolt,7999,7999,-5170,-5170,980,0,0,682416,False,2CEX-196B-M8T4-53X8
1tl4jZh6juZ12VJK,1688487967,Best way to cup,5814,5814,-8000,-8000,980,0,0,687586,False,2116-2H4X-B8HM-0K9A
pu489z0mqVfbjlbB,1688473442,FOP Sturova AS,5814,5814,-10000,-10000,980,0,0,695586,False,9KP3-1X9B-E34E-CT4P
8eCbhB2j2X93V2eF,1688419978,"Lifecell
+380631692598",4814,4814,-30000,-30000,980,0,0,705586,True,75PA-M195-273A-C0T5
-ys7axnxgAhKZ4X3,1688403022,Yaroslaviv Val 37-1,5921,5921,-29300,-29300,980,0,0,735586,False,4ATT-C3AB-8487-PH86
-aq-JNUacSH9Z5ut,1688402310,Ponchyk Boy,5812,5812,-26900,-26900,980,0,0,764886,True,K29E-3HH4-8718-KAH6
qLmGamRlRadjBf83,1688402157,–ï–ª–µ–∫—Ç—Ä–æ—Å–∞–º–æ–∫–∞—Ç–∏ Bolt,7999,7999,-1948,-1948,980,0,0,791786,False,44CE-85C6-MB2T-134A
NoBwHcUotlXgXtPK,1688401008,–ó–∞–º–æ–≤–ª–µ–Ω–Ω—è —ó–∂—ñ,5499,5499,-90205,-90205,980,0,0,793734,False,369A-6A14-K4H2-701A
HcYUWJMSDOkH4wFL,1688394894,LLC MC DOPOMOGA PLUS,8099,8099,-10000,-10000,980,0,75,883939,False,517K-364X-AX49-836C
x1GKFpopZkXSVtNk,1688374748,–ê–ø—Ç–µ–∫–∞ –ê–ù–¶,5912,5912,-4950,-4950,980,0,37,893939,False,KP1P-74PT-435X-PC42
DmGT259fP4XEmNbL,1688319733,Novus,5411,5411,-8799,-8799,980,0,0,898889,False,4X04-AB6C-E857-4C6H
PhXP9QYJNh6xxGAu,1688318698,OKKO,5541,5541,-165972,-165972,980,0,0,907688,False,79K2-6433-8BP0-2MH9
Tt6v95M8d6jMBl1s,1688307073,KAFE,5812,5812,-10000,-10000,980,0,0,1073660,False,5PXP-75CK-MK16-1888
9n8knE_SYMmtd2NP,1688304781,ZavodShop90,5944,5944,-50000,-50000,980,0,0,1083660,False,3M95-HKP3-M4P8-3PTT
uYCrlH8eQZCnS3BA,1688304640,ZavodShop90,5944,5944,-114800,-114800,980,0,0,1133660,False,06TA-H26C-CPTC-K3CP
4SsDJNdeLYRlZhIF,1688297728,–¢–∞–±–∞–∫–µ—Ä–∫–∞,5993,5993,-71000,-71000,980,0,0,1248460,False,66T3-P842-35A3-P525
GRe3dxNyVvy5QIfZ,1688297618,Novus,5411,5411,-32423,-32423,980,0,0,1319460,False,K53X-C8PK-3X23-X1T0
XuLaFUQP6QVUHP_z,1688295411,Best way to cup,5814,5814,-8000,-8000,980,0,0,1351883,False,986T-KT63-4T32-ETB2
DTKvAncQLaMMqEB4,1688294513,BWTC,5814,5814,-15000,-15000,980,0,0,1359883,False,X668-8AH1-KAHE-TB69
IRQJawwV1t6IvKqk,1688294501,Best way to cup,5814,5814,-20000,-20000,980,0,0,1374883,False,1548-5HAC-60H5-T80P
_g6MGDCPLDLvIoY8,1688233158,BWTC,5814,5814,-30500,-30500,980,0,0,1394883,False,H5K5-CMH2-2P11-7AM5
jgSQLZpxdCICa_BN,1688232272,LIQPAY*Kitajskij Privi,5812,5812,-50000,-50000,980,0,0,1425383,False,KTP6-7E3B-4A03-2942
UFjixGx33vrKC_e9,1688231611,–ê–ø—Ç–µ–∫–∞ –ê–ù–¶,5912,5912,-14700,-14700,980,0,0,1475383,False,A0XK-397E-B7A7-94M2
D3NJD6MYN_rnq8Nj,1688230065,One love coffee —Ü—É–º,7523,7523,-10000,-10000,980,0,0,1490083,False,ECK1-T1XB-KM5A-A533
hnZFB02RCcN799Fe,1688229917,Egersund Seafood,5411,5411,-44400,-44400,980,0,0,1500083,False,6H21-P2PH-EMXE-5B49
oO-MPS7ahG8FahRn,1688216829,–ï–ø—ñ—Ü–µ–Ω—Ç—Ä,5211,5211,-153620,-153620,980,0,0,1544483,False,1720-H39C-MME0-66A4
xyU-j3-asN86jPm2,1688201551,EasyPay,4816,4816,-41200,-41200,980,0,0,1698103,False,AX2K-6M8H-5570-6284
JNiOFiRf80tmOZgu,1688200375,Flowerbox,5992,5992,-56000,-56000,980,0,0,1739303,False,M4KC-K358-1X8B-X6CK
jXb__GEzDXqSpWep,1688194708,Best way to cup,5814,5814,-9500,-9500,980,0,0,1795303,False,0XE1-24MK-2BC6-X26X
iScbaKaY2TPwWlPE,1688159270,Novapay,8999,8999,-7000,-7000,980,0,0,1804803,False,5AMK-46K5-TBA5-B63C
7yIjrBxp7Tmydjd_,1690694462,–†–µ–≥—É–ª—è—Ä–Ω–µ –ø–æ–ø–æ–≤–Ω–µ–Ω–Ω—è ¬´–§–æ–Ω–¥ –ü–æ–≤–µ—Ä–Ω–∏—Å—å –∂–∏–≤–∏–º¬ª,4829,4829,-25000,-25000,980,0,0,645399,True
JvdkJ5W8zdcfXyKU,1690530689,–ó –ø–ª–∞—Ç–∏–Ω–æ–≤–æ—ó –∫–∞—Ä—Ç–∫–∏,4829,4829,100000,100000,980,0,0,670399,True
cb2M8Y0LCG9dJqxr,1690458295,–ö–∞—Å–∞ –£–Ωi–≤–µ—Ä—Å–∞–ª –ë–∞–Ω–∫—É,6010,6010,-10090000,-10090000,980,90000,0,570399,True,B967-02P3-2K61-0MM7
ICzyoc7IfjfK_MI3,1690458171,–ó –ø–ª–∞—Ç–∏–Ω–æ–≤–æ—ó –∫–∞—Ä—Ç–∫–∏,4829,4829,10000000,10000000,980,0,0,10660399,True
IsWjZA5EEGltUrvy,1690405421,–ü–æ–ø–æ–≤–Ω–µ–Ω–Ω—è ¬´–ù–∞ dji mavic 3 pro¬ª,4829,4829,-300000,-300000,980,0,0,660399,True,P892-3718-33X7-07CX
DiPUoqXA-tevYke-,1690353453,–ö–∞—Å–∞ –£–Ωi–≤–µ—Ä—Å–∞–ª –ë–∞–Ω–∫—É,6010,6010,-10090000,-10090000,980,90000,0,960399,True,3X73-XAM4-213T-AKPC
C3xxEOybZFY5a7xp,1690315235,–ó –ø–ª–∞—Ç–∏–Ω–æ–≤–æ—ó –∫–∞—Ä—Ç–∫–∏,4829,4829,10200000,10200000,980,0,0,11050399,True
ZXiltaw0kAy7rUvf,1690234793,–î–µ–Ω–∏—Å –ö.,–ö–Ω—è–∑—å üçª,4829,4829,-45000,-45000,980,0,0,850399,True,6A81-0442-60X3-325P
IT9UckfWe_TyPQKQ,1690234627,–ó –ø–ª–∞—Ç–∏–Ω–æ–≤–æ—ó –∫–∞—Ä—Ç–∫–∏,4829,4829,200000,200000,980,0,0,895399,True
8C5B36c5o6_wHro9,1690089657,–†–µ–≥—É–ª—è—Ä–Ω–µ –ø–æ–ø–æ–≤–Ω–µ–Ω–Ω—è ¬´–§–æ–Ω–¥ –ü–æ–≤–µ—Ä–Ω–∏—Å—å –∂–∏–≤–∏–º¬ª,4829,4829,-25000,-25000,980,0,0,695399,True
k9hariNOq3NzZhhV,1689922904,Lesya,4829,4829,-500000,-500000,980,0,0,720399,True,HC0X-K2CX-9K3E-8XPK
1v7Jgw0pC9cbVwh8,1689754650,–ü–æ–ø–æ–≤–Ω–µ–Ω–Ω—è ¬´–ù–∞ mavic 3T –¥–ª—è 6—ó —Ä¬ª,4829,4829,-200000,-200000,980,0,0,1220399,True,91M6-0B38-87P7-K47K
Q65iSNZJlQiENvta,1689669609,–ó –ø–ª–∞—Ç–∏–Ω–æ–≤–æ—ó –∫–∞—Ä—Ç–∫–∏,4829,4829,700000,700000,980,0,0,1420399,True
OZ_bukQKjoMPMqq0,1689597306,–ê—Ä–∫–∞–¥—ñ–π –û.,4829,4829,-125000,-125000,980,0,0,720399,True,9E9X-96E5-645K-KXX7
C3-WKItxxn4We5HP,1689484889,–†–µ–≥—É–ª—è—Ä–Ω–µ –ø–æ–ø–æ–≤–Ω–µ–Ω–Ω—è ¬´–§–æ–Ω–¥ –ü–æ–≤–µ—Ä–Ω–∏—Å—å –∂–∏–≤–∏–º¬ª,4829,4829,-25000,-25000,980,0,0,845399,True
WKCh5VKvLOYwo391,1689236026,–ó –ø–ª–∞—Ç–∏–Ω–æ–≤–æ—ó –∫–∞—Ä—Ç–∫–∏,4829,4829,400000,400000,980,0,0,870399,True
ebqgExQ8JzUoi4ki,1688992390,–ü–æ–ø–æ–≤–Ω–µ–Ω–Ω—è ¬´—Ç–µ–ø–ª–∏–∫ & –∫–∞–ø—Ü—ñ¬ª,4829,4829,-250000,-250000,980,0,0,470399,True,A982-78XX-M1P8-91PB
LlZWFyi_XBgrYQDJ,1688890827,–ó –ø–ª–∞—Ç–∏–Ω–æ–≤–æ—ó –∫–∞—Ä—Ç–∫–∏,4829,4829,300000,300000,980,0,0,720399,True
PG1Db6gzqHmeD8e3,1688880086,–†–µ–≥—É–ª—è—Ä–Ω–µ –ø–æ–ø–æ–≤–Ω–µ–Ω–Ω—è ¬´–§–æ–Ω–¥ –ü–æ–≤–µ—Ä–Ω–∏—Å—å –∂–∏–≤–∏–º¬ª,4829,4829,-25000,-25000,980,0,0,420399,True
pbaXRduj7tfZVr5X,1688632665,–ü–µ—Ä–µ–∫–∞–∑ –Ω–∞ –∫–∞—Ä—Ç–∫—É,4829,4829,-200000,-200000,980,0,0,445399,True
jFAqsI6CYUcXZfLt,1688382451,–ü–æ–ø–æ–≤–Ω–µ–Ω–Ω—è ¬´–ù–∞ –Ω–∞–∑–µ–º–Ω—ñ –¥—Ä–æ–Ω–∏¬ª,4829,4829,-100000,-100000,980,0,0,645399,True,4K75-9TP6-5CEC-0P81
PdyJrc18a1d-dC5I,1688264630,–†–µ–≥—É–ª—è—Ä–Ω–µ –ø–æ–ø–æ–≤–Ω–µ–Ω–Ω—è ¬´–§–æ–Ω–¥ –ü–æ–≤–µ—Ä–Ω–∏—Å—å –∂–∏–≤–∏–º¬ª,4829,4829,-25000,-25000,980,0,0,745399,True
46iRmC24TMAsEGM8jw,1693423626,–ï–ª–µ–∫—Ç—Ä–æ—Å–∞–º–æ–∫–∞—Ç–∏ Bolt,7999,7999,-3026,-3026,980,0,0,2052247,False,1AT5-HMM6-XH7X-M9CC
reA2NI1QVrNdNInq_g,1693419967,–ü–µ—Ä–µ–∫–∞–∑ –Ω–∞ –∫–∞—Ä—Ç–∫—É,4829,4829,-10000,-267,840,0,0,2055273,True
hV-Fz1nfjuLjLVyhJw,1693412635,–ï–ª–µ–∫—Ç—Ä–æ—Å–∞–º–æ–∫–∞—Ç–∏ Bolt,7999,7999,-2219,-2219,980,0,0,2065273,False,67EP-XH07-PT76-M67C
bMGuz5ZAM2NoGATSDQ,1693407597,Libid,5814,5814,-5000,-5000,980,0,100,2067492,False,T474-4XB7-K9B3-B45A
8O3Fnhq15EiJeDBdNg,1693382090,"Lifecell
+380631692598",4814,4814,-24000,-24000,980,0,0,2072492,True,CP9X-TM88-0944-2PC6
cd-YLdGiUxXrreBjuw,1693379971,ZOO–ª—é–∫—Å,5995,5995,-40000,-40000,980,0,0,2096492,False,XE07-74BT-T430-A1P0
OuLVl1eAHppqWYmjcATJPA,1693351874,–ï–ª–µ–∫—Ç—Ä–æ—Å–∞–º–æ–∫–∞—Ç–∏ Bolt,7999,7999,-2827,-2827,980,0,0,2136492,True
K85tGNW5dN1zJxnq4zbte7w2_DU,1693351874,–°–∫–∞—Å—É–≤–∞–Ω–Ω—è. –ï–ª–µ–∫—Ç—Ä–æ—Å–∞–º–æ–∫–∞—Ç–∏ Bolt,7999,7999,15000,15000,980,0,0,2139319,False
bEDOK9TrTwc5k8fgQQ,1693329993,–°—ñ–ª—å–ø–æ,5411,5411,-39545,-39545,980,0,0,2124319,False,BKPC-KTH2-KAAP-7K9B
C8G-CdoBZ6bJpHO6WQ,1693302474,–ü–µ—Ä–µ–∫–∞–∑ –Ω–∞ –∫–∞—Ä—Ç–∫—É,4829,4829,-600000,-600000,980,0,0,2163864,True
p6BF3Fiz7EC_CJGl6Q,1693300140,–íi–¥: –ü–†–ò–•–û–î–¨–ö–û –ï.–í. –§–û–ü,"–î–ª—è –ø–æ–ø–æ–≤–Ω–µ–Ω–Ω—è –∫–∞—Ä—Ç–∫–∏ 5375414101190360, –ü—Ä–∏—Ö–æ–¥—å–∫–æ –ï—Ä–Ω–µ—Å—Ç –íi–∫—Ç–æ—Ä–æ–≤–∏—á, 3487403339",4829,4829,2600000,2600000,980,0,0,2763864,True
FXJPsHRJVUIGfxbC8A,1693289486,–û–±—Å–ª—É–≥–æ–≤—É–≤–∞–Ω–Ω—è –ø–ª–∞—Ç–∏–Ω–æ–≤–æ—ó –∫–∞—Ä—Ç–∫–∏,4829,4829,-30000,-30000,980,0,0,163864,True
ea3g-WjV9R6XlU05yA,1693255533,FDY*Merchandise,5399,5399,-48590,-48590,980,0,0,193864,False,B930-ET07-T6E7-M65H
j3JoEyDgKAIgALRDWQ,1693247873,"Knigarnya""Sens""",5942,5942,-45000,-45000,980,0,0,242454,False,T7B6-0BH9-3BPX-E21K
a5UzLXlHFeq1Yw4VKg,1693247726,"Knigarnya""Sens""",5942,5942,-5000,-5000,980,0,0,287454,False,3H51-HC11-0457-EC7T
viSK2Ls9YD9x5qzInw,1693244638,Cafe 128|2,5812,5812,-108000,-108000,980,0,810,292454,True,5962-4840-088A-E729
QNR8U2AvU-6QK0QcHQ,1693244278,Cafe 128|2,5812,5812,-84200,-84200,980,0,631,400454,True,H3CT-4BA2-0A65-H490
rYgmkxENG59jZ6jlPQ,1693157280,LIQPAY*ZL Vet,742,742,-70000,-70000,980,0,0,484654,False,03E6-0T28-EC7X-697C
x8qkPksUqIkqe2UidA,1693155797,TOBAKKO-SERVIS,5499,5499,-81900,-81900,980,0,0,554654,False,42CB-6KA3-7HME-6H4B
sL2QoqU6y-WLCoTK_w,1693153752,–°—ñ–ª—å–ø–æ,5411,5411,-107982,-107982,980,0,0,636554,False,4B88-9AC5-224H-1900
SrN1MXSxs7qjr_0ELw,1693153476,SECHST,5912,5912,-17896,-17896,980,0,0,744536,False,E00M-P98B-7C88-KM29
_EOZr4F69mY3y1lcCg,1693152419,Ukrkhalial,5499,5499,-96460,-96460,980,0,0,762432,False,9T65-8K2B-71K7-C20M
MYVrm-Tpt-oLSJTy-w,1693147650,AVANGARDEN,5812,5812,-96500,-96500,980,0,723,858892,True,2ET1-5560-E88M-22XX
zRkiJsp7W8k8TiHhIg,1693134626,–û—Ñ—ñ—Å-—á–∞–π,5812,5812,-32100,-32100,980,0,240,955392,True,40HB-3T28-4A18-EM24
pTMCH0X7NIfiClrwoA,1693123542,–ï–ª–µ–∫—Ç—Ä–æ—Å–∞–º–æ–∫–∞—Ç–∏ Bolt,7999,7999,-2667,-2667,980,0,0,987492,False,01MC-E1K3-XX64-3E80
cy09tGxlnGw6oIgvSQ,1693123225,–ï–ª–µ–∫—Ç—Ä–æ—Å–∞–º–æ–∫–∞—Ç–∏ Bolt,7999,7999,-15000,-15000,980,0,0,990159,False
_rTbj7b1L7EyBXEtJg,1693118524,Pethouse,5995,5995,-453600,-453600,980,0,0,1005159,False,76TB-AM9K-2TK9-4713
3ova2EkJ6B1QTG87Eg,1693070739,–°—ñ–ª—å–ø–æ,5411,5411,-59776,-59776,980,0,0,1458759,False,M3A9-7159-BACA-4HTA
EZ1cMsH3H6sFMzcTvg,1693069095,–ó–∞–º–æ–≤–ª–µ–Ω–Ω—è —ó–∂—ñ,5499,5499,-91890,-91890,980,0,0,1518535,False,MT4B-6734-P77E-9HB7
Pfc-s7wicXmNrWUScg,1693052062,#—Ö–ª—ñ–±—Ç–∞—É–Ω,5462,5462,-9500,-9500,980,0,0,1610425,False,XAK5-P69M-P5BC-06P8
wUKU7ViLFLsOrdWktg,1693049912,AstroCoffeeBar,5814,5814,-6000,-6000,980,0,45,1619925,False,PT67-2KPP-197H-2T51
cmeWhMs35TXyjvcFsw,1693049574,AstroCoffeeBar,5814,5814,-29500,-29500,980,0,221,1625925,False,9C9M-PCE6-93AH-X8XX
rIKvJkE0hRdILnOL3A,1693041618,–ê–ø—Ç–µ–∫–∞ –ê–ù–¶,5912,5912,-125780,-125780,980,0,0,1655425,False,K716-P64C-PKHA-XAE6
i0SRyl8zYkrkliEyCw,1693033507,Bestwaytocup,5814,5814,-22000,-22000,980,0,165,1781205,False,K96B-5138-HAPE-P271
kCbyimgQ6NG9qLZplg,1692978487,–°—ñ–ª—å–ø–æ,5411,5411,-52900,-52900,980,0,0,1803205,False,M718-5M06-MP50-4C06
D5sYT23X4vsLDOpwzg,1692978400,–°—ñ–ª—å–ø–æ,5411,5411,-56884,-56884,980,0,0,1856105,False,P182-HP0A-H01B-729M
XcJQrnm7V5KszqCezg,1692958591,PETSALON GAVRYK,7299,7299,-39900,-39900,980,0,0,1912989,False,7MH1-87HE-0PBE-8KXC
7PRlBoUrI7WunGxUqA,1692952092,CRUMB,5977,5977,-234000,-234000,980,0,0,1952889,True,E01A-8XH7-3M0M-ABPX
eM6FLXCSBQ4u7G7mjA,1692951743,–ü–µ—Ä–µ–∫–∞–∑ –Ω–∞ –∫–∞—Ä—Ç–∫—É,4829,4829,-300000,-300000,980,0,0,2186889,True
k4iLCFQbDVmofZ6eWw,1692905520,–°—ñ–ª—å–ø–æ,5411,5411,-37390,-37390,980,0,0,2486889,False,2MX8-BPB0-P500-8EC4
JvCzeINZcI2cr0kkLw,1692904750,OKKO,5541,5541,-243912,-243912,980,0,0,2524279,False,945M-M99P-4AAC-217C
vD2BGc6CJ5o6m6PmCA,1692894630,Pitstsa Fritta,5811,5811,-16000,-16000,980,0,320,2768191,False,6KH9-9X74-3235-05BE
yvqqi57VvFSCTWx3bg,1692893884,–ï–ª–µ–∫—Ç—Ä–æ—Å–∞–º–æ–∫–∞—Ç–∏ Bolt,7999,7999,-2014,-2014,980,0,0,2784191,False,4B2X-HXHM-1EBX-C59B
DnFy6VCc77sqiB3eLQ,1692893597,–ú–∞–∫—Å–∏–º –ì.,4829,4829,-7000,-7000,980,0,0,2786205,True,8H6A-4PC3-7X2P-06KB
rtvZBkeTw1Q_d6i9Eg,1692893551,FOP Kovtun VV,5814,5814,-19000,-19000,980,0,380,2793205,False,BK62-4K02-1AA9-3A5X
AikFhKUOcn7Os1s5Rg,1692893537,Bilyardna,5814,5814,-19700,-19700,980,0,394,2812205,False,BE40-5E68-83PX-AE27
-dInSWCIUGudVfGerg,1692891025,LIQPAY*FOP Minenko Yul,5941,5941,-197880,-197880,980,0,0,2831905,False,68MC-B152-H39T-K8AA
NhLF0o7LSCh8HBgAsg,1692890884,–ï–ª–µ–∫—Ç—Ä–æ—Å–∞–º–æ–∫–∞—Ç–∏ Bolt,7999,7999,-2288,-2288,980,0,0,3029785,False,XM68-7MPE-EB2C-MMPE
itmA0m3vNvsPG6EJHA,1692876784,–°—ñ–ª—å–ø–æ,5411,5411,-15700,-15700,980,0,0,3032073,False,C7T2-K24H-K6B2-MA56
PnH27CFweOx8LfN3IQ,1692874771,–ú—ñ—Å—å–∫–∞ –á–¥–∞–ª—å–Ω—è,5814,5814,-10000,-10000,980,0,200,3047773,False,B2M8-4B67-A4KA-3T9H
ga9qefbRXFvj3_dSSg,1692871781,magazin 762597,5912,5912,-67730,-67730,980,0,0,3057773,False,214X-PEK7-P0X5-02T8
44IeJjl72Kqjs2G9Sg,1692871642,Novapay,8999,8999,-7000,-7000,980,0,0,3125503,False,176M-29XK-2EEX-H5T9
cW9ZvIF6I0-rLKaq2Q,1692871571,–ï–ª–µ–∫—Ç—Ä–æ—Å–∞–º–æ–∫–∞—Ç–∏ Bolt,7999,7999,-4289,-4289,980,0,0,3132503,False,AP96-35XT-92EE-EE0C
5MyRhU9Zp8kr6IjLrw,1692869361,–ï–ª–µ–∫—Ç—Ä–æ—Å–∞–º–æ–∫–∞—Ç–∏ Bolt,7999,7999,-3710,-3710,980,0,0,3136792,False,MM44-255C-1784-5E84
KrHQj6sZhWNiSDM1RQ,1692868736,t.c.pizza,5812,5812,-40200,-40200,980,0,804,3140502,True,A49P-60EE-5EKK-H999
vA_uOsG8eMMKmus0dg,1692867675,Leilia Bakery,5814,5814,-26500,-26500,980,0,530,3180702,False,A633-HK6X-BA0X-01KP
2SSb-_ewZOf9K7Mavg,1692865257,–ï–ª–µ–∫—Ç—Ä–æ—Å–∞–º–æ–∫–∞—Ç–∏ Bolt,7999,7999,-2075,-2075,980,0,0,3207202,False,TM80-76K4-01CT-H5E7
EwBkc-91cxkZ1ce9AQ,1692862989,–íi–¥: –ü–†–ò–•–û–î–¨–ö–û –ï.–í. –§–û–ü,"–î–ª—è –ø–æ–ø–æ–≤–Ω–µ–Ω–Ω—è –∫–∞—Ä—Ç–∫–∏ 5375414101190360, –ü—Ä–∏—Ö–æ–¥—å–∫–æ –ï—Ä–Ω–µ—Å—Ç –íi–∫—Ç–æ—Ä–æ–≤–∏—á, 3487403339",4829,4829,3000000,3000000,980,0,0,3209277,True
rng7mruf5LLqcm2dDA,1692857866,Best way to cup,5814,5814,-8500,-8500,980,0,63,209277,False,H47H-KT0A-4KH7-APK4
yr3sq9cAamRowaA09g,1692857824,Best way to cup,5814,5814,-9500,-9500,980,0,71,217777,False,A68X-E838-86PH-XC65
dQu4SZPzXaDb8ZyBtA,1692806674,Bubbly,5814,5814,-9500,-9500,980,0,71,227277,False,KAKB-83K0-KMMM-HH3C
QmvpZFA502v_um3Odg,1692805225,–ú—ñ—Å—å–∫–∞ –á–¥–∞–ª—å–Ω—è,5814,5814,-13000,-13000,980,0,97,236777,False,K58E-ET3M-21X2-M2B8
J6s-iV8KwvM_YlBghQ,1692774056,Dragomanov fit,7997,7997,-3000,-3000,980,0,0,249777,False,H4B4-1XM0-TA3P-1HT4
aAELs8Y2lftBXv3wXw,1692772402,Best way to cup,5814,5814,-12000,-12000,980,0,90,252777,False,6HCH-4XEB-T196-B3BE
eDE_EA9wigVg9dXySA,1692770770,Best way to cup,5814,5814,-7000,-7000,980,0,52,264777,False,3T9H-3XA9-E54H-0938
lUFp-qRHyrPsy4YefNPk,1692749665,–ï–ª–µ–∫—Ç—Ä–æ—Å–∞–º–æ–∫–∞—Ç–∏ Bolt,7999,7999,-2466,-2466,980,0,0,271777,True
kjIvwfMvx-7T9H_m8mLMpr4ektE,1692749665,–°–∫–∞—Å—É–≤–∞–Ω–Ω—è. –ï–ª–µ–∫—Ç—Ä–æ—Å–∞–º–æ–∫–∞—Ç–∏ Bolt,7999,7999,15000,15000,980,0,0,274243,False
30Xv3rzImR_esBieUg,1692731679,ZOOHUB,5995,5995,-41900,-41900,980,0,0,259243,True,5TT6-PKK2-TAA7-4MAA
Iy0RNZAuBicTG5qV0A,1692721726,Bolt,4121,4121,-16500,-16500,980,0,0,301143,False,1PM7-T4C6-34MK-48B0
Z18lLNrb-FY8ApHA0Q,1692698642,OK Wine,5921,5921,-71400,-71400,980,0,0,317643,False,892E-18P5-71BX-4K7X
pge-jYH5p3hMb7TxYA,1692697532,Best way to cup,5814,5814,-8500,-8500,980,0,63,389043,False,0BEE-KMBA-448A-5909
es3ojt2yM0TRS67bng,1692696339,–ú—ñ—Å—å–∫–∞ –á–¥–∞–ª—å–Ω—è,5814,5814,-43500,-43500,980,0,326,397543,False,283T-BH90-49B1-XBXB
4n4P83AwRf87X2S20g,1692694302,Yaroslaviv Val 37-1,5921,5921,-21810,-21810,980,0,0,441043,False,083B-T1EK-E700-11B9
FjldHhN7vKOj9Or_Sg,1692691893,–ö–∏—ó–≤—Å—å–∫–µ –º–µ—Ç—Ä–æ,4111,4111,-800,-800,980,0,0,462853,False,BCM9-335M-14A7-M2K8
mAu-8YciN2uIDdZ9UlL-yg,1692572731,–ï–ª–µ–∫—Ç—Ä–æ—Å–∞–º–æ–∫–∞—Ç–∏ Bolt,7999,7999,-4480,-4480,980,0,0,463653,True
zfWERxeil6q2_H8g4rGs_0XJjeQ,1692572731,–°–∫–∞—Å—É–≤–∞–Ω–Ω—è. –ï–ª–µ–∫—Ç—Ä–æ—Å–∞–º–æ–∫–∞—Ç–∏ Bolt,7999,7999,15000,15000,980,0,0,468133,False
J0HPfHqpJIX2Gdokkg,1692544247,–í—ñ–¥: –ú–∏–∫–æ–ª–∞ –û–≥–æ–π–∫–æ,4829,4829,90000,90000,980,0,0,453133,True
_88P8kVSE6zSVp0lmg,1692544150,Mates,5812,5812,-195800,-195800,980,0,1468,363133,True,72HP-PK96-A6CX-KMEX
8cGM1IJLrXr9qNiQ4g,1692543718,Market delvi,5499,5499,-5490,-5490,980,0,0,558933,False,A41E-BB5M-5CTK-3M21
uHluaYA_4sjRLpYAXg,1692538373,–ï–ª–µ–∫—Ç—Ä–æ—Å–∞–º–æ–∫–∞—Ç–∏ Bolt,7999,7999,-3272,-3272,980,0,0,564423,False,CPX8-PE41-PHKK-375H
nmds6oPjjws7SAHfng,1692538111,–ï–ª–µ–∫—Ç—Ä–æ—Å–∞–º–æ–∫–∞—Ç–∏ Bolt,7999,7999,-15000,-15000,980,0,0,567695,False
ZIITA28NBbeL1ksTgw,1692538073,–°–∫–∞—Å—É–≤–∞–Ω–Ω—è. –ï–ª–µ–∫—Ç—Ä–æ—Å–∞–º–æ–∫–∞—Ç–∏ Bolt,7999,7999,15000,15000,980,0,0,582695,False
vxuYo432B2JlDPbE-Q,1692537985,–ï–ª–µ–∫—Ç—Ä–æ—Å–∞–º–æ–∫–∞—Ç–∏ Bolt,7999,7999,-15000,-15000,980,0,0,567695,False
ahl7yddgLLeny3CTkQ,1692517451,–°—ñ–ª—å–ø–æ,5411,5411,-45389,-45389,980,0,0,582695,False,CCH5-AE7K-AK2H-876K
HCtuz8B3bEEbNRTZZQ,1692515248,Best way to cup,5814,5814,-8000,-8000,980,0,60,628084,False,65E7-THAA-2M2T-8AE5
xVTvC_mJHKnCEWlNZA,1692513780,AstroCoffeeBar,5814,5814,-17000,-17000,980,0,127,636084,False,873B-84TM-9231-C04B
bgZZIiTAIHnL2YmOJw,1692450552,OK Wine,5411,5411,-6000,-6000,980,0,0,653084,False,64BP-KABB-545K-3ABA
VtZsXEe7ZaL-kQ37Nw,1692450528,magazin 762597,5912,5912,-192940,-192940,980,0,0,659084,False,2335-EPTM-C1KC-3B04
F_uiSs6xS-tKJKILAg,1692445673,Novapay,8999,8999,-7000,-7000,980,0,0,852024,False,3H80-06CT-7BBA-C16C
uWibamJSUA2ANX3zKA,1692436217,–ü–∞—Ä–∫–æ–≤–∫–∞,7523,7033,-3000,-3000,980,0,0,859024,False,465B-3K6X-0E42-AKAH
XRNs678RDu89GEYe7w,1692435627,Roshen,5441,5441,-15569,-15569,980,0,0,862024,False,12H0-822X-4KA8-H8H4
l-vb9N4-Ox4sTRezqg,1692432617,Pethouse,5995,5995,-272100,-272100,980,0,0,877593,False,209T-A6TB-2P30-3T9P
GtpUEDEcVumHVLeZ8w,1692427195,–°—ñ–ª—å–ø–æ,5411,5411,-27117,-27117,980,0,0,1149693,False,M4K4-883B-647E-8M8M
q9VU4fLY842zl55w8w,1692426948,SECHST,5912,5912,-67265,-67265,980,0,0,1176810,False,3CC3-PK4P-EE17-P7K4
F84K7_PZZXdIAuuQZg,1692369642,magazin 762597,5912,5912,-62030,-62030,980,0,0,1244075,False,X00B-CCB4-P026-K4BE
XSwm6DCW4SdJEIWaRg,1692356137,FDY*Merchandise,5399,5399,-103790,-103790,980,0,0,1306105,False,XPXM-08CP-T6BX-M6P3
CiLUZiK5no6Pq1oXAA,1692351260,MasterZoo,5995,5995,-32500,-32500,980,0,1625,1409895,False,KKAE-705P-HKB8-T15E
wrcplqicVmAZlt3uyQ,1692350324,–£–∫—Ä–∞—ó–Ω—Å—å–∫–∏–π –¥—ñ–º,7399,7399,-10000,-10000,980,0,0,1442395,False,02M2-35BK-B8CB-79KE
KsV2uqJKK2CANzBw-g,1692345804,DP UKRAYINSKYJ DIM,7399,7399,-20000,-20000,980,0,0,1452395,False,X907-T504-H47E-3A14
R8u0Ed_TeHimCukvOQ,1692345503,–ï–ª–µ–∫—Ç—Ä–æ—Å–∞–º–æ–∫–∞—Ç–∏ Bolt,7999,7999,-4206,-4206,980,0,0,1472395,False,04BK-4465-A837-B2KX
vacJl_M_f4FWXrqR7w,1692344925,–ï–ª–µ–∫—Ç—Ä–æ—Å–∞–º–æ–∫–∞—Ç–∏ Bolt,7999,7999,-15000,-15000,980,0,0,1476601,False
mq_ZHAr_kOK6zQ1D-w,1692338700,Best way to cup,5814,5814,-25500,-25500,980,0,191,1491601,False,607A-76X7-7PXK-B9H7
Knuv94LZx9T1-RSRCg,1692288144,Best way to cup,5814,5814,-19500,-19500,980,0,146,1517101,False,E56H-EKT1-8BBH-8A24
mYy_-Z__skYiRqQjbQ,1692286076,SHOPSILPO,5411,5411,-191350,-191350,980,0,0,1536601,False,KM78-3A0H-0BHH-82M9
78OgEyHSAPA7Ajsx,1692262835,–ï–ª–µ–∫—Ç—Ä–æ—Å–∞–º–æ–∫–∞—Ç–∏ Bolt,7999,7999,-3145,-3145,980,0,0,1727951,False,1E96-2C8K-3PBT-2B07
BlZKuAP5t0GP_g86,1692262142,–ï–ª–µ–∫—Ç—Ä–æ—Å–∞–º–æ–∫–∞—Ç–∏ Bolt,7999,7999,-5095,-5095,980,0,0,1731096,False,8X9C-51H7-153P-8MH5
ZwKdoHVccYixaz84,1692256163,Novus,5411,5411,-35756,-35756,980,0,0,1736191,False,BX4P-XH33-PP59-2B56
YsOhf6WcoiJPKx5A,1692203862,5045Kavjarnja,5814,5814,-12500,-12500,980,0,93,1771947,False,569C-09P9-2CXP-AKC6
lYBwu7TMo79vFSje,1692178816,–°—ñ–ª—å–ø–æ,5411,5411,-9156,-9156,980,0,0,1784447,False,8K31-B5B1-1063-XHMK
Jl-1zMz2X_0kbImU,1692178317,Bolt,4215,4215,-89200,-89200,980,0,0,1793603,False,8T98-6KPH-733P-T4HM
PvUxoyRldxoq64Ux,1692168954,–°—ñ–ª—å–ø–æ,5411,5411,-35800,-35800,980,0,0,1882803,False,P738-4487-EX53-2A25
VOom0N9UZad7zaYO,1692118964,Konteiner,5814,5814,-8000,-8000,980,0,60,1918603,False,KM1T-3HAX-XT0K-XP11
gygzxWqmVsbFdQjF,1692114148,–û—Ñ—ñ—Å-—á–∞–π,5812,5812,-17900,-17900,980,0,134,1926603,True,1732-P4B9-0EE8-B470
VAVAsImB58O-FRYS,1692113370,Novapay,8999,8999,-5500,-5500,980,0,0,1944503,False,AEKB-TB12-1X6P-14BA
TiXgHFS_pBQRsPDE,1692083697,–°—ñ–ª—å–ø–æ,5411,5411,-14400,-14400,980,0,0,1950003,False,BKB3-0T90-3CPT-TE85
BD8Z344KdQGR5ecu,1692029320,–û—Ñ—ñ—Å-—á–∞–π,5812,5812,-52000,-52000,980,0,595,1964403,True,5M04-8B8E-2AME-E8P2
g3BkMPieTWx4QPr5,1692007046,Libid,5814,5814,-8000,-8000,980,0,160,2016403,False,P206-2K7X-AAA9-577E
TX2lSgAWLODkH8qf,1692006390,–°—ñ–ª—å–ø–æ,5411,5411,-29037,-29037,980,0,0,2024403,False,41K0-463M-KK90-K0M9
PYiW_NVkgutFp77I,1692001734,–íi–¥: –ü–†–ò–•–û–î–¨–ö–û –ï.–í. –§–û–ü,"–î–ª—è –ø–æ–ø–æ–≤–Ω–µ–Ω–Ω—è –∫–∞—Ä—Ç–∫–∏ 5375414101190360, –ü—Ä–∏—Ö–æ–¥—å–∫–æ –ï—Ä–Ω–µ—Å—Ç –íi–∫—Ç–æ—Ä–æ–≤–∏—á, 3487403339",4829,4829,1300000,1300000,980,0,0,2053440,True
6aDek8IrNvCCEUws,1691995038,VeterinarniyshpitalGen,742,742,-210000,-210000,980,0,0,753440,False,C0HT-E4CC-0BHH-75M6
OnYD_zFGYe4ou20d,1691931662,Flowerbox,5992,5992,-54000,-54000,980,0,405,963440,False,X358-6557-1775-5TPA
qFepgcYuVdLKMqe6,1691931116,–ê–ø—Ç–µ–∫–∞ –ê–ù–¶,5912,5912,-63480,-63480,980,0,0,1017440,False,4PH1-0PBT-51A2-PMH2
aGCWgmK6u5X6wRrJ,1691927056,ZOOLYUKS,5995,5995,-114300,-114300,980,0,0,1080920,False,M2M6-1XK4-A2E7-4E0T
37ohqG7G4b03BwQ2,1691923179,Novus,5411,5411,-35424,-35424,980,0,0,1195220,False,TP2C-86B1-5780-6172
r0151Yb8c8ERJDrE,1691907676,Best way to cup,5814,5814,-33010,-33010,980,0,247,1230644,False,E365-9X2X-EC20-A73P
qgDjSt9hIOGVBKSX,1691907467,–¢–∞–±–∞–∫–µ—Ä–∫–∞,5993,5993,-156000,-156000,980,0,0,1263654,False,BCK6-CP72-HP13-E560
7ajD4ngHqFWcVy0q5RPR9w,1691884307,"–°–∫–∞—Å—É–≤–∞–Ω–Ω—è. FDY*INFORMATION,KYIV,UA",7375,7375,100,100,980,0,0,1419654,False
osCaSgD552GOeXgM,1691856823,–°—ñ–ª—å–ø–æ,5411,5411,-140760,-140760,980,0,0,1419554,False,ETX2-KEHM-TPP3-THKK
5dD8Zvd0mJyGvJKb,1691830461,–ë–æ—Ç—Å–∞–¥ —ñ–º. –ú.–ì—Ä–∏—à–∫–æ,7998,7998,-10000,-10000,980,0,0,1560314,False,KM8A-9HKX-0AP8-15EM
tfFR1OrBNs4IculK,1691819525,–ú–µ–¥–∏—á–Ω–∞ –ª–∞–±–æ—Ä–∞—Ç–æ—Ä—ñ—è ¬´–î—ñ–ª–∞¬ª,8062,8099,-30000,-30000,980,0,0,1570314,False,K73T-5859-A8C6-5X5B
OH_QEROME0UvgI-O,1691769902,–ö–æ–ª–æ,5411,5499,-6700,-6700,980,0,0,1600314,False,9PCE-97T3-TXKM-H0PT
s5nD_MsnaxNKOZ9o,1691767525,–ó–∞–º–æ–≤–ª–µ–Ω–Ω—è —ó–∂—ñ,5499,5499,-58275,-58275,980,0,0,1607014,False,K77K-M1AM-6X1E-TB51
IVCSzu2yAlkozMu1,1691747197,–°—ñ–ª—å–ø–æ,5411,5411,-9296,-9296,980,0,0,1665289,False,BTTT-798T-P8KH-X60P
6iPeV24vL7rVOP0t,1691737204,Best way to cup,5814,5814,-7000,-7000,980,0,52,1674585,False,1AP8-K9M1-HA3E-13EM
dPGX4oPO0UdWW-I6,1691735240,Best way to cup,5814,5814,-18500,-18500,980,0,138,1681585,False,HKC5-E34T-T749-A367
SloHZkl0c8if0Z_p,1691735092,Best way to cup,5814,5814,-7000,-7000,980,0,52,1700085,False,H1KC-464H-P9CE-K67T
3P24hVZ_DPcF1gOC,1691695067,–ï–ª–µ–∫—Ç—Ä–æ—Å–∞–º–æ–∫–∞—Ç–∏ Bolt,7999,7999,-4401,-4401,980,0,0,1707085,False,T9HE-2K8E-9017-5X4T
PvEiRTNo0CZ5Etqa,1691692404,Varvar Bar | –ö–∏—ó–≤,5812,5812,-266700,-266700,980,0,2000,1711486,True,7P7E-33MK-H71E-K080
QzXDDJ4qVjJo1eZK,1691684022,–ï–ª–µ–∫—Ç—Ä–æ—Å–∞–º–æ–∫–∞—Ç–∏ Bolt,7999,7999,-3717,-3717,980,0,0,1978186,False,K97B-A404-MPM9-AX7E
xJA-TUxvWw4WGeao,1691682711,Food factor,5499,5499,-10500,-10500,980,0,0,1981903,False,M48B-5BXH-07MA-K17B
cUBw-KJPIYuVsg1a,1691662280,–û—Ñ—ñ—Å-—á–∞–π,5812,5812,-29400,-29400,980,0,493,1992403,True,9P89-A2B7-MCP3-9TAX
wUjtn7xeXlN65yX5,1691662153,–í–ê–†–¶–ê–ë,5814,5814,-84500,-84500,980,0,1690,2021803,False,9H46-C602-BT55-4834
_mJ8SBohrPOi_HxD,1691581790,–ü–µ—Ä–µ–∫–∞–∑ –Ω–∞ –∫–∞—Ä—Ç–∫—É,4829,4829,-1600000,-1600000,980,0,0,2106303,True
D_FCTI68Z_XyyPyF,1691580550,–°—ñ–ª—å–ø–æ,5411,5411,-49506,-49506,980,0,0,3706303,False,388A-50K9-4E7M-XX16
ljf60NOT4apuGlZK,1691577254,Libid,5814,5814,-8000,-8000,980,0,160,3755809,False,P236-4KTK-KA52-99MM
JsbCijjPbSPmoOwn,1691574881,–íi–¥: –ü–†–ò–•–û–î–¨–ö–û –ï.–í. –§–û–ü,"–î–ª—è –ø–æ–ø–æ–≤–Ω–µ–Ω–Ω—è –∫–∞—Ä—Ç–∫–∏ 5375414101190360, –ü—Ä–∏—Ö–æ–¥—å–∫–æ –ï—Ä–Ω–µ—Å—Ç –íi–∫—Ç–æ—Ä–æ–≤–∏—á, 3487403339",4829,4829,3700000,3700000,980,0,0,3763809,True
OKG8K4FQR3ChZbRR,1691572693,–ü–∞—Ä–∫–æ–≤–∫–∞,7523,7523,-8000,-8000,980,0,0,63809,False,6PKX-09EB-C1A4-EKP3
1gUw0Brg2u3_IK6y,1691572468,SHOP KIKO MILANO 4,5977,5977,-58900,-58900,980,0,0,71809,False,CTC7-62TP-EMP5-CKB8
MG4GdZVqXoMufg4_,1691571305,SALON KRASY BAKSTAGE,7230,7230,-54000,-54000,980,0,0,130709,False,H7B5-BM83-17H4-MTB1
j2FqZjYL7y0dH8vB,1691569402,FDY*TAXICABS-S,4121,4121,-16100,-16100,980,0,0,184709,False,0MAE-63K0-P2MM-58H8
_e00_bh23uPEqTgE,1691569292,VeterinarniyshpitalGenesi,742,742,-270000,-270000,980,0,0,200809,False,6MM0-935T-649C-6EBC
9vfwU6vOBkW0vQbl,1691569260,–ó –±—ñ–ª–æ—ó –∫–∞—Ä—Ç–∫–∏,4829,4829,300000,300000,980,0,0,470809,True
VLzJaRJjCpNeypzZ,1691567309,Fresh Dzhus end Babl T,5812,5812,-20500,-20500,980,0,153,170809,False,3T4H-65T0-8220-EPKP
heymfTHhhwdyW3sC,1691565881,FDY*TAXICABS-S,4121,4121,-17300,-17300,980,0,0,191309,False,4EK1-H704-CB4H-TB31
3AjrfPa5n4qxp5aM,1691564308,"Vodafone
+380978495150",4814,4814,-20000,-20000,980,0,0,208609,True,536B-H3TH-4E0T-X07H
VFemVqnZqJ4OkPNk,1691526982,–Ü–Ω—Ñ–æ—Ä–º–∞—Ü—ñ–π–Ω—ñ –ø–æ—Å–ª—É–≥–∏,7375,7375,-100,-100,980,0,0,228609,False
Lk9BrdLaovLocksv,1691516738,30880,5912,5912,-17400,-17400,980,0,0,228709,False,TAA8-B60P-E40K-4786
wJZRfiusoFVl85dS,1691512107,–°—ñ–ª—å–ø–æ,5411,5411,-123247,-123247,980,0,0,246109,False,15M7-25EE-8P64-7P1C
M8MSPd6ApaW8ZJA-,1691488978,Libid,5814,5814,-19500,-19500,980,0,146,369356,False,2054-8118-0XB4-CTT0
fBtGW0kUtCUP90rZ,1691478193,–ü–∞—Ä–∫–æ–≤–∫–∞,7523,7033,-3000,-3000,980,0,0,388856,False,X07C-K5B1-KCC5-7764
HgkbCSnvttS-_9u2,1691438402,FDY*Merchandise,5399,5399,-59810,-59810,980,0,0,391856,False,T1K5-0A9K-7141-E612
bWUUk9soBRq9NEGA,1691437601,Pethouse,5995,5995,-362800,-362800,980,0,0,451666,False,A0XX-CC19-7P8A-T4TA
GGN_KQ06FMP5hd9X,1691426118,–ú–µ–≥–∞–º–∞—Ä–∫–µ—Ç,5399,5411,-76650,-76650,980,0,0,814466,False,0PAP-EACX-T3C3-AB6B
nAnIow-vokuyWT6N,1691424435,–í—ñ–¥: –û–ª–µ—Å—è –°–∞—á–µ–Ω–∫–æ,4829,4829,405000,405000,980,0,0,891116,True
ptQzyHA2az77NbwY,1691424165,SPAZIO,5651,5651,-405000,-405000,980,0,0,486116,False,98T5-1KX9-PBMM-KEAM
FsTn_goNQn1wx4-9,1691340331,–°—ñ–ª—å–ø–æ,5411,5411,-58946,-58946,980,0,0,891116,False,BX1C-08BC-T813-B5HA
o8GzY9H0wAgKibod,1691316805,PHOPKononenkoMG,7999,7999,-5500,-5500,980,0,0,950062,False,T1BA-9ACM-TEE5-0727
uwFaiCHnNwOuUedn,1691315701,PHOPKononenkoMG,7999,7999,-31500,-31500,980,0,0,955562,False,PPMH-HMK4-0BK1-TBP0
9tiYcM5RFI2XL09G,1691314802,–ï–ø—ñ—Ü–µ–Ω—Ç—Ä,5211,5211,-287502,-287502,980,0,0,987062,False,045X-1AAC-KBPA-B4XX
5WNMM0xKCJBSSLDf,1691313038,OKKO,5541,5541,-223703,-223703,980,0,0,1274564,False,T8CX-T3T8-BMP1-0H36
4DEvUihhSyq5Cf5D,1691312109,–í—ñ–¥: –û–ª–µ–Ω–∞ –ë–∞–ª–±–µ–∫,4829,4829,173600,173600,980,0,0,1498267,True
voX8eCtHEol3uwO7,1691311885,Pethouse,5995,5995,-173600,-173600,980,0,0,1324667,False,20T7-26T6-6M16-1622
ugrF15SysEGmgijX,1691255669,ZOOLYUKS,5995,5995,-13500,-13500,980,0,0,1498267,False,X3P2-6CM3-P0B2-9A40
fEENVMeRAS_pUajL,1691249442,TOBAKKO-SERVIS,5499,5499,-81900,-81900,980,0,0,1511767,False,2E66-P1H9-69E7-A201
iwLO68HuYJ4viTYl,1691248908,MasterZoo,5995,5995,-29600,-29600,980,0,0,1593667,False,BMHE-8B84-76H8-9EBC
3VXVZSUJcndivaKS,1691247824,Yaroslaviv Val 37-1,5921,5921,-36190,-36190,980,0,0,1623267,False,XEXB-PT96-2XXC-T2M3
nV7KbiYQGPTtrsTD,1691247456,–ê–ø—Ç–µ–∫–∞ –ê–ù–¶,5912,5912,-100760,-100760,980,0,0,1659457,False,14CX-T7PE-5P54-M2A2
j5fuJuNl8tloxwW9,1691234689,SHOP NORVEN,5422,5422,-74590,-74590,980,0,0,1760217,False,4EBH-8331-EKXE-1HP6
r3B1arCrKgdsXoWU,1691227147,Goodwine,5921,5921,-58600,-58600,980,0,0,1834807,False,38TB-M6B8-5EH9-PHA4
iyzUZtHACNpZMwYR,1691225412,Rozetka,5399,5399,-7200,-7200,980,0,0,1893407,False,MBEA-915P-TT60-BMCP
X9HX7r1153QWrfwS,1691225375,Rozetka,5399,5399,-21100,-21100,980,0,0,1900607,False,A5A9-H9P4-A71K-83AP
qhPUm9Oz--wRKEbe,1691222155,OK Wine,5411,5411,-9000,-9000,980,0,0,1921707,False,CX07-6C73-783B-KK63
Btyl7-IIEotixzaZYajSGQ,1691191595,–ï–ª–µ–∫—Ç—Ä–æ—Å–∞–º–æ–∫–∞—Ç–∏ Bolt,7999,7999,-10020,-10020,980,0,0,1930707,True
DugeXQCx7oGM47V_GpLIbAqOCA,1691191595,–°–∫–∞—Å—É–≤–∞–Ω–Ω—è. –ï–ª–µ–∫—Ç—Ä–æ—Å–∞–º–æ–∫–∞—Ç–∏ Bolt,7999,7999,15000,15000,980,0,0,1940727,False
14yS3oDuH6tPyGYs,1691158805,–°—ñ–ª—å–ø–æ,5411,5411,-18497,-18497,980,0,0,1925727,False,200H-XPC4-AAXC-1552
yqfKOYPHfHi3DGIE,1691143737,–°—ñ–ª—å–ø–æ,5411,5411,-48299,-48299,980,0,0,1944224,False,C58T-5T0K-X3A1-EC3B
_6I_UO41P84FpFRC,1691137633,–ï–ª–µ–∫—Ç—Ä–æ—Å–∞–º–æ–∫–∞—Ç–∏ Bolt,7999,7999,-4323,-4323,980,0,0,1992523,False,T8EX-M9MX-X118-59AH
B-RV7X7vB-bhMI9W,1691136212,–ö–∏—ó–≤—Å—å–∫–µ –º–µ—Ç—Ä–æ,4111,4111,-800,-800,980,0,0,1996846,False,9B48-TX6C-MP5B-5M30
r1bRrFETVYjgCKcX,1691135425,–ê–ó–° –û–í–ò–°,5541,5541,-12900,-12900,980,0,0,1997646,False,B96P-8X1X-XTM0-CA4B
NVXjf8ujFt9u8uWO,1691129376,Best way to cup,5814,5814,-13000,-13000,980,0,260,2010546,False,AB58-TB78-HE7X-K950
FPTK7oq_SPyi1Hyo,1691078146,–ï–ª–µ–∫—Ç—Ä–æ—Å–∞–º–æ–∫–∞—Ç–∏ Bolt,7999,7999,-3197,-3197,980,0,0,2023546,False,9571-2P51-BME6-HA5M
zrvLghAqag3PXeqL,1691071902,Best way to cup,5814,5814,-20000,-20000,980,0,400,2026743,False,492A-MKK0-7H89-22E9
_NK41RmDV2BhZ_lx,1691063419,Novapay,8999,8999,-7000,-7000,980,0,0,2046743,False,3C7K-27XK-467B-9947
jcnMLn0Qr4Ur73TL,1691053348,LIQPAY*Varcab,5812,5812,-19950,-19950,980,0,399,2053743,False,56KB-P2M5-EHE3-CP22
3J0pMfCLuLRQHlUI,1691051186,–ú—ñ—Å—å–∫–µ –∫–∞—Ñ–µ –•–∞—Ä–º—Å,5812,5812,-9400,-9400,980,0,188,2073693,True,XB9T-BCB0-TE5A-B9T3
6_VzKmiA-unxhLbn,1691048784,–ï–ª–µ–∫—Ç—Ä–æ—Å–∞–º–æ–∫–∞—Ç–∏ Bolt,7999,7999,-3768,-3768,980,0,0,2083093,False,574X-4387-4A1K-BEH3
9k5D7G_Md1RLPOc2,1691045462,"Lifecell
+380631692598",4814,4814,-25000,-25000,980,0,0,2086861,True,6331-CA05-PXET-7570
zd_ukAzQGrdXeYYb,1690993703,–ï–ª–µ–∫—Ç—Ä–æ—Å–∞–º–æ–∫–∞—Ç–∏ Bolt,7999,7999,-2171,-2171,980,0,0,2111861,False,91M2-115E-71X0-B51H
8c0GWrzy3Xew8dY8,1690993670,Simona,5812,5812,-97800,-97800,980,0,1956,2114032,True,0A60-K85C-X1C7-HE82
QU4wWggUanHkC9rT,1690983965,–ü–µ—Ä–µ–∫–∞–∑ –Ω–∞ –∫–∞—Ä—Ç–∫—É,4829,4829,-700000,-700000,980,0,0,2211832,True
dWtk5fB_3f4N1CnX,1690963686,–ï–ª–µ–∫—Ç—Ä–æ—Å–∞–º–æ–∫–∞—Ç–∏ Bolt,7999,7999,-9829,-9829,980,0,0,2911832,False,5TBC-A1AE-74K9-7K4K
G_KgMz_ZdjuAeefH,1690962158,–ï–ª–µ–∫—Ç—Ä–æ—Å–∞–º–æ–∫–∞—Ç–∏ Bolt,7999,7999,-15000,-15000,980,0,0,2921661,False
inX4EffbN4leSCdS,1690923852,–ü–æ–ø–æ–≤–Ω–µ–Ω–Ω—è ¬´–ù–∞ –∞–≤—Ç–æ –¥–ª—è –°–°–û¬ª,4829,4829,-50000,-50000,980,0,0,2936661,True,4XTX-T6T8-A60K-2T2A
F8GJtFW_FHg2aVKR,1690898787,StudijaKvitivtadekoruS,5992,5992,-100000,-100000,980,0,0,2986661,False,78KC-E10P-AM22-0BTX
sYwRCVK1r1bEnyaG,1690898449,–ï–ª–µ–∫—Ç—Ä–æ—Å–∞–º–æ–∫–∞—Ç–∏ Bolt,7999,7999,-3820,-3820,980,0,0,3086661,False,PKC3-3MKM-8T2H-9KCX
-63EQYEkkXQlC9qw,1690898272,–¢–∞–±–∞–∫–µ—Ä–∫–∞,5993,5993,-71000,-71000,980,0,0,3090481,False,1044-BETP-X907-3C7P
1PVdB7pt3Feaky-7,1690885276,–°—ñ–ª—å–ø–æ,5411,5411,-6499,-6499,980,0,0,3161481,False,9E30-138A-8X4X-92H9
gv67Lo6hprM2TuKi,1690884802,Lesya,4829,4829,-16100000,-16100000,980,0,0,3167980,True,PAP7-436C-CPT9-9T82
HoYY_es65Dz4H90V,1690883789,–íi–¥: –ü–†–ò–•–û–î–¨–ö–û –ï.–í. –§–û–ü,"–î–ª—è –ø–æ–ø–æ–≤–Ω–µ–Ω–Ω—è –∫–∞—Ä—Ç–∫–∏ 5375414101190360, –ü—Ä–∏—Ö–æ–¥—å–∫–æ –ï—Ä–Ω–µ—Å—Ç –íi–∫—Ç–æ—Ä–æ–≤–∏—á, 3487403339",4829,4829,18900000,18900000,980,0,0,19267980,True
oI_zSVPubF20UbSE,1690873329,Rozetka,5399,5399,-7200,-7200,980,0,0,367980,False,69C2-T056-2EH4-CKM7
Qn9T9L_7k-hmDyx1,1690873297,Rozetka,5399,5399,-29600,-29600,980,0,0,375180,False,MA1C-49T7-B060-CCM7
Yx0urk71aRqBQJ-7,1690870358,PRTMN  *INTERNET,4816,4816,-50750,-50750,980,0,0,404780,False,5KBH-6M00-BB4H-C929
7FbDrV1gQPUHEkiQVw,1693421372,–¢–∞—Ä–∞—Å –ì.,4829,4829,-280000,-280000,980,0,0,940999,True,X33E-AKT6-ACMM-7A96
y8M5TDTA_NDKkww4yw,1693302475,–ó –ø–ª–∞—Ç–∏–Ω–æ–≤–æ—ó –∫–∞—Ä—Ç–∫–∏,4829,4829,600000,600000,980,0,0,1220999,True
3ru_7KAW3CtxcGXWqw,1693293304,Lesya,4829,4829,-150000,-150000,980,0,0,620999,True,C39H-HCHH-27E3-E7MH
ot-BMs81dy55n_WHvQ,1693113674,–†–µ–≥—É–ª—è—Ä–Ω–µ –ø–æ–ø–æ–≤–Ω–µ–Ω–Ω—è ¬´–§–æ–Ω–¥ –ü–æ–≤–µ—Ä–Ω–∏—Å—å –∂–∏–≤–∏–º¬ª,4829,4829,-25000,-25000,980,0,0,770999,True
yvCW8r198SikFv_I0w,1693035069,Lesya,4829,4829,-200000,-200000,980,0,0,795999,True,6AH3-87K9-HKK0-M183
vErXFvjn54KEwKg-0A,1692951743,–ó –ø–ª–∞—Ç–∏–Ω–æ–≤–æ—ó –∫–∞—Ä—Ç–∫–∏,4829,4829,300000,300000,980,0,0,995999,True
HDatRDm_EsEd0W8AUw,1692792653,Lesya,4829,4829,-200000,-200000,980,0,0,695999,True,A2CX-3HA5-3B24-M5E4
qSOn0u5-6Osp2cC6dQ,1692508895,–†–µ–≥—É–ª—è—Ä–Ω–µ –ø–æ–ø–æ–≤–Ω–µ–Ω–Ω—è ¬´–§–æ–Ω–¥ –ü–æ–≤–µ—Ä–Ω–∏—Å—å –∂–∏–≤–∏–º¬ª,4829,4829,-25000,-25000,980,0,0,895999,True
rUmroDPaZcyPFwqV,1691946252,Lesya,–ü–∞–ø—ñ –Ω–∞ —à–æ–Ω–∞,4829,4829,-800000,-800000,980,0,0,920999,True,21M6-H252-M2M6-T0P2
GvxSV8iiYL7I6boV,1691903994,–†–µ–≥—É–ª—è—Ä–Ω–µ –ø–æ–ø–æ–≤–Ω–µ–Ω–Ω—è ¬´–§–æ–Ω–¥ –ü–æ–≤–µ—Ä–Ω–∏—Å—å –∂–∏–≤–∏–º¬ª,4829,4829,-25000,-25000,980,0,0,1720999,True
kDdYicYf3zqq72ST,1691849288,Lesya,4829,4829,-400000,-400000,980,0,0,1745999,True,CPB5-KKT6-1AE3-5MBX
jS1GTCzkerV3LIWo,1691778462,Lesya,4829,4829,-100000,-100000,980,0,0,2145999,True,3K6P-E7E2-3123-MPH1
oDOFkVhe4C4jYeHn,1691753817,–í—ñ–¥: –°–µ—Ä–≥—ñ–π –°–∞—á–µ–Ω–∫–æ,4829,4829,100000,100000,980,0,0,2245999,True
Xv0E9Sn4lf3tzvaq,1691663225,–í—ñ–¥: –°–µ—Ä–≥—ñ–π –°–∞—á–µ–Ω–∫–æ,4829,4829,100000,100000,980,0,0,2145999,True
us9Jm6dGlhy6sidE,1691597031,–°–µ—Ä–≥—ñ–π –°.,4829,4829,-200000,-200000,980,0,0,2045999,True,TAB3-286C-KX0H-K92H
XmGeFEn85a1tDMWP,1691581790,–ó –ø–ª–∞—Ç–∏–Ω–æ–≤–æ—ó –∫–∞—Ä—Ç–∫–∏,4829,4829,1600000,1600000,980,0,0,2245999,True
NjOTKH3oCUZgBO-K,1691569260,–ü–µ—Ä–µ–∫–∞–∑ –Ω–∞ –∫–∞—Ä—Ç–∫—É,4829,4829,-300000,-300000,980,0,0,645999,True
v_gxT6ZVbfld00aP,1691492582,–ü–æ–ø–æ–≤–Ω–µ–Ω–Ω—è ¬´–î–ª—è –ù–∞–∑–∞—Ä—ñ—è –ì—É—Å–∞–∫–æ–≤–∞¬ª,4829,4829,-50000,-50000,980,0,0,945999,True,HEAC-94CH-2CEA-HX7B
0HEeD_W2v2LyMUKk,1691475177,Lesya,4829,4829,-50000,-50000,980,0,0,995999,True,MCH3-569E-29E8-0APK
rGucc9f3h-aMyIc2,1691299261,–†–µ–≥—É–ª—è—Ä–Ω–µ –ø–æ–ø–æ–≤–Ω–µ–Ω–Ω—è ¬´–§–æ–Ω–¥ –ü–æ–≤–µ—Ä–Ω–∏—Å—å –∂–∏–≤–∏–º¬ª,4829,4829,-25000,-25000,980,0,0,1045999,True
4zvmFjLG0Zr895eV,1691234421,Lesya,4829,4829,-100000,-100000,980,0,0,1070999,True,5PMB-H3PT-X415-A52A
1NRbpVtzoYnps9GI,1691221255,–ö–æ–ª—è –û–≥–æ–π–∫–æ,4829,4829,-174400,-174400,980,0,0,1170999,True,X461-CXPB-9219-CBXX
EJh4wb2BDmYjV6Ky,1690983965,–ó –ø–ª–∞—Ç–∏–Ω–æ–≤–æ—ó –∫–∞—Ä—Ç–∫–∏,4829,4829,700000,700000,980,0,0,1345399,True
tRHQvd3SskctFCRUkw,1696006994,MarchakDA,5814,5814,-19900,-19900,980,0,0,434828,False,72CB-KA5H-E3AK-6KX7
XohiWF2e7Z8VH3VZrQ,1695988636,Yaroslaviv Val 37-1,5921,5921,-153970,-153970,980,0,0,454728,False,MTTC-HXE7-MM7E-03HK
pSXAkBcZF0zJEV7Kkg,1695981062,BestWayToCup,5814,5814,-21000,-21000,980,0,0,608698,False,08KC-X838-K9KM-8XPT
JFQBrO0YMJ1hOS2VQg,1695973111,Vodafone,4814,4814,-17500,-17500,980,0,0,629698,False,18BE-8XXP-0EA6-708M
Qf9UzwGGRBHZ3qfIlA,1695970443,–ï–ª–µ–∫—Ç—Ä–æ—Å–∞–º–æ–∫–∞—Ç–∏ Bolt,7999,7999,-5156,-5156,980,0,0,647198,False,C81M-8KHH-C6MA-8M2M
AfO0oQxU6uBrerGqsQ,1695969629,–ï–ª–µ–∫—Ç—Ä–æ—Å–∞–º–æ–∫–∞—Ç–∏ Bolt,7999,7999,-4480,-4480,980,0,0,652354,False,5X73-773T-466K-CMC9
OtTRDrHA2AAJzQ1WlA,1695967886,–û–±—Å–ª—É–≥–æ–≤—É–≤–∞–Ω–Ω—è –ø–ª–∞—Ç–∏–Ω–æ–≤–æ—ó –∫–∞—Ä—Ç–∫–∏,4829,4829,-30000,-30000,980,0,0,656834,True
zQq2CxfSOT9hyi8kEA,1695912032,LOKO,5411,5411,-32900,-32900,980,0,0,686834,False,C216-KC86-2TAX-BCHH
gSiZMF5wGAw7q3afjA,1695908009,–°—ñ–ª—å–ø–æ,5411,5411,-57176,-57176,980,0,0,719734,False,H2CT-K5C0-72M7-AAEH
XsiLfLMtmV2oLc4X3w,1695907697,SECHST,5912,5912,-86813,-86813,980,0,651,776910,False,031E-PBXK-CT88-M79H
umo56NkV-artkknPOw,1695889807,Paragraph Coffee,5814,5814,-9500,-9500,980,0,0,863723,False,P5BH-M56C-01T9-K486
Rsp5FHZvo1KS4neZrQ,1695882572,"Lifecell
+380631692598",4814,4814,-30000,-30000,980,0,0,873223,True,A85B-CTHE-H2H2-925K
Tt6knZc8c6DKal9qvla4nw,1695856418,–ï–ª–µ–∫—Ç—Ä–æ—Å–∞–º–æ–∫–∞—Ç–∏ Bolt,7999,7999,-2287,-2287,980,0,0,903223,True
afz6megN2eCo4EipxgdbHw,1695856418,–ï–ª–µ–∫—Ç—Ä–æ—Å–∞–º–æ–∫–∞—Ç–∏ Bolt,7999,7999,-2735,-2735,980,0,0,905510,True
M9f_qlbNCJqAF5AX3GKkSLrj-pY,1695856418,–°–∫–∞—Å—É–≤–∞–Ω–Ω—è. –ï–ª–µ–∫—Ç—Ä–æ—Å–∞–º–æ–∫–∞—Ç–∏ Bolt,7999,7999,10000,10000,980,0,0,908245,False
_UkYjvk48Fe4INGqir1lOOO0H20,1695856418,–°–∫–∞—Å—É–≤–∞–Ω–Ω—è. –ï–ª–µ–∫—Ç—Ä–æ—Å–∞–º–æ–∫–∞—Ç–∏ Bolt,7999,7999,10000,10000,980,0,0,898245,False
pRFy8nTcazlwzETwJQ,1695834703,–¢–∞–±–∞–∫–µ—Ä–∫–∞,5993,5993,-78000,-78000,980,0,0,888245,False,KKX9-T43T-ETXP-C3M2
ADoGRfUE9hb5kPch2A,1695834610,Novus,5411,5411,-69729,-69729,980,0,0,966245,False,1575-BTB3-6BXP-B1E0
f56dB7OViuBQAZpkzw,1695833954,magazin 762597,5912,5912,-133117,-133117,980,0,998,1035974,False,5EM4-3CT6-PMK8-B5CB
IT3OQ4nAMC596kF3Qw,1695829429,Uklon,4121,4121,-9000,-9000,980,0,0,1169091,False,60M9-15C4-4682-5B13
Ry6D-pzze938s3l5Bw,1695828093,"Knigarnya""Sens""",5942,5942,-161000,-161000,980,0,0,1178091,False,2813-KMTE-ACM0-9XC1
k45imFd14blHoXB0cw,1695827262,ArtknigarnyaMisto,5942,5942,-72000,-72000,980,0,0,1339091,False,AHP8-HBA3-APHC-8C80
zKA46URSLTFDYapmtg,1695825369,Sens,5814,5814,-15200,-15200,980,0,0,1411091,False,1A97-459X-9CXE-HPE1
5FNZs3B5iOSiHChMbA,1695821805,Uklon,4121,4121,-7200,-7200,980,0,0,1426291,False,6678-MP3T-8XA9-PP8B
xf4mgO-ZJqSx247OOA,1695815803,–ö–æ–ª–æ,5411,5499,-5100,-5100,980,0,0,1433491,False,6324-BCA7-AT73-KM5M
Wh6uymrSVcxjI5x-8w,1695814977,–ó–∞–º–æ–≤–ª–µ–Ω–Ω—è —ó–∂—ñ,5499,5499,-97240,-97240,980,0,0,1438591,False,A33A-X9CT-0T76-X35H
tCf8GtGMqt4oaNYZ9A,1695810804,Pethouse,5995,5995,-306100,-306100,980,0,0,1535831,False,CH7T-C2X3-42K9-P4MA
VHK1Hc5WXCSsi3oLUA,1695803602,–íi–¥: –ü–†–ò–•–û–î–¨–ö–û –ï.–í. –§–û–ü,"–î–ª—è –ø–æ–ø–æ–≤–Ω–µ–Ω–Ω—è –∫–∞—Ä—Ç–∫–∏ 5375414101190360, –ü—Ä–∏—Ö–æ–¥—å–∫–æ –ï—Ä–Ω–µ—Å—Ç –íi–∫—Ç–æ—Ä–æ–≤–∏—á, 3487403339",4829,4829,1800000,1800000,980,0,0,1841931,True
f1RN8EhZPc10Rhgqlg,1695802038,City24 Swift Garant,4816,4816,-41000,-41000,980,0,0,41931,False,XT03-X5TA-1KX0-E2B7
U3fOFph6_tho1j683JdOTQ,1695769559,–ï–ª–µ–∫—Ç—Ä–æ—Å–∞–º–æ–∫–∞—Ç–∏ Bolt,7999,7999,-1994,-1994,980,0,0,82931,True
ZNxu0NsKQ2D8AA2d-RiAcHrdtaQ,1695769559,–°–∫–∞—Å—É–≤–∞–Ω–Ω—è. –ï–ª–µ–∫—Ç—Ä–æ—Å–∞–º–æ–∫–∞—Ç–∏ Bolt,7999,7999,10000,10000,980,0,0,84925,False
qbDdxkot6MfjJyAGFg,1695757760,FDY*Merchandise,5399,5399,-28310,-28310,980,0,0,74925,False,1608-K90P-K66C-XT76
AqzZRkfSYIndC7HkMw,1695735461,magazin 762597,5912,5912,-75310,-75310,980,0,564,103235,False,E46X-63H3-1PM6-X80H
NWxHrh-E8MXP8DfL2w,1695735081,OK Wine,5921,5921,-16600,-16600,980,0,0,178545,False,KKMX-P8TC-THKC-6C24
5bf_kiPdYK9cWi2oFA,1695734873,Novus,5411,5411,-18395,-18395,980,0,0,195145,False,XCM0-00E0-4BT7-PM6A
cWPKKwq_sz-r3UXorw,1695734415,BestWayToCup,5814,5814,-12500,-12500,980,0,0,213540,False,3ACH-5A0A-B36C-EX54
U7oNPY7G1U6ihcnEzg,1695725033,–û—Ñ—ñ—Å-—á–∞–π,5812,5812,-18900,-18900,980,0,0,226040,True,2AKA-2PXM-BP13-3MT5
QDfCTNUnKtu-4xEWzQ,1695723961,–ï–ª–µ–∫—Ç—Ä–æ—Å–∞–º–æ–∫–∞—Ç–∏ Bolt,7999,7999,-7835,-7835,980,0,0,244940,False,K80K-K47P-50MP-53BX
hP7VmH0h3cfjhgdJQQ,1695723578,Fotovramci,5946,5946,-20000,-20000,980,0,0,252775,False,CK21-7BTB-6C2T-A754
Pxh8Y8hPlCpCkMJZBg,1695721721,–ú—ñ—Å—å–∫–∞ –á–¥–∞–ª—å–Ω—è,5814,5814,-61000,-61000,980,0,0,272775,False,165P-E9A1-XK48-XT68
M1I2v8hUpryur_MdSw,1695721418,–ó –±—ñ–ª–æ—ó –∫–∞—Ä—Ç–∫–∏,4829,4829,200000,200000,980,0,0,333775,True
dPjb7ogoQr7ADhVlXg,1695716327,–ü—Ä–∏–≤–∞—Ç24: Holovchenko Maksym,6536,6536,46800,46800,980,0,0,133775,False
m8sd0vNyr76VWObHog,1695662366,PHOPKononenkoMG,7999,7999,-50000,-50000,980,0,0,86975,False,75C0-P7XC-ABM1-XB85
oacj2Pj1AeyFZg1fcQ,1695658068,–ï–ª–µ–∫—Ç—Ä–æ—Å–∞–º–æ–∫–∞—Ç–∏ Bolt,7999,7999,-2895,-2895,980,0,0,136975,False,3X67-41XA-CBTP-K4E1
VNNENdYR8S4Id_v3NQ,1695657766,–ï–ª–µ–∫—Ç—Ä–æ—Å–∞–º–æ–∫–∞—Ç–∏ Bolt,7999,7999,-10000,-10000,980,0,0,139870,False
DNBo9CQ9KyNSN29E3A,1695657182,–ï–ª–µ–∫—Ç—Ä–æ—Å–∞–º–æ–∫–∞—Ç–∏ Bolt,7999,7999,-2534,-2534,980,0,0,149870,False,AXPC-9E1E-TKA7-4KBM
5wZbFCjTbs8ail7f2w,1695656950,–ï–ª–µ–∫—Ç—Ä–æ—Å–∞–º–æ–∫–∞—Ç–∏ Bolt,7999,7999,-10000,-10000,980,0,0,152404,False
QJN_Vd9eQOF6t4XPKA,1695656330,Novapay,8999,8999,-43900,-43900,980,0,0,162404,False,472A-07T5-8X9A-02AP
9jX28CNWqVEVcsRCzQ,1695636713,OKKO,5541,5541,-234013,-234013,980,0,0,206304,False,BE81-T9E2-1C02-4618
c6Z4dwCB6lObEN1xtg,1695630995,IHROLEND,7996,7996,-121000,-121000,980,0,0,440317,False,9B4T-EMBX-22T9-0TKK
rEeDG2IwDJ4HMUzC8g,1695622842,–°—ñ–ª—å–ø–æ,5411,5411,-30600,-30600,980,0,0,561317,False,4368-M8H2-HET6-ME6X
KSwtivZFG_3HI99UsQ,1695571333,–í—ñ–¥: –í–ª–∞–¥–∏—Å–ª–∞–≤ –ß–æ—Ä–Ω–∏–π,—Å–ø–ª—ñ—Ç,4829,4829,114400,114400,980,0,0,591917,True
jRtgCenyi1W1crbUQg,1695567017,–ó–∞–≤–µ—Ä—Ç–∞–π–ª–æ –°–æ—Ñ—ñ—è ,5812,5812,-73460,-73460,980,0,0,477517,True,AT35-A008-88HM-KAM2
0UUvdFtfomJZFM3IzQ,1695563828,–ï–ª–µ–∫—Ç—Ä–æ—Å–∞–º–æ–∫–∞—Ç–∏ Bolt,7999,7999,-2268,-2268,980,0,0,550977,False,7X4K-1K55-7EMH-295X
BKTDDJ4njKWvbAwIow,1695563641,–ï–ª–µ–∫—Ç—Ä–æ—Å–∞–º–æ–∫–∞—Ç–∏ Bolt,7999,7999,-10000,-10000,980,0,0,553245,False
oQmkzwSEHbf_39wfEQ,1695562553,Bolt,4121,4121,-25600,-25600,980,0,0,563245,False,C67B-359M-0KT9-5X74
XexF1dRXcQURFUk1Dg,1695559883,TOVVREBRO1,5812,5812,-101000,-101000,980,0,0,588845,False,AH39-2721-2K5B-P55P
M5PlzRZmvDIlQyrSPg,1695559860,TOVVRebro,5812,5812,-392700,-392700,980,0,0,689845,False,4B52-HTE2-2C15-EX06
ArKNk2xk0ZU1QU68AQ,1695484624,magazin 762597,5912,5912,-36200,-36200,980,0,271,1082545,False,4M85-229H-C3K6-3A05
FCh02cEeGAIUptd0hg,1695477738,–ü–∞—Ä–∫–æ–≤–∫–∞,7523,7523,-6000,-6000,980,0,0,1118745,False,M13M-B9AP-AEX1-H3XB
gikS2PWy5kcAAlmtuQ,1695477358,Restoran Privit,5814,5814,-13000,-13000,980,0,0,1124745,False,X6HT-98X0-2CXB-19AP
bICXpBUS49uEV1b6PA,1695475440,SPILKA,5812,5812,-12000,-12000,980,0,0,1137745,False,T14M-C5A0-2B14-A4AK
pecXao5CKrNpWcaQDg,1695472676,Diletant,5814,5814,-28500,-28500,980,0,0,1149745,False,H60E-43C4-0PKT-C65B
XT0Kc8_I1QW57QXflw,1695472343,–ê–ø—Ç–µ–∫–∞ –ê–ù–¶,5912,5912,-41040,-41040,980,0,307,1178245,False,7C3H-M4TK-T60X-0915
vjVBujJjOKlfLyus4A,1695465926,BestWayToCup,5814,5814,-31500,-31500,980,0,0,1219285,False,T0MH-BH4M-E6M7-7T73
LpImLQXROtlhxLJ8bQ,1695465477,–ü—Ä–æ–¥—É–∫—Ç–∏,5499,5499,-1339,-1339,980,0,0,1250785,False,KPA3-M5K6-35K1-8E14
b2RQiSGznPU7XbejfQ,1695465276,FOP DANCHENKO YEVDOKIIA I,5812,5812,-3500,-3500,980,0,0,1252124,False,KKMH-KK0P-3H3E-4M90
L7UU8SKh6OeNcUyDug,1695452870,Novus,5411,5411,-8999,-8999,980,0,0,1255624,False,149M-89CP-TEMT-K1X1
6dc714yKPAWETD785Q,1695452572,HliBar,5462,5462,-4500,-4500,980,0,0,1264623,False,6AA9-9B51-T895-9BCT
eKviq81OSeU0E6AMRQ,1695413137,–ï–ª–µ–∫—Ç—Ä–æ—Å–∞–º–æ–∫–∞—Ç–∏ Bolt,7999,7999,-2637,-2637,980,0,0,1269123,False,7B9P-XPBA-TMHE-T54X
WBsBO7lav_nmnOHhoA,1695398507,–ï–ª–µ–∫—Ç—Ä–æ—Å–∞–º–æ–∫–∞—Ç–∏ Bolt,7999,7999,-5460,-5460,980,0,0,1271760,False,1B28-T2C6-E3A0-CB59
HkWFPCRa5R94v0YaTQ,1695393727,–û—Ñ—ñ—Å-—á–∞–π,5812,5812,-34100,-34100,980,0,0,1277220,True,HK80-9KCA-P17K-KPB5
MQZhAg-O-VUDUfhd0A,1695383169,Novus,5411,5411,-9348,-9348,980,0,0,1311320,False,3E21-HPX1-M941-T14C
9hioaGS4eQUCaZa7SA,1695364521,Novapay,8999,8999,-5400,-5400,980,0,0,1320668,False,XET2-PPAA-TA08-X910
ZXu8JUf29jgzD1hdNQ,1695316550,Bolt,4121,4121,-20700,-20700,980,0,0,1326068,False,E979-TEM3-H78H-EK05
YiwLNXEQgQ_-ZgR1Wg,1695288611,–ê–ø—Ç–µ–∫–∞ –ê–ù–¶,5912,5912,-8140,-8140,980,0,61,1346768,False,2757-X022-CEHK-8PC0
R9wa2QrxY03qN7JpHA,1695283193,Novus,5411,5411,-33809,-33809,980,0,0,1354908,False,3KK8-6PBP-K37K-A4EK
J9_Q9mIpXzcbvHxsyg,1695216591,SHOPSILPO,5411,5411,-279100,-279100,980,0,0,1388717,False,EP8A-749K-9CPE-7P5B
eH__kBuwa_pVPPLQfQ,1695195336,BestWayToCup,5814,5814,-29500,-29500,980,0,0,1667817,False,64A2-B4T9-5T2K-6MME
I4_bVq0ypk0Pm6Mz3w,1695195111,–¢–∞–±–∞–∫–µ—Ä–∫–∞,5993,5993,-156000,-156000,980,0,0,1697317,False,X2X6-40KP-42B9-71M9
NcxDBoRGWaoB4Zg16w,1695194513,magazin 762597,5912,5912,-160230,-160230,980,0,1371,1853317,False,CXXT-CA9B-8PPE-01BC
SSKzJv5b_VzX3J2yoA,1695192631,HliBar,5462,5462,-27500,-27500,980,0,0,2013547,False,B969-AKHK-B18E-72TT
axaH6aFj2ml5iYHErQ,1695192553,HliBar,5462,5462,-10500,-10500,980,0,0,2041047,False,T82A-C1A2-0T32-EAB8
RsybJYIvvmQOK2xq1Q,1695134867,BestWayToCup,5814,5814,-9500,-9500,980,0,0,2051547,False,1M1A-83P4-B7CK-80C0
B_s5SyPrFHcs4iR3-Q,1695129656,–ö–æ–ª–æ,5411,5499,-8050,-8050,980,0,0,2061047,False,30B2-1TBT-T8XA-PK3B
bQu4_gHF_KjGR-rhIw,1695129213,–ú—ñ—Å—å–∫–∞ –á–¥–∞–ª—å–Ω—è,5814,5814,-26000,-26000,980,0,0,2069097,False,HC5B-24HB-7PC0-251E
gBjtHcoZZlg84_VcAQ,1695123676,Lesya,4829,4829,-100,-100,980,0,0,2095097,True,88K5-X97X-5A14-9PXB
05egO-mpn-GOcX8p1Q,1695106105,Novus,5411,5411,-36394,-36394,980,0,0,2095197,False,1MPH-B8KX-9PK5-K0H5
cMaC_PXHFv5yO24eww,1695103518,–ü–µ—Ä–µ–∫–∞–∑ –Ω–∞ –∫–∞—Ä—Ç–∫—É,4829,4829,-220000,-220000,980,0,0,2131591,True
b4KH7SZCfK1Fw0VB1w,1695103503,Lesya,4829,4829,-700000,-700000,980,0,0,2351591,True,A5EM-87T4-P1K1-E624
M-3LhQYlAZggSSIVr735LQ,1695078237,–ï–ª–µ–∫—Ç—Ä–æ—Å–∞–º–æ–∫–∞—Ç–∏ Bolt,7999,7999,-2865,-2865,980,0,0,3051591,True
-BqvLVlQJfc6_aZAdsvk4w,1695078237,–ï–ª–µ–∫—Ç—Ä–æ—Å–∞–º–æ–∫–∞—Ç–∏ Bolt,7999,7999,-2667,-2667,980,0,0,3054456,True
AwaW81s2wlKcD5GqrlCVjb0dSP4,1695078237,–°–∫–∞—Å—É–≤–∞–Ω–Ω—è. –ï–ª–µ–∫—Ç—Ä–æ—Å–∞–º–æ–∫–∞—Ç–∏ Bolt,7999,7999,10000,10000,980,0,0,3057123,False
GKCQiR7akAsDm-f7q1NTgja4suk,1695078237,–°–∫–∞—Å—É–≤–∞–Ω–Ω—è. –ï–ª–µ–∫—Ç—Ä–æ—Å–∞–º–æ–∫–∞—Ç–∏ Bolt,7999,7999,10000,10000,980,0,0,3047123,False
glc4OlO_qvUDG_3BVQ,1695053272,Food Spot,5812,5812,-48100,-48100,980,0,0,3037123,True,670H-C6BP-4HMX-0918
Lb0zPf8EdttXev4GWQ,1695052371,–°—ñ–ª—å–ø–æ,5411,5411,-450,-450,980,0,0,3085223,False,6KPH-AX8T-MTP2-2P70
hPhxbdY75VGDaD2D4Q,1695052324,–°—ñ–ª—å–ø–æ,5411,5411,-63245,-63245,980,0,0,3085673,False,5619-34HM-TC2M-XAET
lrvB58ZQLPmCIdu6BA,1695028476,–íi–¥: –ü–†–ò–•–û–î–¨–ö–û –ï.–í. –§–û–ü,"–î–ª—è –ø–æ–ø–æ–≤–Ω–µ–Ω–Ω—è –∫–∞—Ä—Ç–∫–∏ 5375414101190360, –ü—Ä–∏—Ö–æ–¥—å–∫–æ –ï—Ä–Ω–µ—Å—Ç –íi–∫—Ç–æ—Ä–æ–≤–∏—á, 3487403339",4829,4829,2900000,2900000,980,0,0,3148918,True
XUBSSDlW8PjL76tJ2A,1695021365,–ê–ø—Ç–µ–∫–∞ –ê–ù–¶,5912,5912,-18240,-18240,980,0,136,248918,False,1A5K-EBC0-C69M-PXEE
H4sTv4E_N5Xtdpwesg,1694974383,Pethouse,5995,5995,-306100,-306100,980,0,0,267158,False,8C6H-H6AK-B777-26AE
KtwGopIDbF-W_WQs5Q,1694954445,–ó–∞–≤–µ—Ä—Ç–∞–π–ª–æ –°–æ—Ñ—ñ—è ,5812,5812,-18500,-18500,980,0,0,573258,True,B1E8-1399-MCCH-2MA5
HPzvmW5cEZ77JNrs7A,1694954199,–ó–∞–≤–µ—Ä—Ç–∞–π–ª–æ –°–æ—Ñ—ñ—è ,5812,5812,-127180,-127180,980,0,0,591758,True,2T04-2MXC-541A-C205
wTY4OSBGJrWPae2byQ,1694949102,–ö–∏—ó–≤–ø–∞—Å—Ç—Ä–∞–Ω—Å,4111,4111,-800,-800,980,0,0,718938,False,2BPA-38E7-150A-6HHA
N8VDLSJz-AAZQiXmmA,1694879347,–ó–æ–æ–º–∞–≥–∞–∑–∏–Ω,5995,4215,-22500,-22500,980,0,0,719738,False,E13K-5BCA-29A4-XCCC
Ww0qOQrUsrEyI_EX3Q,1694867444,OK Wine,5411,5411,-93050,-93050,980,0,0,742238,False,PEMP-9P8B-4B33-HE40
k7jw9THCRcgN6_IAow,1694867045,Novus,5411,5411,-30238,-30238,980,0,0,835288,False,T2XT-9B8T-EH3M-49PB
aDs5nzRxhC0TLLNSkg,1694866326,magazin 762597,5912,5912,-71000,-71000,980,0,532,865526,False,10CA-1H65-9MT7-AAMM
mM7NJHlWAvNYnzBfhw,1694859435,–ï–ª–µ–∫—Ç—Ä–æ—Å–∞–º–æ–∫–∞—Ç–∏ Bolt,7999,7999,-2838,-2838,980,0,0,936526,False,7PKM-6858-13K2-PC19
F-3WdDl6CgF4f8IKhQ,1694859142,–ï–ª–µ–∫—Ç—Ä–æ—Å–∞–º–æ–∫–∞—Ç–∏ Bolt,7999,7999,-10000,-10000,980,0,0,939364,False
RMeLFwdm-Edby1ADZg,1694856619,Riot Division,5691,5691,-700000,-700000,980,0,0,949364,False,MXX0-KTX4-T410-A72P
7C4XtBXQGSOn87kwmw,1694855596,–ï–ª–µ–∫—Ç—Ä–æ—Å–∞–º–æ–∫–∞—Ç–∏ Bolt,7999,7999,-2998,-2998,980,0,0,1649364,False,XXP6-21XM-34T3-8E15
AxhMWQm2-CPQ1VGpTg,1694855271,–ï–ª–µ–∫—Ç—Ä–æ—Å–∞–º–æ–∫–∞—Ç–∏ Bolt,7999,7999,-10000,-10000,980,0,0,1652362,False
YWgl9d4lTER8jXIbOw,1694852499,MagazinAzurZolotievoro,5399,5399,-114400,-114400,980,0,0,1662362,False,B8M5-KMBA-8M1M-MTE7
iRs7d-8Du0BaiOw-rg,1694849032,–ó–∞–≤–µ—Ä—Ç–∞–π–ª–æ –°–æ—Ñ—ñ—è ,5812,5812,-137000,-137000,980,0,0,1776762,True,2BTC-CMPK-TE21-C203
680wUD6EUKyHJLcuKA,1694784925,FDY*Merchandise,5399,5399,-78110,-78110,980,0,0,1913762,False,0C71-11KA-B520-A0E8
zDTjp1K1hCb0wtujdQ,1694762752,BestWayToCup,5814,5814,-35000,-35000,980,0,0,1991872,False,H36A-53KK-546B-5E50
4egVJabb68O-P8TZBg,1694761770,BestWayToCup,5814,5814,-8500,-8500,980,0,0,2026872,False,3H7C-A20E-0PE8-7EXA
A26KnXcn_dES4CmTDw,1694710184,LIQPAY*Kitajskij Privi,5812,5812,-106700,-106700,980,0,0,2035372,False,9BK8-MT84-E8BB-X2CX
tePot9tgbb3WVkUkwA,1694680824,TITKA KLARA,5814,5814,-3300,-3300,980,0,0,2142072,False,T543-8TEA-6PB8-4C6M
kh8NQhPXUKsadr49aA,1694626499,SHIBUYA | –Ø—Ä–æ—Å–ª–∞–≤—ñ–≤ –í–∞–ª,5812,5812,-137100,-137100,980,0,0,2145372,True,8P18-PHCT-8MA8-K2TB
2dFaqgKYV-UhVdnoSQ,1694596715,–°—ñ–ª—å–ø–æ,5411,5411,-15143,-15143,980,0,0,2282472,False,BCKE-B15P-C85A-319C
x_JJ7ssqXCGzr-AHNg,1694591244,–íi–¥: –ü–†–ò–•–û–î–¨–ö–û –ï.–í. –§–û–ü,"–î–ª—è –ø–æ–ø–æ–≤–Ω–µ–Ω–Ω—è –∫–∞—Ä—Ç–∫–∏ 5375414101190360, –ü—Ä–∏—Ö–æ–¥—å–∫–æ –ï—Ä–Ω–µ—Å—Ç –íi–∫—Ç–æ—Ä–æ–≤–∏—á, 3487403339",4829,4829,2100000,2100000,980,0,0,2297615,True
oUQJV4laRCa49x8fkw,1694583455,Pethouse,5995,5995,-90400,-90400,980,0,0,197615,False,7PE0-7CP9-HXP9-04X7
rSNxuY8tUxzZDPOSjQ,1694537658,HliBar,5462,5462,-9000,-9000,980,0,0,288015,False,4100-XT23-4396-175M
5ylwWXOhByCTkU7mHw,1694536104,Bubbly,5814,5814,-9500,-9500,980,0,0,297015,False,TXTM-0138-KMH6-AAH7
VQOn88inFL6SBc7wNA,1694535404,Novapay,8999,8999,-7000,-7000,980,0,0,306515,False,86CP-TKMK-T824-3BE0
HS7u8negazVo31QP_A,1694530212,–û–≤–æ—á—ñ —Ç–∞ —Ñ—Ä—É–∫—Ç–∏,5499,5499,-18000,-18000,980,0,0,313515,False,9491-3HX1-0T52-4XB1
LMpYbgt6bkmKy_D-Hw,1694530176,–û–≤–æ—á—ñ —Ç–∞ —Ñ—Ä—É–∫—Ç–∏,5499,5499,-4300,-4300,980,0,0,331515,False,X7PA-01MK-TTE0-ATXX
ofydivo_7tRPRvQL1g,1694449582,–ê–ø—Ç–µ–∫–∞ –ê–ù–¶,5912,5912,-43200,-43200,980,0,324,335815,False,C93H-AH3C-PT64-B1AX
AtiVMJg_hjPeVEx86w,1694449380,HliBar,5462,5462,-8720,-8720,980,0,0,379015,False,A513-465X-T8EA-M7A0
T4bvDAKRfNc_bGN3MQ,1694436061,–°—ñ–ª—å–ø–æ,5411,5411,-9998,-9998,980,0,0,387735,False,M4XE-69A1-M1EP-6CC2
gUFVy5H6lqZ0Qfqlmg,1694366000,–°–∫–∞—Å—É–≤–∞–Ω–Ω—è. –°—ñ–ª—å–ø–æ,5411,5411,3962,3962,980,0,0,397733,False
R9CbiQGJkfMP1FU6dQ,1694365442,–°—ñ–ª—å–ø–æ,5411,5411,-20130,-20130,980,0,0,393771,False
f9N21Y7Yej4f2prQ1w,1694354078,BestWayToCup,5814,5814,-8500,-8500,980,0,0,413901,False,A6PH-20B5-B904-EX02
JOs5X-4J0BQG0-zetg,1694332375,BestWayToCup,5814,5814,-19500,-19500,980,0,0,422401,False,7XM4-PB7H-3T56-E2H3
QqXVk2nXODPU8oyMDA,1694280963,–°—ñ–ª—å–ø–æ,5411,5411,-69598,-69598,980,0,0,441901,False,TBHX-TPAM-8X6E-M035
dqI5hMAubaV3diTHpA,1694278196,Promin,5651,5651,-247700,-247700,980,0,0,511499,False,MXM0-8ET4-A9TT-1363
7lZVR3qnW_nb-oXUqQ,1694276544,–°—ñ–ª—å–ø–æ,5411,5411,-15515,-15515,980,0,0,759199,False,8C6K-TA34-A265-16H4
hfDM158olGu4w9EOUQ,1694260658,HliBar,5462,5462,-22500,-22500,980,0,0,774714,False,6PBT-338T-CK1C-1E8M
NkCVvNyw-RMzP38eRg,1694259818,Promn,5651,5651,-157400,-157400,980,0,0,797214,False,PA5K-H8M4-X1A2-92MB
KNIr1lJPA6njFaWwZA,1694258604,–ï–ª–µ–∫—Ç—Ä–æ—Å–∞–º–æ–∫–∞—Ç–∏ Bolt,7999,7999,-1323,-1323,980,0,0,954614,False,5EA5-4AXC-X222-0KT7
2zBhYs2CWBGt8NVLQg,1694196188,Novapay,8999,8999,-7000,-7000,980,0,0,955937,False,X3M4-MAC3-K9T8-T76C
rG5GTzTPBw9sBDrzTg,1694191428,Konteiner,5814,5814,-35000,-35000,980,0,0,962937,False,834C-C7T2-2HPC-M67K
RMHeTIVHUHpV9lxvZQ,1694191069,–ú–Ü–ù–Ü–°–¢–ï–†–°–¢–í–û –î–ï–°–ï–†–¢–Ü–í,5812,5812,-101800,-101800,980,0,0,997937,True,9M9K-C2KP-4AP5-6H6E
-wRZpYwBtG5irtd3Fg,1694190669,FDY*FOOD,5499,5499,-58230,-58230,980,0,0,1099737,False,890C-H40T-M8ET-638T
OAQCvbwWKIEG2dBebQ,1694190090,FDY*Merchandise,5399,5399,-110809,-110809,980,0,0,1157967,False,T406-9HC1-5612-49C6
fFztpAsRjCffK6AvBA,1694164285,–°—ñ–ª—å–ø–æ,5411,5411,-5728,-5728,980,0,0,1268776,False,9MA2-6CX7-H754-41T8
Rm6uA42p2K6K3qEjag,1694149459,Pethouse,5995,5995,-335400,-335400,980,0,0,1274504,False,630H-AC2P-TT18-TX58
0KxinqhoHF26pWvJFQ,1694104827,–ö–æ–ª–æ,5411,5499,-8300,-8300,980,0,0,1609904,False,4PKP-PKXM-CC8H-EP40
5JuVTSZYmfuQF9bZbQ,1694104347,Konteiner,5814,5814,-19900,-19900,980,0,0,1618204,False,C5HM-2TM4-M0ME-7C4H
3grPAqmF2MviAEuOpw,1694088361,SHOPSILPO,5411,5411,-133121,-133121,980,0,0,1638104,False,XP6B-20HH-9MB9-9MEB
3Ks9Hw5vPYKf5jwZjQ,1694087464,–°—ñ–ª—å–ø–æ,5411,5411,-8500,-8500,980,0,0,1771225,False,KE44-58XE-90HA-XC7T
XfiQeNFf1dsM-gv-4w,1694073742,–ú–µ—Ä–µ–∂–∞ –∞–ø—Ç–µ–∫ D.S.,5912,5912,-3900,-3900,980,0,29,1779725,False,035B-T74T-2XT0-M047
t1jZyEeInZE1j4ojyg,1694073723,PetStoryZootovari,5995,5995,-20000,-20000,980,0,0,1783625,False,H3CA-9180-BHTH-PA97
0F1vyGHyxJ_GjZGozA,1694073464,LaFabrique,5814,5814,-16500,-16500,980,0,0,1803625,False,AA58-785P-5TBH-KXHA
mo_GRZ1FoXevSVYEGg,1694070967,–¢–∞–±–∞–∫–µ—Ä–∫–∞,5993,5993,-156000,-156000,980,0,0,1820125,False,5M12-1TK3-C3HH-6EHE
BmUf6f1ksWWLh40ncg,1694070751,OK Wine,5411,5411,-6000,-6000,980,0,0,1976125,False,HPC4-5BT8-01H1-8813
QwJ0NniYhy2E_Qn3Xg,1694070658,magazin 762597,5912,5912,-74310,-74310,980,0,1262,1982125,False,XHCH-75T1-B29B-3EH4
JoXouimtM4nKXTqj-g,1694069251,RIZNI,5812,5812,-33000,-33000,980,0,0,2056435,False,PK78-XC4E-9MBX-3AKP
_dBzfHuBsgFZKtnYQQ,1694020590,Naushi,5812,5812,-92200,-92200,980,0,0,2089435,True,M3E3-K2P2-H6K4-K7PP
qbWLUqcKnXYxiQwOvA,1694017717,–ï–ª–µ–∫—Ç—Ä–æ—Å–∞–º–æ–∫–∞—Ç–∏ Bolt,7999,7999,-6409,-6409,980,0,0,2181635,False,15PH-9PB7-HHK2-5XMH
5XYIWOewMLVB1wd9-Q,1693996510,–ö–æ–ª–æ,5411,5499,-9650,-9650,980,0,0,2188044,False,T319-28B2-85PA-69MA
2s9PyxNuYeU4wjcGxw,1693996136,MarchakDA,5814,5814,-16900,-16900,980,0,0,2197694,False,5M76-0THX-B5ME-XK5P
NO7dkQ098jPP18PgPw,1693930075,–û—Ñ—ñ—Å-—á–∞–π,5812,5812,-18400,-18400,980,0,0,2214594,True,PKEH-6E3T-EA1X-C7TB
9pYRkcqf8o3VAuHpGw,1693912673,–ü–µ—Ä–µ–∫–∞–∑ –Ω–∞ –∫–∞—Ä—Ç–∫—É,4829,4829,-10000,-267,840,0,0,2232994,True
6K4W40IpKHH8mTjimw,1693905182,Aptechniypunkt1Apteki1,5912,5912,-420,-420,980,0,8,2242994,False,0533-8129-X94X-0C07
iacv8xMbIVuydpGKXg,1693887920,–ü–µ—Ä–µ–∫–∞–∑ –Ω–∞ –∫–∞—Ä—Ç–∫—É,4829,4829,-1000000,-1000000,980,0,0,2243414,True
GJH-jR4vaXEFb5xjOA,1693845122,–°—ñ–ª—å–ø–æ,5411,5411,-34514,-34514,980,0,0,3243414,False,T5EX-PE2B-10BP-T76X
jbSYKZLWdG226sqOxg,1693819469,–°—ñ–ª—å–ø–æ,5411,5411,-29105,-29105,980,0,0,3277928,False,T819-T8M4-KP0C-AMCB
0NHcHrsI9vYTeATOEg,1693817505,–íi–¥: –ü–†–ò–•–û–î–¨–ö–û –ï.–í. –§–û–ü,"–î–ª—è –ø–æ–ø–æ–≤–Ω–µ–Ω–Ω—è –∫–∞—Ä—Ç–∫–∏ 5375414101190360, –ü—Ä–∏—Ö–æ–¥—å–∫–æ –ï—Ä–Ω–µ—Å—Ç –íi–∫—Ç–æ—Ä–æ–≤–∏—á, 3487403339",4829,4829,2200000,2200000,980,0,0,3307033,True
5ob254UK92EexCrQ3g,1693807312,LaFabrique,5814,5814,-15000,-15000,980,0,0,1107033,False,K4HM-AKXC-B6EK-7A71
-g7zUnnO7gTqg_jGLg,1693760220,–û–≤–æ—á—ñ —Ç–∞ —Ñ—Ä—É–∫—Ç–∏,5499,5499,-18000,-18000,980,0,0,1122033,False,9327-TH2T-9PA8-7981
Rf5t2tQdlU3UPPubKQ,1693760053,–°—ñ–ª—å–ø–æ,5411,5411,-138135,-138135,980,0,0,1140033,False,CHE8-HP1X-88TK-XPCX
U-tv7iT3Zp0c5-tyzQ,1693755962,–í—ñ–¥: –í–ª–∞–¥–∏—Å–ª–∞–≤ –ß–æ—Ä–Ω–∏–π,—Å–ø–ª—ñ—Ç,4829,4829,19166,19166,980,0,0,1278168,True
hJmL4_UX4Lam6C60LA,1693751873,ParkSovki,5814,5814,-5500,-5500,980,0,0,1259002,False,AB0T-X852-3407-379E
nAewuHpMEqjvi8o89A,1693751832,ParkSovki,5814,5814,-4000,-4000,980,0,0,1264502,False,9BM0-PP0A-XXM7-H20T
Bb9y6Mcugl8d6uRsLw,1693727273,–í–µ—Ç–µ—Ä–∏–Ω–∞—Ä–Ω–∞ –∞–ø—Ç–µ–∫–∞,742,742,-120000,-120000,980,0,0,1268502,False,8P49-38KM-9K60-M22T
A1glz-jnmaCxPILRFQ,1693725118,BestWayToCup,5814,5814,-14500,-14500,980,0,0,1388502,False,BAET-T98X-12K8-M2M4
_4MZYDiF1uhTXRB6DA,1693723196,RIZNI,5812,5812,-40500,-40500,980,0,0,1403002,False,0KPB-53AX-M495-8731
GXPEYKoGRM2QgR6evw,1693678995,–ü–∞—Ä–∫–æ–≤–∫–∞,7523,7523,-12000,-12000,980,0,0,1443502,False,7P3A-59T7-2815-1682
i18VS7lJBUiUImHNcg,1693677452,FDY*FOOD,5499,5499,-62275,-62275,980,0,0,1455502,False,5P49-19M9-AT59-6EA3
zR76KA_iCAHdCTyyig,1693676296,SPILKA,5812,5812,-10500,-10500,980,0,0,1517777,False,5K3K-02CM-5452-B65T
NasqNq_0_rXpgDKOAw,1693657151,RESTAURANT PYVNA DUMA,5812,5812,-15500,-15500,980,0,0,1528277,False,K01B-2027-46A0-100E
wl1AbXVQ9rYWwOD2UA,1693655394,Uklon,4121,4121,-5500,-5500,980,0,0,1543777,False,38KK-K919-ABME-A05M
u3fmTbA3BLkxJwnayw,1693584462,Uklon,4121,4121,-7000,-7000,980,0,0,1549277,False,T44T-47M0-C736-HHB9
EM0E4PaHAZm-yGl11Q,1693582865,Uklon,4121,4121,-29000,-29000,980,0,0,1556277,False,5394-93PA-97E2-C6TP
ZYyApOEXGNGsBEP2Vw,1693548177,City24 Swift Garant,4816,4816,-35875,-35875,980,0,0,1585277,False,8T3E-0K0T-M5EH-BCH1
0dCNxwggjUekWUoW9g,1696005447,–ü–æ–ø–æ–≤–Ω–µ–Ω–Ω—è ¬´–°–ª–æ–±—ñ–¥–∫–∞ –¥–æ–Ω–∞—Ç–∏—Ç—å ‚ö°Ô∏è¬ª,4829,4829,-50000,-50000,980,0,0,1536999,True,8T41-ME5M-E930-2PB5
Pz0CFiZ5sViEP3LJkw,1695904680,–†—É—Å–ª–∞–Ω –î.,4829,4829,-86500,-86500,980,0,0,1586999,True,64EE-0K5T-6CH2-173T
QIwoqZh_cPprka_J5A,1695821495,Lesya,4829,4829,-150000,-150000,980,0,0,1673499,True,P599-PB3M-PK17-1T1K
wALvDfu0ZHSEJ8nd0w,1695721418,–ü–µ—Ä–µ–∫–∞–∑ –Ω–∞ –∫–∞—Ä—Ç–∫—É,4829,4829,-200000,-200000,980,0,0,1823499,True
R2e-nSBLcyMTGpjkpA,1695719886,–ì–∞–Ω–Ω–∞ –ü.,4829,4829,-84000,-84000,980,0,0,2023499,True,P2MP-PEA7-MXA9-1PK6
2y5rHvYBuMzxWRUddQ,1695522127,–†–µ–≥—É–ª—è—Ä–Ω–µ –ø–æ–ø–æ–≤–Ω–µ–Ω–Ω—è ¬´–§–æ–Ω–¥ –ü–æ–≤–µ—Ä–Ω–∏—Å—å –∂–∏–≤–∏–º¬ª,4829,4829,-25000,-25000,980,0,0,2107499,True
hjATXNylWtIdeEYq8g,1695103518,–ó –ø–ª–∞—Ç–∏–Ω–æ–≤–æ—ó –∫–∞—Ä—Ç–∫–∏,4829,4829,220000,220000,980,0,0,2132499,True
NSNQ_KmfG_dih5sGbQ,1694928086,–†–µ–≥—É–ª—è—Ä–Ω–µ –ø–æ–ø–æ–≤–Ω–µ–Ω–Ω—è ¬´–§–æ–Ω–¥ –ü–æ–≤–µ—Ä–Ω–∏—Å—å –∂–∏–≤–∏–º¬ª,4829,4829,-25000,-25000,980,0,0,1912499,True
tKUNwaadA3BDvqZyAw,1694620281,–ü–æ–ø–æ–≤–Ω–µ–Ω–Ω—è ¬´–ù–∞ –º–∞–≤—ñ–∫–∏ –¥–ª—è 77¬ª,4829,4829,-100000,-100000,980,0,0,1937499,True,MXT4-6P47-MKKH-B7C8
KaOPes-qLeNQLnsSGw,1694436167,–í—ñ–¥: –û–ª–µ—Å—è –°–∞—á–µ–Ω–∫–æ,–≥—Ä–æ—à—ñ–∫–∏–∏–∏–∏–∏,4829,4829,1000000,1000000,980,0,0,2037499,True
OIwcOslOpAOyF500Kg,1694361742,–í—ñ–∫—Ç–æ—Ä—ñ—è –ì.,4829,4829,-6000,-6000,980,0,0,1037499,True,6KH2-PXMP-1PAA-PAT5
IiZfugmk9m65CbvZRA,1694337011,–ü–æ–ø–æ–≤–Ω–µ–Ω–Ω—è ¬´–ù–∞ –°–°–û¬ª,4829,4829,-50000,-50000,980,0,0,1043499,True,CK5H-7X65-H306-H353
_x1A8F0fAGbZye5TiQ,1694323492,–†–µ–≥—É–ª—è—Ä–Ω–µ –ø–æ–ø–æ–≤–Ω–µ–Ω–Ω—è ¬´–§–æ–Ω–¥ –ü–æ–≤–µ—Ä–Ω–∏—Å—å –∂–∏–≤–∏–º¬ª,4829,4829,-25000,-25000,980,0,0,1093499,True
q2mmr_7VBWpaXBa3PQ,1694116407,–ü–æ–ø–æ–≤–Ω–µ–Ω–Ω—è ¬´–ù–∞ —Ä–µ–º–æ–Ω—Ç –∫–æ—Ä—á—ñ–≤ 93¬ª,4829,4829,-50000,-50000,980,0,0,1118499,True,PE3E-X7TC-H825-6989
iAs96F2gtgKXYPgz6A,1693996401,–õ—ñ–ª—ñ—è –ö.,4829,4829,-47500,-47500,980,0,0,1168499,True,780K-7664-MBCA-957M
GOZUJT0SewPUCfX12g,1693887920,–ó –ø–ª–∞—Ç–∏–Ω–æ–≤–æ—ó –∫–∞—Ä—Ç–∫–∏,4829,4829,1000000,1000000,980,0,0,1215999,True
B9aUhR1Xpo81T3KcnQ,1693718492,–†–µ–≥—É–ª—è—Ä–Ω–µ –ø–æ–ø–æ–≤–Ω–µ–Ω–Ω—è ¬´–§–æ–Ω–¥ –ü–æ–≤–µ—Ä–Ω–∏—Å—å –∂–∏–≤–∏–º¬ª,4829,4829,-25000,-25000,980,0,0,215999,True
YsYBnMHfp0q8wmwfMw,1693653844,–ú–∞–º–∞,4829,4829,-700000,-700000,980,0,0,240999,True,5TM9-1996-K0CB-H2PT
OhnL3BCL2eAi_Wy4cQ,1698691669,Bolt,4121,4121,-18600,-18600,980,0,139,1162088,False,5M52-KATM-B26E-0TCK
oJf8W02GVx0mVGyQtw,1698673390,Bolt,4121,4121,-12900,-12900,980,0,96,1180688,False,XHM2-71T6-E3M7-7MEM
NQbM-o_q0RNL5mJapQ,1698669229,–ê–ø—Ç–µ–∫–∞ ¬´–ê–ª–≥–æ-–§–∞—Ä–º¬ª,5912,7210,-7490,-7490,980,0,0,1193588,False,HTM8-3CK2-4MC5-M90E
toY8TJ-WONifznkp5Q,1698667459,Bolt,4121,4121,-12000,-12000,980,0,90,1201078,False,437H-C751-8A23-KHMT
IS9Cl3Binhyi6AGhAw,1698663463,Bolt,4121,4121,-16400,-16400,980,0,123,1213078,False,1TTC-8KKK-C378-6AAC
rkg10DwNoFgTxwqe-w,1698655894,–ù–æ–≤–∞ –ø–æ—à—Ç–∞,7399,7399,-29000,-29000,980,0,0,1229478,False,T781-M61K-1BM3-9XPP
KI0wEvFvSaGu8ef4Ew,1698602142,FDY*Merchandise,5399,5399,-208700,-208700,980,0,0,1258478,False,E7BA-8KMA-B360-525M
6Fc1vum6hI2-PuLjSA,1698598870,Pethouse,5995,5995,-408200,-408200,980,0,0,1467178,False,M4P9-C2M0-3P2X-HKT1
1_raz6xZnO23csG8OQ,1698596259,FDY*FOOD,5499,5499,-50465,-50465,980,0,0,1875378,False,4M39-A4KM-46H7-7022
H8Q4JrMwissl2_Y6CA,1698593101,SHOPSILPO,5411,5411,-147252,-147252,980,0,0,1925843,False,0PM6-710B-57M4-M90B
TgaSBa4rJZUE_XZSaA,1698583924,–ü–µ—Ä–µ–∫–∞–∑ –Ω–∞ –∫–∞—Ä—Ç–∫—É,4829,4829,-600000,-600000,980,0,0,2073095,True
EeM3Z2YONJq-xdPfVg,1698581536,APTECHNYJ PUNKT 2611,5912,5912,-12663,-12663,980,0,0,2673095,False,EBA4-8X0B-A04C-B0H3
yBPF_ZJeyfBDSYSjyg,1698563484,–û–±—Å–ª—É–≥–æ–≤—É–≤–∞–Ω–Ω—è –ø–ª–∞—Ç–∏–Ω–æ–≤–æ—ó –∫–∞—Ä—Ç–∫–∏,4829,4829,-30000,-30000,980,0,0,2685758,True
MDx2TiBVxpMQtPdIuA,1698511514,–íi–¥: –ë–ê–ëI–ß –í.–Æ. –§–û–ü,–ü–æ–≤–µ—Ä–Ω–µ–Ω–Ω—è –∫–æ—à—Çi–≤ –∑–∞ —Ç–æ–≤–∞—Ä –±—Ä–µ–Ω–¥—É O.TAJE –∑–≥i–¥–Ω–æ –±–ª–∞–Ω–∫—É –ø–æ–≤–µ—Ä–Ω–µ–Ω–Ω—è ‚Ññ –ë–í-1541 –≤i–¥ 25.10.2023 —Ä–æ–∫—É. –ë–µ–∑ –ü–î–í.,4829,4829,159920,159920,980,0,0,2715758,True
yspwzZiDuYetyRdxMQ,1698499697,Novapay,8999,8999,-11800,-11800,980,0,0,2555838,False,KCXK-7PPE-4A2P-AH41
LMslRtz6P-0LNv24mw,1698424298,magazin 762597,5912,5912,-2250,-2250,980,0,0,2567638,False,767T-10KT-M08P-X86H
PrA2zGY_HtxaLZL0GA,1698417202,–íi–¥: –ü–†–ò–•–û–î–¨–ö–û –ï.–í. –§–û–ü,"–î–ª—è –ø–æ–ø–æ–≤–Ω–µ–Ω–Ω—è –∫–∞—Ä—Ç–∫–∏ 5375414101190360, –ü—Ä–∏—Ö–æ–¥—å–∫–æ –ï—Ä–Ω–µ—Å—Ç –íi–∫—Ç–æ—Ä–æ–≤–∏—á, 3487403339",4829,4829,2200000,2200000,980,0,0,2569888,True
LqOLsOywCGY-wjL-KA,1698414334,–°—ñ–ª—å–ø–æ,5411,5411,-147661,-147661,980,0,0,369888,False,BATM-3480-TXK5-6MA9
Yqo3DDkkSl7opOKFUA,1698412926,Bolt,4121,4121,-19600,-19600,980,0,147,517549,False,METC-C3K0-3MC1-C78E
nWPFEl72TtB_Cbgpsg,1698402078,Bolt,4121,4121,-12700,-12700,980,0,95,537149,False,881P-6TA8-46B2-0HH9
f_AB1_LHR6soTidy8g,1698400727,WFP.CLOTHIING,5651,5651,-369000,-369000,980,0,0,549849,False,C51P-401M-30A7-18C8
4ZXhIFXrB4Eek21vZQ,1698393651,StudijaKvitivtadekoruS,5992,5992,-143500,-143500,980,0,0,918849,False,9254-B6K1-72CT-E602
7zcrHG5PBQEaD1dg0A,1698392883,magazin 762597,5912,5912,-52920,-52920,980,0,0,1062349,False,A7P8-T61M-X34P-C64H
tTj9nl3kvAP88-QYHQ,1698336171,MasterZoo,5995,5995,-85050,-85050,980,0,0,1115269,False,HAXA-9PP1-7P3B-0PM1
AwUWgktqPD7MVtbLaw,1698335944,EVA,5977,5977,-6290,-6290,980,0,0,1200319,False,7PTM-HA79-7PA6-PM07
2JIYTfnxWAvS_MBHIg,1698319563,Bolt,4121,4121,-13700,-13700,980,0,102,1206609,False,E43H-M6TK-H57H-T9XX
SmuVQdW4FnZ5DMABeA,1698312479,APTECHNYJ PUNKT 2611,5912,5912,-65650,-65650,980,0,0,1220309,False,395K-58MX-3XA2-31KB
yrd9EGArHqmP7LMEgw,1698308769,Bolt,4121,4121,-10900,-10900,980,0,81,1285959,False,KKK7-4P7K-EC0A-MA1P
9wUZygCGwBf4jmgWUg,1698306916,–ö–æ–ª–æ,5411,5499,-4150,-4150,980,0,0,1296859,False,XC2X-9C74-MPK9-4M25
TSfHSALtemudPeFcig,1698303335,Bestwaytocup,5814,5814,-7000,-7000,980,0,52,1301009,False,506A-AC55-T2B5-0H5P
cZzxeROQ-fnO4fSyaw,1698303168,–¢–∞–±–∞–∫–µ—Ä–∫–∞,5993,5993,-163800,-163800,980,0,0,1308009,False,X032-800K-HEE1-4M6X
LJaKO43Vt6NUmLDUwg,1698303067,Novus,5411,5411,-45547,-45547,980,0,0,1471809,False,H2X8-CMPE-5M9M-2MAP
Hg2p_ZJ3IlHv91gQZg,1698302511,magazin 762597,5912,5912,-57916,-57916,980,0,0,1517356,False,EEA7-B2A5-62A4-BCCM
biUOv43iLzrKs6zTUw,1698248225,Bolt,4121,4121,-19500,-19500,980,0,146,1575272,False,X6PC-2PM8-468B-0PXP
7IgFsvQS8g1zJfIS3g,1698239263,Bolt,4121,4121,-12100,-12100,980,0,90,1594772,False,801T-69H4-2K3E-9BA1
rCwXSNng6_JSUA6LWw,1698228703,Bolt,4121,4121,-14700,-14700,980,0,110,1606872,False,HP8E-8M4M-7XTC-8H34
_nOIh5nPMKf9VYOv4Q,1698218920,Bolt,4121,4121,-12200,-12200,980,0,91,1621572,False,PMBE-3X56-M65T-HT0X
5LN4hnzrsknPOaopgw,1698178236,FDY*TAXICABS-S,4121,4121,-33200,-33200,980,0,249,1633772,False,A2C9-8889-00M5-14A1
TCaazdSxwFvmmyJtRQ,1698162825,–°—ñ–ª—å–ø–æ,5411,5411,-170730,-170730,980,0,0,1666972,False,0C9K-89XB-395M-8MCP
tWz-9oxrRyM80DwSRw,1698162459,SECHST,5912,5912,-92038,-92038,980,0,0,1837702,False,827M-BK44-K5XK-K8T4
ZBQz_Nue_JzVDxFRww,1698149853,LOKO,5411,5411,-40800,-40800,980,0,0,1929740,False,65P6-TB3T-AM34-BX1C
F_cB6oNHoVg9FCqVNQ,1698132198,Bestwaytocup,5814,5814,-43000,-43000,980,0,491,1970540,False,TE14-81XB-5T26-6HTE
3BZP9hGlc2rARQ-y_w,1698077767,–ï–ª–µ–∫—Ç—Ä–æ—Å–∞–º–æ–∫–∞—Ç–∏ Bolt,7999,7999,-6695,-6695,980,0,0,2013540,False,56X8-E6KP-E0AK-0M4P
ze5yDeojbjrAF5mnrQ,1698077301,magazin778566,5912,5912,-7550,-7550,980,0,0,2020235,False,3H8M-617H-H6HP-7XK5
iaWx1drdjIYGxzul5w,1698076774,–ù–æ–≤–∞ –ø–æ—à—Ç–∞,7399,7399,-8500,-8500,980,0,0,2027785,False,E0C9-P2HA-MPEH-BPP2
2k9audBCnpiKqKSQqg,1698060588,Lesya,4829,4829,-220000,-220000,980,0,0,2036285,True,2C53-P64B-05BP-2A74
kY7SrGOw2wTqLLjg5A,1698060578,–ü–µ—Ä–µ–∫–∞–∑ –Ω–∞ –∫–∞—Ä—Ç–∫—É,4829,4829,-100000,-100000,980,0,0,2256285,True
3-gWtuIiij_4L_evrw,1698058725,Lesya,4829,4829,-100000,-100000,980,0,0,2356285,True,H34E-5A21-6K8P-9A7K
wqkjkIvF-xMayFB_vg,1698051167,–íi–¥: –ü–†–ò–•–û–î–¨–ö–û –ï.–í. –§–û–ü,"–î–ª—è –ø–æ–ø–æ–≤–Ω–µ–Ω–Ω—è –∫–∞—Ä—Ç–∫–∏ 5375414101190360, –ü—Ä–∏—Ö–æ–¥—å–∫–æ –ï—Ä–Ω–µ—Å—Ç –íi–∫—Ç–æ—Ä–æ–≤–∏—á, 3487403339",4829,4829,2200000,2200000,980,0,0,2456285,True
RIsSFgy0TdC_h-Wr3w,1697990503,LOKO,5411,5411,-27100,-27100,980,0,0,256285,False,K341-K160-A20H-T166
i0cdA-1F0cWDXEYMQQ,1697976031,–ö–≤—ñ—Ç–∏,5992,5992,-15000,-15000,980,0,0,283385,False,CH0M-HA79-X84M-K9PH
u9M76AOIdCBlf5srJQ,1697975734,RIZNI,5812,5812,-4500,-4500,980,0,33,298385,False,MA16-MKC9-H080-A41A
W_aQH8l3fdZFPbIvqw,1697975502,–ù–æ–≤–∞ –ø–æ—à—Ç–∞,7399,7399,-7800,-7800,980,0,0,302885,False,MC93-M26P-B9PC-4KAB
6CDP9TzKT5Ui-7RivQ,1697975223,Bestwaytocup,5814,5814,-14000,-14000,980,0,105,310685,False,X0EK-M9EP-8HM4-MP54
Ccaz2H7Z8UC61A6LjQ,1697902728,–°—ñ–ª—å–ø–æ,5411,5411,-104938,-104938,980,0,0,324685,False,3MB3-X6CP-C8K1-3669
srDuikvvfNtjb4Q3HA,1697901687,–ï–ª–µ–∫—Ç—Ä–æ—Å–∞–º–æ–∫–∞—Ç–∏ Bolt,7999,7999,-1842,-1842,980,0,0,429623,False,74AH-PP58-B1TE-6EH1
02taq893gOFBZVuC9g,1697892572,Steam,5816,5816,-42458,-41500,980,0,0,431465,False,9TXA-1637-5X49-HXBT
YYUODinibDu-XnxxPA,1697881855,Novus,5411,5411,-19195,-19195,980,0,0,473923,False,XTA9-MB05-2HPE-7958
xkTso71zwnPBSnP-Tw,1697881423,–ó –±—ñ–ª–æ—ó –∫–∞—Ä—Ç–∫–∏,4829,4829,300000,300000,980,0,0,493118,True
ydYPILdlyPzBRYkddA,1697881283,magazin 762597,5912,5912,-217725,-217725,980,0,0,193118,False,HHTC-7A4H-853A-M68H
y526Z2WH19qDJl8m9w,1697834353,LIQPAY*O.Taje,5651,5651,-159920,-159920,980,0,0,410843,False,1789-E3P1-8KC3-4678
eD3GGZlYFhQoCIY6Bw,1697833890,–í—ñ–¥: –û–ª–µ—Å—è –°–∞—á–µ–Ω–∫–æ,–Ω–∞ –∫–æ—Ñ—Ç–∏–Ω—É,4829,4829,160000,160000,980,0,0,570763,True
t1VOwaWqlopICGBt9A,1697830449,–°–∫–∞—Å—É–≤–∞–Ω–Ω—è. Steam,5816,5816,67580,66000,980,0,0,410763,False
IbzaO4gSxVc-eeS9Ug,1697824943,30880,5912,5912,-13200,-13200,980,0,0,343183,False,XCE1-509X-1EX2-9KHH
LN-ozWT2MqfFKLFNng,1697815674,Steam,5816,5816,-67580,-66000,980,0,0,356383,False
ltn1pZoNxGPJCNpGCQ,1697782104,HliBar,5462,5462,-25500,-25500,980,0,0,423963,False,8KAT-1428-C40C-AXXM
Cp1OAHqnbmNn3h5JAQ,1697733281,–°—ñ–ª—å–ø–æ,5411,5411,-7796,-7796,980,0,0,449463,False,M1C8-XC6P-9A43-H2X4
p43Xu42OuGoHLWoVgQ,1697733042,–°—ñ–ª—å–ø–æ,5411,5411,-118138,-118138,980,0,0,457259,False,P8AA-3AT8-C8HT-6C4E
I3lwF5c6DBVmJj5ZaA,1697696579,–ù–æ–≤–∞ –ø–æ—à—Ç–∞,7399,7399,-10000,-10000,980,0,0,575397,False,EB3P-B770-6753-KT29
5rg8qqURSrwcDgPtiw,1697643608,FDY*Merchandise,5399,5399,-62390,-62390,980,0,0,585397,False,7555-ET9K-1B4C-209K
9beeT2_SCnVwi9FNVA,1697635197,Novus,5411,5411,-3999,-3999,980,0,0,647787,False,752C-P5KK-XBPH-1BAA
8vVL_o3D0Qo6kCrrww,1697634917,magazin 762597,5912,5912,-16251,-16251,980,0,0,651786,False,4AP1-6T85-PM2E-H2M6
iCJhFg9RLn2BoMYJfQ,1697624696,BarTCBolshevik,5814,5814,-7500,-7500,980,0,56,668037,False,P7HX-CA14-7M78-1XAB
yKLrbu_Q3so5sJNUmQ,1697624516,–ö–æ—Å–º–æ—Å,7832,7832,-15000,-15000,980,0,0,675537,False,5PMP-C7KE-TECX-P09K
pbeCTtP7ILOu7reK5w,1697622685,FDY*TAXICABS-S,4121,4121,-17900,-17900,980,0,134,690537,False,HTBC-53BM-X74P-7131
TXzUDa4Bp7PMyNWjOw,1697612491,Bestwaytocup,5814,5814,-7000,-7000,980,0,52,708437,False,07XA-07X1-HKX3-073H
jR7Wv3HkDgKYRrK9VA,1697612250,–¢–∞–±–∞–∫–µ—Ä–∫–∞,5993,5993,-81900,-81900,980,0,0,715437,False,5P2E-X01P-HE39-5B39
fyWj17JO9JP83OXp7w,1697612109,Novus,5411,5411,-49815,-49815,980,0,0,797337,False,EM2K-C4E2-1E4B-3BK6
nsL0cNYZzfU2Nv_c4Q,1697561269,–ï–ª–µ–∫—Ç—Ä–æ—Å–∞–º–æ–∫–∞—Ç–∏ Bolt,7999,7999,-1595,-1595,980,0,0,847152,False,MT16-MTKP-MH90-B7B6
7e2QCJ25WatzMkohuw,1697561078,–°—ñ–ª—å–ø–æ,5411,5411,-67898,-67898,980,0,0,848747,False,55H1-B1KH-4PTT-CTC8
nxAEo7PXjkEeFWjruw,1697560785,SECHST,5912,5912,-64970,-64970,980,0,0,916645,False,625H-5C7A-B8T2-6PC3
ktrNRBxrq482anJnjQ,1697560533,–ï–ª–µ–∫—Ç—Ä–æ—Å–∞–º–æ–∫–∞—Ç–∏ Bolt,7999,7999,-1633,-1633,980,0,0,981615,False,7AHC-4629-4X69-MXPM
uUuMgGdfXjqAmW235g,1697560099,FDY*FOOD,5499,5499,-79570,-79570,980,0,0,983248,False,8BCH-MCTK-6PB9-C7AX
dTXFnarif29Cw8X-zQ,1697553689,–ö–æ–ª–æ,5411,5499,-16050,-16050,980,0,0,1062818,False,9724-TB76-H3EM-8ACK
MWss64JEmmGNd5dOsA,1697550584,LIQPAY*Pozabotko,5200,5200,-45000,-45000,980,0,0,1078868,False,6M0A-M437-3XXT-K72P
UgbZzz_30bI-F-3gRg,1697532121,–í—ñ–¥: –û–ª–µ—Å—è –°–∞—á–µ–Ω–∫–æ,4829,4829,800000,800000,980,0,0,1123868,True
CdRVODPB7blok6hL4Q,1697524191,–ö–≤—ñ—Ç–∏,5992,5992,-95000,-95000,980,0,0,323868,False,876X-HEH6-XEK5-P3T5
32VZr-K21OfkCErF9g,1697470832,–ê–ø—Ç–µ–∫–∞ –ê–ù–¶,5912,5912,-39130,-39130,980,0,0,418868,False,MH8A-8B73-4HB8-5E7T
2Hzdd3vf2Khmejf4TQ,1697469696,–ü–∏—Ä—ñ–∂–∫–æ–≤–∞ ¬´–¢—ñ—Ç–∫–∞ –ö–ª–∞—Ä–∞¬ª,5814,5814,-34500,-34500,980,0,258,457998,False,02H2-3PT8-X104-PCHP
Bjkd1JPoGtEF0a3I8A,1697461207,–í—ñ–¥: –û–ª–µ—Å—è –°–∞—á–µ–Ω–∫–æ,4829,4829,366900,366900,980,0,0,492498,True
KAqdcwgRY-pd1oovXQ,1697395788,FREEPEOPLE.COM #2899,5651,5651,-366918,-9800,840,0,0,125598,False,H4HA-353H-1E87-B69T
aUicT_laokvOugNQbQ,1697394758,Pethouse,5995,5995,-408200,-408200,980,0,0,492516,False,PEXC-P821-63KP-C5BT
GkRNqHzSOzy7LTYzUw,1697372633,–ö–æ–ª–æ,5411,5499,-16250,-16250,980,0,0,900716,False,KATX-9937-3M86-5HMM
al-XlaUel-ObgvdVqw,1697372255,–°—ñ–ª—å–ø–æ,5411,5411,-201295,-201295,980,0,0,916966,False,M9H3-6527-9TKH-AT4C
T2wPv-NtcLtfrNP8OA,1697368643,OKKO,5541,5541,-205946,-205946,980,0,0,1118261,False,P16A-437B-BCKT-046E
tydzAaNHxh8kI8lQhw,1697367865,FOP YaSTREB O.O.,5944,5944,-218000,-218000,980,0,0,1324207,False,620X-97H6-88KE-6AKP
tBo3ULYQHI8vshaOSQ,1697300203,"Lifecell
+380731983817",4814,4814,-17000,-17000,980,0,0,1542207,True,5759-88BK-7P4M-TA3X
2nHWkoysvARWuny-Ww,1697297058,lifecell,4814,4814,-5000,-5000,980,0,0,1559207,False,5HPX-30MX-E7E8-29P6
5oTzPQZHHTxWe-xjdA,1697290450,FOP Kovtun VV,5814,5814,-42000,-42000,980,0,315,1564207,False,66A1-1E9A-0HCB-41AE
KSRUQ6pxa5t8J55-2A,1697290430,Bilyardna,5814,5814,-66100,-66100,980,0,495,1606207,False,PTX3-XPK1-2T5X-59XH
L-Isno9T14tTxOwTRw,1697284084,–ï–ª–µ–∫—Ç—Ä–æ—Å–∞–º–æ–∫–∞—Ç–∏ Bolt,7999,7999,-2306,-2306,980,0,0,1672307,False,X042-MH6H-06B2-7274
h-XJyIzHIgAn66nkSA,1697280206,–ö–∏—ó–≤—Å—å–∫–∏–π –∑–æ–æ–ª–æ–≥—ñ—á–Ω–∏–π –ø–∞—Ä–∫ –∑–∞–≥–∞–ª—å–Ω–æ–¥–µ—Ä–∂–∞–≤–Ω–æ–≥–æ –∑–Ω–∞—á–µ–Ω–Ω—è,7941,7523,-12000,-12000,980,0,0,1674613,False,XBEK-X1TH-76E8-E31C
JxDJra8TAj0dG99H2Q,1697272976,–ö–∏—ó–≤—Å—å–∫–∏–π –∑–æ–æ–ª–æ–≥—ñ—á–Ω–∏–π –ø–∞—Ä–∫ –∑–∞–≥–∞–ª—å–Ω–æ–¥–µ—Ä–∂–∞–≤–Ω–æ–≥–æ –∑–Ω–∞—á–µ–Ω–Ω—è,7941,7523,-40000,-40000,980,0,0,1686613,False,17AP-7H70-4TCC-45T7
3LRmpARTF6tgSFVPFg,1697270134,Bestwaytocup,5814,5814,-7000,-7000,980,0,52,1726613,False,KC4K-TXH9-3BAE-P0C6
VWdTFhDsEHQSOVYaMg,1697268676,Bestwaytocup,5814,5814,-24500,-24500,980,0,183,1733613,False,EMKE-M85T-7B52-B3CH
gMBLf_jOQ9sS3X_OSg,1697268414,–¢–∞–±–∞–∫–µ—Ä–∫–∞,5993,5993,-163800,-163800,980,0,0,1758113,False,95P3-A206-9894-08AT
mCbdHP-vsqkqqiiSEw,1697268346,Novus,5411,5411,-3599,-3599,980,0,0,1921913,False,1M93-T7C6-K47C-2TE3
pD62h77vTTKZiCEh9Q,1697268199,LaFabrique,5814,5814,-11000,-11000,980,0,82,1925512,False,2A4H-B486-5MMM-T83T
xgvDMUZneTGr3z8ABA,1697268017,magazin 762597,5912,5912,-212262,-212262,980,0,0,1936512,False,7115-1XX8-1M71-9PAB
IqD-iNqjeOPGY9a1mw,1697232434,–í—ñ–¥: –í–ª–∞–¥–∏—Å–ª–∞–≤ –ß–æ—Ä–Ω–∏–π,—Å–ø–ª—ñ—Ç,4829,4829,132000,132000,980,0,0,2148774,True
SWCNr_H9jWl4TTOdmw,1697209254,Uklon,4121,4121,-11800,-11800,980,0,590,2016774,False,H32A-PKX7-ME7M-79X5
y7VYIFfj0C3r-ao3nw,1697191092,ITIS CAFE,5814,5814,-17800,-17800,980,0,356,2028574,False,A116-7914-8P36-9M74
Qwr27Jt2UmNt_MDXxA,1697190895,–ü–µ—á–µ–Ω–∞ –ö–∞—Ä—Ç–æ–ø–ª—è,5814,5814,-39600,-39600,980,0,792,2046374,False,E337-3T07-8PA4-55X1
z5qFeo2y6hSQ2DlQvA,1697189274,–ü–µ—Ä–µ–∫–∞–∑ –Ω–∞ –∫–∞—Ä—Ç–∫—É,4829,4829,-700000,-700000,980,0,0,2085974,True
F-jhEYXepaC5nd1KlQ,1697188261,–íi–¥: –ü–†–ò–•–û–î–¨–ö–û –ï.–í. –§–û–ü,"–î–ª—è –ø–æ–ø–æ–≤–Ω–µ–Ω–Ω—è –∫–∞—Ä—Ç–∫–∏ 5375414101190360, –ü—Ä–∏—Ö–æ–¥—å–∫–æ –ï—Ä–Ω–µ—Å—Ç –íi–∫—Ç–æ—Ä–æ–≤–∏—á, 3487403339",4829,4829,2200000,2200000,980,0,0,2785974,True
6g8IIvBw1kcz6f-Uyw,1697183160,FDY*JEWELRY,5944,5944,-145500,-145500,980,0,0,585974,False,M8KX-9K52-64K5-P911
jzPxUBjYTe2BJ0QfWQ,1697129819,Novus,5411,5411,-8299,-8299,980,0,0,731474,False,CT8T-8TTP-TT2P-KEE1
5TcSNSU-whiIC2ixQg,1697126755,–û—Ñ—ñ—Å-—á–∞–π,5812,5812,-15800,-15800,980,0,118,739773,True,0P1M-CCAT-M03B-KBK7
_eFkWpW5ore1gAW2ug,1697124309,Kafe Kharms,5814,5814,-45000,-45000,980,0,337,755573,False,6969-1X4E-A728-732E
L1Da1rPN4G2VRT1rvw,1697111700,Kafe Kharms,5814,5814,-5760,-5760,980,0,43,800573,False,0MCH-M04H-310H-63XB
2SXA6hXPr-XbR6lW6A,1697110739,Kafe Blue cup,5814,5814,-6900,-6900,980,0,51,806333,False,AK2T-29EP-8B93-94MH
XbAZsTzW4CAFu4iDWw,1697110316,Smertkacapam,5814,5814,-27000,-27000,980,0,202,813233,False,16MB-EH43-MAT9-M8TE
MbCGDN7OSeps-En5Ow,1697107646,FDY*TAXICABS-S,4121,4121,-14000,-14000,980,0,105,840233,False,M5BH-KMK8-A52E-8MT7
xC6gKZnVdwK7BMgC8Q,1697102053,LIQPAY*GO Agenti Krovi,8661,8661,-30000,-30000,980,0,0,854233,False,K54C-3308-EM3K-PA6E
080fQ1ScfX2LImlYQA,1697093233,FDY*TAXICABS-S,4121,4121,-22000,-22000,980,0,165,884233,False,4MXH-PT68-52B0-9T77
p_rANJpEeuisdSZ55Q,1697045298,Yaroslaviv Val 37-1,5921,5921,-18100,-18100,980,0,0,906233,False,3CAC-3E34-3X35-9248
ykf_WfdP3oTPaQ-VbQ,1697045123,–í–ê–†–¶–ê–ë,5814,5814,-41000,-41000,980,0,307,924333,False,47PM-B057-M620-TM6C
WnLapt41UVDpU136qQ,1697018542,–°—ñ–ª—å–ø–æ,5411,5411,-14194,-14194,980,0,0,965333,False,MH31-4C5H-713X-B2H9
O9_CBEhW3PsuxsONRw,1696952457,–°—ñ–ª—å–ø–æ,5411,5411,-102325,-102325,980,0,0,979527,False,H186-53HK-2E87-XAKP
vvnaRDyCBwhICtb8eQ,1696952070,SECHST,5912,5912,-113347,-113347,980,0,0,1081852,False,49MK-X3XE-0BPE-3C9P
n4Kzy0KAt3-v9XiSmA,1696936052,Bolt Food,4215,4215,-45100,-45100,980,0,0,1195199,False,31X2-C7AB-T8MX-1EPH
x-q1lcda9jdrVBOs3A,1696922154,Bestwaytocup,5814,5814,-25500,-25500,980,0,191,1240299,False,H5HK-7C3H-PKCE-AP1K
Hv22oRcn8awAJD7yrQ,1696916960,Uklon,4121,4121,-13400,-13400,980,0,100,1265799,False,KX86-P3CP-9A6H-A562
Kj_-A1o_0Sg0mrHG6Q,1696875022,–°—ñ–ª—å–ø–æ,5411,5411,-57300,-57300,980,0,0,1279199,False,7TMT-5HT0-2B2E-BEMA
QYK1dQR15OPWkGlnCw,1696872886,Smartass KB,5814,5814,-14000,-14000,980,0,105,1336499,False,X79C-22B6-5MB1-377P
_Ix6JxGGND60v3s6Ag,1696868075,FITNES KLUB SMARTASS,7941,7941,-13000,-13000,980,0,0,1350499,False,KXCB-HC6B-12E5-E8M9
hj8VB1dnA4rB7sYLWw,1696846451,–°—ñ–ª—å–ø–æ,5411,5411,-15096,-15096,980,0,0,1363499,False,CA2P-BK34-M8X9-4C8A
ObWpM8F8anYG6d251w,1696771466,PARK ROZVAG,7994,7994,-20000,-20000,980,0,0,1378595,False,XT97-3K6B-BA91-B8C9
hUUNNl9Xvc4WEKg5IA,1696770627,PARK ROZVAG,7994,7994,-20000,-20000,980,0,0,1398595,False,2C5E-73X3-3H9P-7E5B
3138yjaGZSQWMkBPPQ,1696762653,KOKAbubbletea,5814,5814,-32000,-32000,980,0,240,1418595,False,776B-KH1P-E5TC-B55X
my-5Fgo-4E2URpOYiA,1696750634,–ö–æ–ª–æ,5411,5499,-11150,-11150,980,0,0,1450595,False,66HB-AE51-HTXT-H25T
O8mskAheloRWu8VNHg,1696689046,Banya,7298,7298,-850000,-850000,980,0,0,1461745,False,97XA-088M-2E43-K5CE
rS8DVYEzK7JgPcKHPA,1696686570,–ü–µ—Ä–µ–∫–∞–∑ –Ω–∞ –∫–∞—Ä—Ç–∫—É,4829,4829,-500000,-500000,980,0,0,2311745,True
qVk7S8sdtgdpGqzXQw,1696686530,–í—ñ–¥: –û–ª–µ—Å—è –°–∞—á–µ–Ω–∫–æ,4829,4829,630000,630000,980,0,0,2811745,True
NgYa5IJ42AvHNN8PBw,1696676622,–ü–µ—Ä–µ–∫–∞–∑ –Ω–∞ –∫–∞—Ä—Ç–∫—É,4829,4829,-300000,-300000,980,0,0,2181745,True
S0-kDeTPBYGjeMNZeA,1696674953,–íi–¥: –ü–†–ò–•–û–î–¨–ö–û –ï.–í. –§–û–ü,"–î–ª—è –ø–æ–ø–æ–≤–Ω–µ–Ω–Ω—è –∫–∞—Ä—Ç–∫–∏ 5375414101190360, –ü—Ä–∏—Ö–æ–¥—å–∫–æ –ï—Ä–Ω–µ—Å—Ç –íi–∫—Ç–æ—Ä–æ–≤–∏—á, 3487403339",4829,4829,2000000,2000000,980,0,0,2481745,True
wxG3LKDkMKDxJsjSlA,1696673599,–ó –±—ñ–ª–æ—ó –∫–∞—Ä—Ç–∫–∏,4829,4829,300000,300000,980,0,0,481745,True
NkJYHkCpAyTruwyjVw,1696672011,–°—ñ–ª—å–ø–æ,5411,5411,-103266,-103266,980,0,0,181745,False,9M0A-P756-9583-1XH8
B1LcujogPabA4byFvQ,1696670806,magazin 726008,5912,5912,-60612,-60612,980,0,0,285011,False,AX3M-AB5K-P2C4-TT28
a9zSJfM4B9TeAJ5IRg,1696658466,–ü—Ä–æ–¥—É–∫—Ç–∏,5499,5499,-7400,-7400,980,0,0,345623,False,1TXC-TKBC-21EP-K631
W6YqVnDVL6W-FX6UEQ,1696584661,–°—ñ–ª—å–ø–æ,5411,5411,-36900,-36900,980,0,0,353023,False,K12B-KTBK-5CTM-1E4T
8vEVg0o5VhZFdy9ybw,1696572312,BestWayToCup,5814,5814,-40010,-40010,980,0,300,389923,False,E58B-8XPX-BX9H-B6TK
ynPlNMQKrnYA1J_xhg,1696526281,–ö–æ–ª–æ,5411,5499,-28350,-28350,980,0,0,429933,False,K384-1883-79A4-5X71
FYkSIjM1ugMzdUZhog,1696525197,FDY*FOOD,5499,5499,-96505,-96505,980,0,0,458283,False,K164-KHE4-CB59-6KM3
9mHFzbClx5H3M6ANfQ,1696516101,LIQPAY*ZL Vet,742,742,-70000,-70000,980,0,0,554788,False,75B8-M888-2KXC-EPCE
LsA52wLwCWLXLi9utQ,1696508727,FDY*Merchandise,5399,5399,-67550,-67550,980,0,0,624788,False,T5A9-2MTH-KBAT-PCB7
hPGp9UsIp8tIAC7uJg,1696508726,Pethouse,5995,5995,-440700,-440700,980,0,0,692338,False,9KBB-6BE4-TC9E-612X
2evZG1XBXCrtQ_rIsg,1696493660,UNIVERSUM CLINIC,8099,8099,-619000,-619000,980,0,0,1133038,False,2T0A-0B4H-2HX2-KBB9
KcbnZXecI875VXVIZw,1696486985,Smartass KB,5814,5814,-9000,-9000,980,0,67,1752038,False,62H1-AME3-PEXM-P1BT
VCCSNolrW8pNinwKlw,1696442355,IDEALIST COFFEE CO,5814,5814,-44700,-44700,980,0,335,1761038,False,M052-0CTC-T13B-4XBE
Qdx7ZqTiu64zMtVM3Q,1696419044,–¢–∞–±–∞–∫–µ—Ä–∫–∞,5993,5993,-156000,-156000,980,0,0,1805738,False,99P4-E62K-K173-E7TX
IVYKJrwTBHm82o_kTw,1696418945,Novus,5411,5411,-24487,-24487,980,0,0,1961738,False,T229-X7E4-2P16-0K52
BR3OB-Wk9vJAo3c18A,1696312556,magazin 762597,5912,5912,-93800,-93800,980,0,0,1986225,False,P7XM-MHT9-K32E-K46T
Ddf55_6kISB7S_gxUg,1696312432,FLOWER CLUB,5992,5992,-49000,-49000,980,0,0,2080025,False,K37T-9H45-PXXM-H3T0
cnlFJtG2HVjAdZEJag,1696312256,LaFabrique,5814,5814,-12000,-12000,980,0,240,2129025,False,53P5-C2C6-578B-37BC
tg0BsTojfJqQbbc6JA,1696312038,BestWayToCup,5814,5814,-19500,-19500,980,0,390,2141025,False,0X5M-B438-172A-69H5
C7qXLyP0Xt9QO5hyKw,1696267670,Lesya,4829,4829,-200000,-200000,980,0,0,2160525,True,A927-8MPP-6A81-198M
cMfiE6NHk1zrAfF4Bw,1696267599,–ü–æ–ø–æ–≤–Ω–µ–Ω–Ω—è ¬´–ù–∞ —Ç–∏—Ç–∞–Ω–æ–≤—É —Å–ø–∏–Ω—É¬ª,–í—ñ–¥ —à–∞–ª—Ñ–∞ üê∂,4829,4829,-500000,-500000,980,0,0,2360525,True,P4K7-T364-K6TE-0A87
9Gr1H7APRt5efCadqA,1696256559,–íi–¥: –ü–†–ò–•–û–î–¨–ö–û –ï.–í. –§–û–ü,"–î–ª—è –ø–æ–ø–æ–≤–Ω–µ–Ω–Ω—è –∫–∞—Ä—Ç–∫–∏ 5375414101190360, –ü—Ä–∏—Ö–æ–¥—å–∫–æ –ï—Ä–Ω–µ—Å—Ç –íi–∫—Ç–æ—Ä–æ–≤–∏—á, 3487403339",4829,4829,2800000,2800000,980,0,0,2860525,True
tVji-3J_013DReZ7IA,1696240708,–°—ñ–ª—å–ø–æ,5411,5411,-100,-100,980,0,0,60525,False,HEP7-T821-E1B3-T95A
tfTaNdZd28Y1XH2OCg,1696236110,–ï–ª–µ–∫—Ç—Ä–æ—Å–∞–º–æ–∫–∞—Ç–∏ Bolt,7999,7999,-5403,-5403,980,0,0,60625,False,1PEA-X44B-0447-2X23
x1wJHWX56o0Me4MLfQ,1696235816,Leilia Bakery,5814,5814,-36500,-36500,980,0,273,66028,False,M2AT-4HH0-BEM7-2TTK
4Bvt6kddSuS0RD4MCw,1696233567,–ö–∏—ó–≤—Å—å–∫–µ –º–µ—Ç—Ä–æ,4111,4111,-800,-800,980,0,0,102528,False,28P7-738A-CK77-37A4
kVFBanZuM1BUm37Cyg,1696233142,Bolt,4121,4121,-13400,-13400,980,0,100,103328,False,T3C1-6K3X-43C8-22XM
iYx9auBmJLHtbL4Ucg,1696168552,TRTSPlazma,7523,7523,-2000,-2000,980,0,0,116728,False,9B5X-KPMC-HE62-PK86
uko_VggRJrS7DjdRyg,1696160697,EVA,5977,5977,-10900,-10900,980,0,0,118728,False,E891-E13A-M1KH-43P2
v82pULHvTu-xSbq3GA,1696148089,–•–ª—ñ–±–Ω–∞ –ö–∞–≤–∞,5462,5462,-3500,-3500,980,0,0,129628,False,E30P-6XMC-880H-X833
LfRB7uSx9IOXSwlmXw,1698583924,–ó –ø–ª–∞—Ç–∏–Ω–æ–≤–æ—ó –∫–∞—Ä—Ç–∫–∏,4829,4829,600000,600000,980,0,0,668599,True
qLzvHPSjZd1abZHn1Q,1698549717,–†–µ–≥—É–ª—è—Ä–Ω–µ –ø–æ–ø–æ–≤–Ω–µ–Ω–Ω—è ¬´–§–æ–Ω–¥ –ü–æ–≤–µ—Ä–Ω–∏—Å—å –∂–∏–≤–∏–º¬ª,4829,4829,-25000,-25000,980,0,0,68599,True
oFpYLYRLPtrTrXVvBg,1698070087,–°–µ—Ä–≥—ñ–π –ó.,4829,4829,-10000,-10000,980,0,0,93599,True,0XE4-A852-K4K2-ET46
URwgf3_shgs5bHkm-A,1698060579,–ó –ø–ª–∞—Ç–∏–Ω–æ–≤–æ—ó –∫–∞—Ä—Ç–∫–∏,4829,4829,100000,100000,980,0,0,103599,True
VMBGOw9kIaUtU91IYQ,1697881423,–ü–µ—Ä–µ–∫–∞–∑ –Ω–∞ –∫–∞—Ä—Ç–∫—É,4829,4829,-300000,-300000,980,0,0,3599,True
u78_0bxM-tkZAjYYPw,1697336657,–†–µ–≥—É–ª—è—Ä–Ω–µ –ø–æ–ø–æ–≤–Ω–µ–Ω–Ω—è ¬´–§–æ–Ω–¥ –ü–æ–≤–µ—Ä–Ω–∏—Å—å –∂–∏–≤–∏–º¬ª,4829,4829,-25000,-25000,980,0,0,303599,True
A1ZjJ_vo08DLXbKquQ,1697285005,–ü–æ–ø–æ–≤–Ω–µ–Ω–Ω—è ¬´–º–∞—Ä–∫–µ—Ç –∑ carrot cake¬ª,4829,4829,-40000,-40000,980,0,0,328599,True,054T-4M5M-T0A6-4KM6
8qBxCu-0_FmwX4BrzA,1697284326,–ü–æ–ø–æ–≤–Ω–µ–Ω–Ω—è ¬´–±–ª–∞–≥–æ–¥—ñ–π–Ω–µ –±–∞—Ä–±–µ–∫—é¬ª,4829,4829,-50000,-50000,980,0,0,368599,True,XB5P-EET7-A0KP-C173
jGoYH53iLKn1uTYN0Q,1697197725,–ü–æ–ø–æ–≤–Ω–µ–Ω–Ω—è ¬´–ù–∞   –ü—ñ–∫–∞–ø¬ª,4829,4829,-100000,-100000,980,0,0,418599,True,T7C8-8CX1-P61H-79X5
1djBXD_cE1WiZ33x_w,1697189287,Lesya,4829,4829,-200000,-200000,980,0,0,518599,True,2029-09KP-X2HA-A9M6
OEniIkrPpaYQjYERAQ,1697189274,–ó –ø–ª–∞—Ç–∏–Ω–æ–≤–æ—ó –∫–∞—Ä—Ç–∫–∏,4829,4829,700000,700000,980,0,0,718599,True
StfXXhJ1-ID-DXke8Q,1697187963,Lesya,4829,4829,-300000,-300000,980,0,0,18599,True,E9EP-T6TC-TA24-7438
HyuNimHR6z-JIzaUUA,1696970704,Lesya,4829,4829,-200000,-200000,980,0,0,318599,True,XP4K-XAKK-C0B1-K11B
IWBaUo_hf5wtHutCbQ,1696834293,Lesya,4829,4829,-400000,-400000,980,0,0,518599,True,8K3A-49BX-KXBM-HEHM
RG0xMMCvqbVvl-On-g,1696731793,–†–µ–≥—É–ª—è—Ä–Ω–µ –ø–æ–ø–æ–≤–Ω–µ–Ω–Ω—è ¬´–§–æ–Ω–¥ –ü–æ–≤–µ—Ä–Ω–∏—Å—å –∂–∏–≤–∏–º¬ª,4829,4829,-25000,-25000,980,0,0,918599,True
z5hmTI320NRr4i-YYw,1696686570,–ó –ø–ª–∞—Ç–∏–Ω–æ–≤–æ—ó –∫–∞—Ä—Ç–∫–∏,4829,4829,500000,500000,980,0,0,943599,True
NsXy10aA0v5uGIa7aA,1696676622,–ó –ø–ª–∞—Ç–∏–Ω–æ–≤–æ—ó –∫–∞—Ä—Ç–∫–∏,4829,4829,300000,300000,980,0,0,443599,True
U-M2V_FLPqmDYzR3CA,1696673599,–ü–µ—Ä–µ–∫–∞–∑ –Ω–∞ –∫–∞—Ä—Ç–∫—É,4829,4829,-300000,-300000,980,0,0,143599,True
H9ZUoXX6MN-greZnRg,1696618560,–û–ª—å–≥–∞ –°.,4829,4829,-30500,-30500,980,0,0,443599,True,KT1A-5854-XPMB-TX86
0a0tQm-uSJrhnWvg8w,1696164313,Lesya,4829,4829,-500000,-500000,980,0,0,474099,True,02MM-39AC-E57K-PXE9
JSix3qllrcmzo8r3Pw,1696127266,–†–µ–≥—É–ª—è—Ä–Ω–µ –ø–æ–ø–æ–≤–Ω–µ–Ω–Ω—è ¬´–§–æ–Ω–¥ –ü–æ–≤–µ—Ä–Ω–∏—Å—å –∂–∏–≤–∏–º¬ª,4829,4829,-25000,-25000,980,0,0,974099,True
Srpno7ic9-_iJEDNpQ,1701258415,Libid,5814,5814,-9000,-9000,980,0,0,167230,False,98XM-49MM-XKK2-7X8T
NeoFzU24-UEUrrVR4g,1701241886,–û–±—Å–ª—É–≥–æ–≤—É–≤–∞–Ω–Ω—è –ø–ª–∞—Ç–∏–Ω–æ–≤–æ—ó –∫–∞—Ä—Ç–∫–∏,4829,4829,-30000,-30000,980,0,0,176230,True
G1Jx1jszt8u1QQ2Skg,1701241292,APTEKA 13,5912,5912,-45725,-45725,980,0,342,206230,False,9KXC-5759-XT4B-PCTP
yrjLzCMGvA_4d6o8mQ,1701196702,Novapay,8999,8999,-5000,-5000,980,0,0,251955,False,MXBT-H1C9-HT1E-918P
lpgBalLGrrtie-3aFg,1701191928,Novus,5411,5411,-42241,-42241,980,0,316,256955,False,P9MM-65H8-KCB1-7P17
EpUiHYEQ9jK2mjbpmA,1701181055,–ü—Ä–∏–≤–∞—Ç24: Ernest Prykhodko,6536,6536,160000,160000,980,0,0,299196,False
WVhLxS8y0fdWwzmvag,1701180947,FDY*Merchandise,5399,5399,-42350,-42350,980,0,317,139196,False,X5E2-X4KM-9K12-CPHP
BsB_ohS794XXL5GxLA,1701016110,APTEKA 13,5912,5912,-40980,-40980,980,0,307,181546,False,CP8H-8105-3EC3-4BAB
awAVH4sV4dk60IeWJg,1701005605,Novus,5411,5411,-5998,-5998,980,0,44,222526,False,86H0-CTB9-9BKA-CA6B
U-bSdz5L4apsO7TU6g,1700920283,–ü–∞—Ä–∫–æ–≤–∫–∞,7523,7523,-2000,-2000,980,0,0,228524,False,K41A-EAAC-7E04-H8EX
VLY6hLIyRKCozP1HDg,1700919982,Giulia,5631,5631,-63800,-63800,980,0,0,230524,False,H7TE-2937-EC8H-H976
X5M6Dj9mwdfAPz2BaQ,1700910337,Yaroslaviv Val 37-1,5921,5921,-50700,-50700,980,0,380,294324,False,5XC2-A249-CXC4-4C2T
WIym1ENiukSYrER1hg,1700909720,–û—Ñ—ñ—Å-—á–∞–π,5812,5812,-33600,-33600,980,0,0,345024,True,CX00-T500-2860-5A54
5HnOyXZ-XTI6riZGnQ,1700905848,Pethouse,5995,5995,-242300,-242300,980,0,0,378624,False,481B-105K-XX14-X2PE
n4PaCbEyjDLrDb0h2g,1700905003,Vodafone,4814,4814,-17500,-17500,980,0,0,620924,False,9052-MKB0-3ETB-80E7
yPBsJ663XG-xZtB7LQ,1700903116,MEDYCHNYI TSENTR 22,8099,8099,-66000,-66000,980,0,495,638424,False,9P6H-B02K-BPET-MB76
VszaKcI5NxN-EK-mNg,1700854138,–¶–∏–ø–∞ Craft Pub,5814,5814,-107500,-107500,980,0,0,704424,False,7MEE-K6B7-B528-HEAH
ZkpU4g6t-VvrCua8yQ,1700854130,BAR HUTSUL KRAFT PAB,5813,5813,-43750,-43750,980,0,0,811924,False,B4AT-35AM-45HB-M43X
k33Wbm3PWpkW-OpQVA,1700851819,Bolt,4121,4121,-2944,-2944,980,0,0,855674,False,K3CC-HM16-K26H-X787
MaXe5wqvacjX0Jf2lg,1700849077,magazin 762597,5912,5912,-35640,-35640,980,0,267,858618,False,X2M7-XT2B-92TE-01A4
2CHyxtoQxipM7rb0hA,1700815070,Bestwaytocup,5814,5814,-7000,-7000,980,0,0,894258,False,9PB5-731C-BB0B-1E2P
z-xZ_dHXCv3D7q_aFA,1700766060,Novus,5411,5411,-25297,-25297,980,0,189,901258,False,CP03-2621-918B-AETE
aG1Idf7woiOikfADtw,1700764785,–°—ñ–ª—å–ø–æ,5411,5411,-12900,-12900,980,0,96,926555,False,4B1B-6201-68C0-XXA7
GRvjYC4IoA4TkTonOw,1700764099,OKKO,5541,5541,-149975,-149975,980,0,0,939455,False,67TH-70XH-38X1-HP4M
oNRoFXHYBBAb0fMHVA,1700758490,–ê–ø—Ç–µ–∫–∞ ‚Ññ7,5912,5912,-4600,-4600,980,0,34,1089430,False,H30E-803C-M503-961T
AOb0GC8tCJ0Ozk4sGg,1700758220,TOBAKKO-SERVIS,5499,5499,-74550,-74550,980,0,559,1094030,False,8PT5-4T3M-TE7P-T4MB
wFYL9qee5GkY-hYULA,1700758213,Beer Market,5921,5921,-9899,-9899,980,0,74,1168580,False,4CX4-MH7C-1T06-XX9P
9EWyew6Ih10Lu50bZA,1700746899,Kafe Kharms,5814,5814,-7200,-7200,980,0,0,1178479,False,M134-C7PT-914E-1A4B
GqanoqDx2hl5Zyp_DA,1700746762,–ú—ñ—Å—å–∫–µ –∫–∞—Ñ–µ –•–∞—Ä–º—Å,5812,5812,-45300,-45300,980,0,0,1185679,True,1C28-E2C3-PT2E-1M2T
1Ktkm4HOYh4n3gHiaQ,1700741902,–°—ñ–ª—å–ø–æ,5411,5411,-26715,-26715,980,0,200,1230979,False,912K-23H8-7375-6KTH
t8JEU3cC_4gssEJfag,1700729514,–íi–¥: –ü–†–ò–•–û–î–¨–ö–û –ï.–í. –§–û–ü,"–î–ª—è –ø–æ–ø–æ–≤–Ω–µ–Ω–Ω—è –∫–∞—Ä—Ç–∫–∏ 5375414101190360, –ü—Ä–∏—Ö–æ–¥—å–∫–æ –ï—Ä–Ω–µ—Å—Ç –íi–∫—Ç–æ—Ä–æ–≤–∏—á, 3487403339",4829,4829,1100000,1100000,980,0,0,1257694,True
i4QTh0pvnf4vqcQppA,1700722658,Novus,5411,5411,-16996,-16996,980,0,127,157694,False,A2AP-AM2P-4EK3-96C6
KTLd4NRXZEHCqJhUKQ,1700722397,Bestwaytocup,5814,5814,-7000,-7000,980,0,0,174690,False,9187-E8AA-XPC4-564X
iHTSlJHUn5bVfU0pYQ,1700662411,–ú–µ–≥–∞–º–∞—Ä–∫–µ—Ç,5399,5411,-30800,-30800,980,0,231,181690,False,881H-T7C4-M75E-442T
4cejJ6oSunpMyq1D0w,1700657911,SHOPSILPO,5411,5411,-229500,-229500,980,0,1721,212490,False,BE5B-MP4K-38T7-AKTE
TD1u47YKiurZuPlm8g,1700636614,LOKO,5411,5411,-37050,-37050,980,0,277,441990,False,4BT8-H3E1-57BM-952B
cfnBnMjrUFgYhCSznA,1700636427,Right coffee bar,5814,5814,-5500,-5500,980,0,0,479040,False,8434-H4P5-AH13-43CT
2BXTzl7bJ93WGyCx-Q,1700636245,–ü–∏—Ä—ñ–∂–∫–æ–≤–∞ ¬´–¢—ñ—Ç–∫–∞ –ö–ª–∞—Ä–∞¬ª,5814,5814,-34500,-34500,980,0,0,484540,False,C1P1-KC94-P591-26B1
0N4pXr5SGq6QXzsYTg,1700586105,LIQPAY*Shibuya Yarosla,5812,5812,-29520,-29520,980,0,0,519040,False,M9B7-6947-5E4K-T52X
3lB4cL1oOzeFn_DSKA,1700573531,KAFE VESNA,5812,5812,-16000,-16000,980,0,0,548560,False,KH6H-8PAP-94P2-3AK3
zmYLBEMYis5mvnSKXA,1700572407,APTECHNYJ PUNKT 2611,5912,5912,-3870,-3870,980,0,29,564560,False,8P41-E051-TK15-5CA3
dcsE0xut7fwpS5eDHw,1700553521,Bestwaytocup,5814,5814,-16500,-16500,980,0,0,568430,False,EXEC-9C54-PH2C-8KBB
hxdn7WQbUEEzfZjXcw,1700553082,La Fabrique,5814,5814,-6500,-6500,980,0,0,584930,False,E9XX-74B9-6C1T-P798
pM7LhA-MhEDPb_RWtA,1700488686,"Lifecell
+380631692598",4814,4814,-30000,-30000,980,0,0,591430,True,A976-4HKK-15P7-EMH0
sPlYuQNMaSi1TtlYxw,1700478881,–°—ñ–ª—å–ø–æ,5411,5411,-11800,-11800,980,0,88,621430,False,K120-EP04-0H6H-1AKX
iVYumNhD-2gADhSsZA,1700460801,Bestwaytocup,5814,5814,-7000,-7000,980,0,0,633230,False,4K0A-PAB3-CBE0-9T6E
QyuGlHjOewR5IELcMg,1700415748,–ó–∞–≤–µ—Ä—Ç–∞–π–ª–æ –°–æ—Ñ—ñ—è ,5812,5812,-44000,-44000,980,0,0,640230,True,K5K6-32E4-9AC5-TKX3
xhnc7mzAuXAe_C293g,1700415552,Bolt,4121,4121,-2458,-2458,980,0,0,684230,False,0565-BA2X-T920-8B38
ADw5c2bKfyXiphAn3Q,1700415058,FOP Kovtun VV,5814,5814,-22500,-22500,980,0,0,686688,False,XE5A-CM41-2K76-E740
Wn96A0ENorGVYwj_1g,1700415033,FOP Kovtun VV,5814,5814,-27500,-27500,980,0,0,709188,False,1373-T56X-EXCP-XM10
9CDN85SsmcrGjpVuaA,1700412992,Bolt,4121,4121,-2401,-2401,980,0,0,736688,False,5E83-9HAE-P2A4-KBTB
GaNgAAOCtuLunsCpCA,1700403802,Novus,5411,5411,-38796,-38796,980,0,290,739089,False,C805-8C1H-PM33-H8E3
OMHnXBiYza4fR_DbCA,1700399600,Bestwaytocup,5814,5814,-12500,-12500,980,0,0,777885,False,3B4C-33P9-8K4A-A5KC
HQ7AjIZrB9BI3yNpeA,1700331335,FDY*Merchandise,5399,5399,-29450,-29450,980,0,220,790385,False,BBK9-8ACA-M3B0-8MC0
bSoCLk0dJOlCYbHzFw,1700326606,–°–∫–∞—Å—É–≤–∞–Ω–Ω—è. LOKO,5411,5411,8800,8800,980,0,-65,819835,False
v-JQQ5TrgsUrpnHplw,1700326210,LOKO,5411,5411,-77300,-77300,980,0,579,811035,False
CSBUKes2RP9LZUpr_w,1700321827,RIZNI,5812,5812,-5500,-5500,980,0,0,888335,False,M991-8EC5-3P90-XKPT
N6I_wtyNq60Nym_ojw,1700302799,Bestwaytocup,5814,5814,-27000,-27000,980,0,0,893835,False,9K6K-8E2M-K3A4-E0T9
iWM6QCMsYJ4pVx0cFA,1700295752,–ê–ø—Ç–µ–∫–∞ ‚Ññ7,5912,5912,-4600,-4600,980,0,34,920835,False,968E-EMK8-54CH-EXH2
CHiMMBz3xH7ZzBaG-g,1700290753,Bestwaytocup,5814,5814,-10500,-10500,980,0,0,925435,False,PCMT-ME66-5H50-KPBK
tk_t94wh5f_M12Ti6w,1700254156,Bolt,4121,4121,-3226,-3226,980,0,0,935935,False,T933-7109-B05K-7P99
AFlr7c_2Y1ib77fHcA,1700240928,Bolt,4121,4121,-2944,-2944,980,0,0,939161,False,89X7-3PXP-ME0T-125C
qgZkTI0IoiLehrLwmA,1700215264,–¢–∞–±–∞–∫–µ—Ä–∫–∞,5993,5993,-163800,-163800,980,0,0,942105,False,A95T-TE8H-73EX-KPP1
3dwSvw97cMMnXO6n2g,1700215178,Novus,5411,5411,-29194,-29194,980,0,218,1105905,False,KEKK-3KAC-53X7-BCXH
Uoun7jzXt7hH2SJUHA,1700214661,magazin 762597,5912,5912,-250710,-250710,980,0,1880,1135099,False,MMA7-K549-E9KE-2P43
fzkoNuyZvre8FonHGg,1700160533,–í—ñ–¥: –û–ª–µ—Å—è –°–∞—á–µ–Ω–∫–æ,ü•í,4829,4829,700,700,980,0,0,1385809,True
wkVaMGpkl1fZaQjmqQ,1700149061,Pethouse,5995,5995,-366300,-366300,980,0,0,1385109,False,9A4X-2T27-BTA6-0H29
rP3GW_rpu9IDR8-zuA,1700128108,Bestwaytocup,5814,5814,-26500,-26500,980,0,0,1751409,False,1BTP-73T1-788M-2575
TBYjj3pGZTFdRQdtyw,1700122209,Bestwaytocup,5814,5814,-7000,-7000,980,0,0,1777909,False,T15B-KE9M-E729-HP32
Wn96A0EJpLOVaALw3Q,1700071337,–°–∫–∞—Å—É–≤–∞–Ω–Ω—è. LOKO,5411,5411,2503,2503,980,0,-18,1784909,False
TLaPNsqO69h2uENjFA,1700070978,LOKO,5411,5411,-43950,-43950,980,0,329,1782406,False
sXwHGN3eZJM4Z0wsiA,1700043817,Bestwaytocup,5814,5814,-7000,-7000,980,0,0,1826356,False,TKH3-6910-5H9E-H09B
ieLXyWTyIB32BS_XNA,1700037061,Bestwaytocup,5814,5814,-12500,-12500,980,0,0,1833356,False,709H-2M37-T773-A5BX
vEDxflqqM1HWRE2NqQ,1700034018,Bestwaytocup,5814,5814,-7000,-7000,980,0,0,1845856,False,XX4P-930K-187P-4M66
mLrddlMduR8ZSJj9KQ,1699981110,–°—ñ–ª—å–ø–æ,5411,5411,-104419,-104419,980,0,783,1852856,False,MTM1-CX88-94PH-T993
A9BKCtSZ1qZdEjU9Yg,1699969353,Orner,5947,5947,-55900,-55900,980,0,0,1957275,False,4M56-TXM6-KH4M-9A47
QVMHTHJBBwareAnMHw,1699947159,Bestwaytocup,5814,5814,-7000,-7000,980,0,0,2013175,False,E1TH-1X27-3390-A9E1
GWpEiUBVTRcJ5jUjbg,1699905424,LIQPAY*TOV MLDILA,8099,8099,-119300,-119300,980,0,2386,2020175,False,T350-1348-2H5E-CKKC
ObemwddktRDPF4g1iA,1699901839,–°—ñ–ª—å–ø–æ,5411,5411,-49980,-49980,980,0,499,2139475,False,BE9C-5KM6-28B6-52HK
OxImKkDLjb0QhT3IOQ,1699881689,–ü–µ—Ä–µ–∫–∞–∑ –Ω–∞ –∫–∞—Ä—Ç–∫—É,4829,4829,-900000,-900000,980,0,0,2189455,True
9Kbozc34opK38Odg9w,1699881621,–ü–æ–ø–æ–≤–Ω–µ–Ω–Ω—è ¬´–ù–∞ –¥—Ä–æ–Ω –¥–ª—è 23 –û–ë–°–ü¬ª,4829,4829,-100000,-100000,980,0,0,3089455,True,1AT0-14CK-5X29-A257
ZAuLdRrDBxHD7WKCqg,1699881556,–ü–æ–ø–æ–≤–Ω–µ–Ω–Ω—è ¬´–ù–∞ –∞–≤—Ç–æ –¥–ª—è 47¬ª,4829,4829,-100000,-100000,980,0,0,3189455,True,M907-550P-BX8M-C5CK
xqbTvrr8P65tetjlBw,1699868716,–íi–¥: –ü–†–ò–•–û–î–¨–ö–û –ï.–í. –§–û–ü,"–î–ª—è –ø–æ–ø–æ–≤–Ω–µ–Ω–Ω—è –∫–∞—Ä—Ç–∫–∏ 5375414101190360, –ü—Ä–∏—Ö–æ–¥—å–∫–æ –ï—Ä–Ω–µ—Å—Ç –íi–∫—Ç–æ—Ä–æ–≤–∏—á, 3487403339",4829,4829,3200000,3200000,980,0,0,3289455,True
mJG6Df0d2lXIGaTEcw,1699861109,Bestwaytocup,5814,5814,-7000,-7000,980,0,0,89455,False,58KT-C867-XEC7-6X2T
uIUmS0_K4-FdmShmEg,1699821264,Novapay,8999,8999,-5400,-5400,980,0,0,96455,False,0EEK-94AT-HEP7-E14M
ixQ4jlbZWpilGVEpVA,1699821261,Novapay,6538,6538,-92322,-92322,980,3122,0,101855,False,73TB-8BHB-PM2C-0731
QsWaC7KNI3VhPSfs-w,1699805551,SHOPSILPO,5411,5411,-119370,-119370,980,0,895,194177,False,4TA1-5CK8-KH98-B42P
AKpd8NRXkn0TE6Katw,1699779605,Bestwaytocup,5814,5814,-47500,-47500,980,0,0,313547,False,62H4-1KBH-PCA5-CA9T
sDhgEkosr3riC29iww,1699718814,–°—ñ–ª—å–ø–æ,5411,5411,-54698,-54698,980,0,410,361047,False,5424-1AKX-EH8M-04MM
yMkGdwBfwc63EPUFGQ,1699718003,AVANGARDEN,5812,5812,-6900,-6900,980,0,0,415745,True,89M8-2723-8CK7-4504
XgSiK8vUd0PS5BvGeg,1699703024,–ê–ø—Ç–µ–∫–∞ ‚Ññ7,5912,5912,-4600,-4600,980,0,34,422645,False,MT83-AKKH-K35P-1C81
SWZbvsgiOcej7uZFxw,1699701950,LIQPAY*ZL Vet,742,742,-80000,-80000,980,0,0,427245,False,EKH7-650E-208E-42HH
Jv8bJgNzoSU9-RQl_Q,1699694331,magazin 762597,5912,5912,-51080,-51080,980,0,383,507245,False,XC57-A5T8-8X7C-54MT
b-7NqlwdTSvcGUioKQ,1699694077,Novus,5411,5411,-73581,-73581,980,0,551,558325,False,E05M-PPC4-C776-0XEK
126x8z4KODhWkQx44g,1699688591,Bestwaytocup,5814,5814,-7000,-7000,980,0,0,631906,False,235P-AAK9-C2HC-4BAT
m244hhV6tpb4zcOtkw,1699630417,SHOPSILPO,5411,5411,-90800,-90800,980,0,681,638906,False,64EP-9C82-EKB8-9K3P
5evhhXqht7ZwuHfJlA,1699601237,Bestwaytocup,5814,5814,-7000,-7000,980,0,0,729706,False,B719-9318-512X-BE19
Pk1ZLJNY8LarIarTfA,1699552979,Novapay,8999,8999,-7000,-7000,980,0,0,736706,False,BPEP-CX7M-MX98-6KX4
U8cnNd7ONm19YX3_Qw,1699552956,Novapay,8999,8999,-7000,-7000,980,0,0,743706,False,7ATM-329P-0178-3E4M
H_t4Ov4UMR3ytlz0HA,1699549991,–¢–∞–±–∞–∫–µ—Ä–∫–∞,5993,5993,-81900,-81900,980,0,0,750706,False,981X-8C96-5133-M13M
zKer8y1O-4va7RU-xQ,1699549925,Novus,5411,5411,-15397,-15397,980,0,115,832606,False,48H6-1K2A-4TXA-TH8M
N7dk0DGi_PMGIUBvuw,1699549484,magazin 762597,5912,5912,-51080,-51080,980,0,383,848003,False,KPTH-3A01-PCAC-1MA6
7x0r7HZ2LCgQ8emllA,1699540704,Novus,5411,5411,-19899,-19899,980,0,149,899083,False,9P91-P034-MHEX-A5K2
eLAX4bHOJ3gwxpfpuQ,1699535922,Cotton coffee,5814,5814,-9000,-9000,980,0,0,918982,False,3B2K-C779-A1ET-66E7
vmP-0UbupkzHUqIRaA,1699533821,MEDYCHNYI TSENTR 22,8099,8099,-44000,-44000,980,0,330,927982,False,XXA7-58X4-6TPB-P7K0
ZLoDMtsGWebPpVZ-Kg,1699524932,FDY*Merchandise,5399,5399,-29450,-29450,980,0,220,971982,False,H307-A9M2-0M84-095X
xNic9THZkXCRgk1B-g,1699516524,Novus,5411,5411,-55889,-55889,980,0,419,1001432,False,P1C3-7MK5-EEP4-743X
tWg-Q0tKkXQA3YyB7g,1699515895,PROSTOR 7216,5977,5977,-24111,-24111,980,0,180,1057321,False,P421-CKP8-6T54-9H71
DADrdXx5l1pXJFl4lg,1699514547,Bolt,4121,4121,-1660,-1660,980,0,0,1081432,False,C7TA-AAX6-9K36-H6CP
VnDeDtnZYa1VLQcBLw,1699436841,–§–ö –ï–í–û,5399,5399,-32500,-32500,980,0,243,1083092,False,PHH4-T702-M9E3-40AT
QAc2hGZzDTYlLWJR2g,1699436068,Novus,5411,5411,-85995,-85995,980,0,644,1115592,False,E6EM-14X1-P5CT-XC68
vqPLic7s_tyPROloTw,1699425496,Bolt,4121,4121,-5289,-5289,980,0,0,1201587,False,5XAC-7K3X-TB76-5945
jxSmxdmrrBi_oJ4xwg,1699367517,Bestwaytocup,5814,5814,-8500,-8500,980,0,0,1206876,False,B1A7-0MCK-12H7-6T36
3clSg4M18uoOCiXR_w,1699367303,Novus,5411,5411,-7698,-7698,980,0,57,1215376,False,7TCK-76BP-6EC7-4EPX
ZjWPFpd2iuiz_kr5Kw,1699345286,Pethouse,5995,5995,-447000,-447000,980,0,0,1223074,False,98MA-4MX8-TE9B-5TCH
ljs_9kyaVhw9S9-ZEQ,1699343905,–ê–ø—Ç–µ–∫–∞ –ê–ù–¶,5912,5912,-25740,-25740,980,0,193,1670074,False,159E-X4BC-985P-1CHM
N5yFpvoGoKiQ6Fj7xA,1699342454,Bestwaytocup,5814,5814,-7000,-7000,980,0,0,1695814,False,9ABC-6096-BBKX-895P
WB-TZFoaFGeuGgD86A,1699193233,Leilia Bakery,5814,5814,-24000,-24000,980,0,0,1702814,False,3M6H-PAP5-97BB-P093
qyEKFX7GFS_8ltLhyw,1699192884,t.c.pizza,5812,5812,-64400,-64400,980,0,0,1726814,True,3A0A-B3CT-X264-CTAT
U3UhdMVIPxZuSr57xQ,1699175968,–ü–æ–ø–æ–≤–Ω–µ–Ω–Ω—è ¬´–ö–Ü–¢ –ú–£–†–ê–ù¬ª,4829,4829,-50000,-50000,980,0,0,1791214,True,PM0H-E544-BPB6-6988
QswhvoJ65cU0BHS-Vw,1699174337,Novus,5411,5411,-25565,-25565,980,0,191,1841214,False,37C9-HBAK-5X3E-74M3
642BGVcpJ9i2tWe4pA,1699101085,magazin 762597,5912,5912,-153810,-153810,980,0,0,1866779,False,EKXC-MEC0-XAT2-38B9
xGlFfGBz96rSMCAtog,1699090584,PROSTOR 7216,5977,5977,-34309,-34309,980,0,0,2020589,False,H4PP-PKT8-4CXP-KBKT
m32kQ8i7nk4IOAbemA,1699089594,Bestwaytocup,5814,5814,-8500,-8500,980,0,0,2054898,False,72A4-667P-C469-M6B4
zrvDih0vYg3KWeKPsA,1699086402,Novus,5411,5411,-46996,-46996,980,0,0,2063398,False,T8AC-66A5-E11K-K5AC
tsJzv0bTVKmmoiyzxQ,1699039192,–í—ñ–¥: –í–ª–∞–¥–∏—Å–ª–∞–≤ –ß–æ—Ä–Ω–∏–π,split,4829,4829,40731,40731,980,0,0,2110394,True
O-o2Fr-AELHuYfP28w,1699025353,–°–∫–∞—Å—É–≤–∞–Ω–Ω—è. LOKO,5411,5411,1110,1110,980,0,0,2069663,False
L0Md47JAMBG6IQo2Wg,1699025222,LOKO,5411,5411,-18070,-18070,980,0,0,2068553,False
hdb75aO7KgJIOcMBOQ,1699018780,–ê–ø—Ç–µ–∫–∞ ‚Ññ7,5912,5912,-4600,-4600,980,0,0,2086623,False,H490-A11M-9C28-489M
-Tc5-v9o9K7jZknDMw,1699005145,–ü–µ—Ä–µ–∫–∞–∑ –Ω–∞ –∫–∞—Ä—Ç–∫—É,4829,4829,-600000,-600000,980,0,0,2091223,True
EMfDKhq0LTLCHAyseQ,1699003850,–íi–¥: –ü–†–ò–•–û–î–¨–ö–û –ï.–í. –§–û–ü,"–î–ª—è –ø–æ–ø–æ–≤–Ω–µ–Ω–Ω—è –∫–∞—Ä—Ç–∫–∏ 5375414101190360, –ü—Ä–∏—Ö–æ–¥—å–∫–æ –ï—Ä–Ω–µ—Å—Ç –íi–∫—Ç–æ—Ä–æ–≤–∏—á, 3487403339",4829,4829,2100000,2100000,980,0,0,2691223,True
-5gyvdp7ZlWuVzneeQ,1698995950,BestWayToCup,5814,5814,-15500,-15500,980,0,0,591223,False,B4E9-B5CH-X7H9-P5TC
MIgyEn78hu0uWmimkg,1698931188,magazin 762597,5912,5912,-57160,-57160,980,0,0,606723,False,0TTE-P13B-P5K3-EKA3
O7T-VyVUooqp2KjVXA,1698930914,–¢–∞–±–∞–∫–µ—Ä–∫–∞,5993,5993,-81900,-81900,980,0,0,663883,False,118A-B5PE-PX0X-X98P
YGGuUTxRFGaYdyIHQA,1698930809,Novus,5411,5411,-111342,-111342,980,0,0,745783,False,3459-8972-A2P7-147K
coKbWhFW_MlDd6Nyfg,1698926578,Apteka,5912,5912,-13410,-13410,980,0,0,857125,False,E3P6-KE0B-H0AP-5880
9fAm1IP2oZfDT7t3bw,1698926364,MEDYCHNYI TSENTR 22,8099,8099,-43300,-43300,980,0,0,870535,False,E376-A104-MX77-9C98
HJLSjgZ2QvmCyBSPzQ,1698829903,Bolt,4121,4121,-11500,-11500,980,0,0,913835,False,B9P9-539C-XE92-E988
rMd_t1D1ZJVXuzl8BA,1698823337,Bolt,4121,4121,-12400,-12400,980,0,0,925335,False,4K4T-X10T-09C9-1K91
kWwOgVpG1iUROzBLWg,1701104502,Privat24 Internet serv,4816,4816,-32320,-32320,980,0,0,16279,False,5997-78H4-BA5E-K49P
eoX6AwIVQzXlPteRrw,1700969010,–†–µ–≥—É–ª—è—Ä–Ω–µ –ø–æ–ø–æ–≤–Ω–µ–Ω–Ω—è ¬´–§–æ–Ω–¥ –ü–æ–≤–µ—Ä–Ω–∏—Å—å –∂–∏–≤–∏–º¬ª,4829,4829,-25000,-25000,980,0,0,48599,True
Ui0oPbLMKeowmfBRng,1700910750,Lesya,4829,4829,-150000,-150000,980,0,0,73599,True,380T-17KT-H4XX-CXA0
3W-1Ve11ujDUrMaNQg,1700660799,Lesya,4829,4829,-200000,-200000,980,0,0,223599,True,AKCT-H9KK-9246-M1A3
6nVaa5BdeZ52GhSjNw,1700641418,Lesya,4829,4829,-50000,-50000,980,0,0,423599,True,M59H-B5C3-KE46-A7XT
PlIViDsrv5Se_tl83A,1700596393,Lesya,4829,4829,-40000,-40000,980,0,0,473599,True,BT5M-P919-9B92-1BXC
eGzKBPL3vNMrw0Tcew,1700506679,"–ë—ñ–¥—é–∫ –Ñ–≤–≥–µ–Ω –ú–∏–∫–æ–ª–∞–π–æ–≤–∏—á, –§–û–ü",4829,4829,-40000,-40000,980,0,0,513599,True,T9H8-4AH2-K488-20XE
DN550oRcB5Y_w8TBNA,1700364161,–†–µ–≥—É–ª—è—Ä–Ω–µ –ø–æ–ø–æ–≤–Ω–µ–Ω–Ω—è ¬´–§–æ–Ω–¥ –ü–æ–≤–µ—Ä–Ω–∏—Å—å –∂–∏–≤–∏–º¬ª,4829,4829,-25000,-25000,980,0,0,553599,True
F75m6f2n0bhtJds6Rw,1700335665,Lesya,–ù–∞ —á–æ–±—ñ—Ç–∫–∏ üë¢,4829,4829,-850000,-850000,980,0,0,578599,True,M773-PAM4-7XT3-6X36
ZVMv9j0YDkHfAtbgaA,1700212100,"–¢–û–í ""–ü–∞—Ä–∏—Ç–µ—Ç""",4829,4829,-140000,-140000,980,0,0,1428599,True,1654-3THM-7KAP-ETM4
ndRZ59ui_oDV8ciO_g,1699881689,–ó –ø–ª–∞—Ç–∏–Ω–æ–≤–æ—ó –∫–∞—Ä—Ç–∫–∏,4829,4829,900000,900000,980,0,0,1568599,True
OEGWKUo3AVc-zKnJnw,1699759412,–†–µ–≥—É–ª—è—Ä–Ω–µ –ø–æ–ø–æ–≤–Ω–µ–Ω–Ω—è ¬´–§–æ–Ω–¥ –ü–æ–≤–µ—Ä–Ω–∏—Å—å –∂–∏–≤–∏–º¬ª,4829,4829,-25000,-25000,980,0,0,668599,True
vXQHI3CSIolHrXbibQ,1699474167,–ü–æ–ø–æ–≤–Ω–µ–Ω–Ω—è ¬´–£–î–ê–†–ù–ò–ô –ó–ë–Ü–†¬ª,–í—ñ–¥ –¢—ñ—Ö–æ–Ω–∞ üò∏,4829,4829,-100000,-100000,980,0,0,693599,True,BTK4-HT40-9B2K-KTH4
-UTki2Kk9594Zpk_9g,1699437960,–ü–æ–ø–æ–≤–Ω–µ–Ω–Ω—è ¬´–ó–±—ñ—Ä –¥—Ä—É–∑—ñ–≤ –ù–∞–∑–∞—Ä—ñ—é¬ª,4829,4829,-50000,-50000,980,0,0,793599,True,0K6P-P79P-X193-K00C
ROInlSx-63I0yfS0tQ,1699388552,–ü–æ–ø–æ–≤–Ω–µ–Ω–Ω—è ¬´–ù–æ—à—ñ –¥–ª—è –µ–≤–∞–∫—É–∞—Ü—ñ—ó¬ª,4829,4829,-100000,-100000,980,0,0,843599,True,M5C4-M054-8PC8-E458
i963pywBBgRuuLgQ8Q,1699154679,–†–µ–≥—É–ª—è—Ä–Ω–µ –ø–æ–ø–æ–≤–Ω–µ–Ω–Ω—è ¬´–§–æ–Ω–¥ –ü–æ–≤–µ—Ä–Ω–∏—Å—å –∂–∏–≤–∏–º¬ª,4829,4829,-25000,-25000,980,0,0,943599,True
MDvbDTUMPEZFTQ9EoQ,1699005301,–ü–æ–ø–æ–≤–Ω–µ–Ω–Ω—è ¬´–ù–∞–∫–∏–¥–∫–∏ 8 –ø–æ–ª–∫—É –°–°–û¬ª,4829,4829,-150000,-150000,980,0,0,968599,True,PC0B-1PC8-EA1M-C39P
G2cDxHwHs2ifN-XWeA,1699005279,–ü–æ–ø–æ–≤–Ω–µ–Ω–Ω—è ¬´–î—Ä–æ–Ω–∏ –¥–ª—è 249–±–∞—Ç¬ª,4829,4829,-150000,-150000,980,0,0,1118599,True,9CAK-AC0E-BHT4-4434
C7d-Y4VGR0dInU22GQ,1699005145,–ó –ø–ª–∞—Ç–∏–Ω–æ–≤–æ—ó –∫–∞—Ä—Ç–∫–∏,4829,4829,600000,600000,980,0,0,1268599,True
CrzYMiYT1-UF68JsgQ,1703959309,–°—ñ–ª—å–ø–æ,5411,5411,-82395,-82395,980,0,0,313505,False,50CP-BXKE-2CCP-CP3K
J7-LsJLtPkdyNaz1ug,1703958955,SECHST,5912,5912,-122578,-122578,980,0,919,395900,False,EXK5-X5C5-KB9B-H270
fz0Xl2c9Ra02Vmn2Ng,1703954903,OKKO,5541,5541,-212003,-212003,980,0,0,518478,False,14KP-HMM3-6E78-8PH4
EfCegUgNxyM9uE7Ccw,1703935025,–ü–∞—Ä–∫–æ–≤–∫–∞,7523,7523,-18000,-18000,980,0,0,730481,False,50E4-757M-EC4P-BXAM
jWWzzA7qrAf27aonrQ,1703923126,–°—ñ–ª—å–ø–æ,5411,5411,-29802,-29802,980,0,0,748481,False,4X64-XH97-4462-MK6K
YRDPedQyAWswywwHig,1703922675,os9vigotovlennyaklyuchiv,8999,8999,-30800,-30800,980,0,0,778283,False,22H5-3C92-0H4M-9P37
RyXc078DVcIi9Rf-5Q,1703919283,Bestwaytocup,5814,5814,-25000,-25000,980,0,0,809083,False,9XH6-7K85-383P-K90B
gNUcZTyNwus5ytaxRQ,1703880147,Pethouse,5995,5995,-306100,-306100,980,0,2295,834083,False,28E8-HT3T-81C6-TX9T
Uo7Jnv2ASeItuY5xqA,1703878304,–ü–∞—Ä–∫–æ–≤–∫–∞,7523,7033,-8000,-8000,980,0,0,1140183,False,XAX0-46CP-3E1X-7B7A
6IqNb3V9NyJlyAd3og,1703878007,–ú–µ–≥–∞–º–∞—Ä–∫–µ—Ç,5399,5411,-34600,-34600,980,0,0,1148183,False,97T3-1TK5-P5T8-0505
2CVcjp1tVi0v0JfebA,1703860659,Bestwaytocup,5814,5814,-17000,-17000,980,0,0,1182783,False,A369-AP89-9C9C-4XC6
qDELHPRnH59Ns0UVwQ,1703846038,Yaroslaviv Val 37-1,5921,5921,-57970,-57970,980,0,0,1199783,False,K3K0-48C9-6XE1-49A3
26tN-uzHS_VPNnuDMg,1703843388,–ú—ñ—Å—å–∫–∞ –á–¥–∞–ª—å–Ω—è,5814,5814,-2000,-2000,980,0,0,1257753,False,0E18-ETPT-HA2T-0P2A
Kxzlz_kmRF8usxpZcg,1703843328,Miskakavyarnya,5814,5814,-6500,-6500,980,0,0,1259753,False,H1BA-402H-18M5-711K
rZ4rPmrsKWPVkD2dIg,1703843315,–ú—ñ—Å—å–∫–∞ –á–¥–∞–ª—å–Ω—è,5814,5814,-13500,-13500,980,0,0,1266253,False,9437-3T03-4AMH-A856
u_j-2WzqBeuNSHnnwg,1703841078,EasyPay,5411,5411,-208603,-208603,980,0,0,1279753,False,HEX3-1MX1-K60X-6CH7
Pla5RL_Gtn1MeqsNRw,1703833891,–û–±—Å–ª—É–≥–æ–≤—É–≤–∞–Ω–Ω—è –ø–ª–∞—Ç–∏–Ω–æ–≤–æ—ó –∫–∞—Ä—Ç–∫–∏,4829,4829,-30000,-30000,980,0,0,1488356,True
lZ8PBYBzC9tLYKS9LQ,1703784008,FDY*FOOD,5499,5499,-113360,-113360,980,0,0,1518356,False,T1HP-1PT9-M6PB-45MP
NQitHmDSH9gP9YyCsA,1703782972,Konteiner,5814,5814,-51500,-51500,980,0,0,1631716,False,KCAX-K2EA-24CE-HK74
Al_n1T7_vwMcLpwQWw,1703778401,APTEKA 45,5912,5912,-170300,-170300,980,0,1277,1683216,False,0P72-95EE-6AT2-B8B2
5eSI_FWq9qcJKobsCA,1703753937,OK Wine,5411,5411,-38760,-38760,980,0,0,1853516,False,AX64-M850-A3CK-E8X7
6xCtokcYwQFgTnJuEA,1703701525,OK Wine,5411,5411,-27500,-27500,980,0,0,1892276,False,T84P-A78E-T8M0-9H54
Unx6N1Ad9qvMIMiZaw,1703700968,Restoran ChIChIKO,5814,5814,-109500,-109500,980,0,0,1919776,False,XKHA-3E0P-T393-217C
awmy2uVQ2YtGYDIQwg,1703682701,Ridnimedtehnika,5399,5399,-300,-300,980,0,0,2029276,False,B585-2222-38H8-BP6H
JU4Cu6y10QESeNSTTw,1703673095,–ü–µ—Ä–µ–∫–∞–∑ –Ω–∞ –∫–∞—Ä—Ç–∫—É,4829,4829,-120000,-120000,980,0,0,2029576,True
zK-4nVbrr7iGxav9hA,1703672953,–§–û–ü –î–∏–¥–∞—Ä –Ü—Ä–∏–Ω–∞ –Æ—Ä—ñ—ó–≤–Ω–∞,4829,4829,-95200,-95200,980,0,0,2149576,True,8P94-3M6K-6PM8-B720
TzqEteFTBynCa_lwYg,1703667762,–Ü–Ω—Ç–µ—Ä–Ω–µ—Ç —ñ –¢–ë,4900,4900,-35000,-35000,980,0,0,2244776,True,37C1-K2M2-7T23-X06H
9lYRi_L3k58Kqm5hkQ,1703614075,LIQPAY*Shibuya Yarosla,5812,5812,-69190,-69190,980,0,0,2279776,False,BB46-6C52-9ABE-K2P1
41a4IXr2NS1cQaE06A,1703610106,SEJNOUMO,5814,5814,-65000,-65000,980,0,0,2348966,False,7373-B419-9K18-5P90
R2RSiAioKWtr-bHPsQ,1703591494,–ü–æ–ø–æ–≤–Ω–µ–Ω–Ω—è ¬´–Ø–ª–∏–Ω–∫–∞ –≤—ñ–¥ monobank¬ª,4829,4829,-200,-200,980,0,0,2413966,True,PCM3-3M4C-XHCX-810A
PxVVHxM2swOqZs_fYQ,1703591461,FDY*Merchandise,5399,5399,-103850,-103850,980,0,0,2414166,False,3K79-5A58-K2T7-9PPE
0CSqSyjMZ0tnVHEs9w,1703584776,–íi–¥: –ü–†–ò–•–û–î–¨–ö–û –ï.–í. –§–û–ü,"–î–ª—è –ø–æ–ø–æ–≤–Ω–µ–Ω–Ω—è –∫–∞—Ä—Ç–∫–∏ 5375414101190360, –ü—Ä–∏—Ö–æ–¥—å–∫–æ –ï—Ä–Ω–µ—Å—Ç –íi–∫—Ç–æ—Ä–æ–≤–∏—á, 3487403339",4829,4829,2500000,2500000,980,0,0,2518016,True
uth-EkuXXZJPKRNxlQ,1703572449,Vodafone,4814,4814,-17500,-17500,980,0,0,18016,False,K7XE-A7C8-H371-KMX0
LAE8w6aESlLUi5EXEA,1703522131,LOKO,5411,5411,-13700,-13700,980,0,0,35516,False,6P93-264A-6A0K-KACB
IMYIvN62ntcD_nDuqg,1703513247,–ü—Ä–æ–¥—É–∫—Ç–∏,5499,5499,-6500,-6500,980,0,0,49216,False,X97X-5E1M-0C49-E72C
BATGsUB4lx1OnKYE7w,1703513233,–ó –±—ñ–ª–æ—ó –∫–∞—Ä—Ç–∫–∏,4829,4829,50000,50000,980,0,0,55716,True
GCY3resg_R5b1O22og,1703511261,–ù–æ–≤–∞ –ø–æ—à—Ç–∞,7399,7399,-5000,-5000,980,0,0,5716,False,86BC-XMK8-6K2C-7HPT
HlWxY_w3SNZyK3qmOA,1703497893,–ù–æ–≤–∞ –ø–æ—à—Ç–∞,7399,7399,-11500,-11500,980,0,0,10716,False,01CB-TM7T-XBH0-M8X9
3rmQrx95bXeRVxoKWg,1703497447,Novus,5411,5411,-30393,-30393,980,0,0,22216,False,C753-1K75-04XE-T9CT
eCYtcQNXwgHL_A81jg,1703431784,–ó –±—ñ–ª–æ—ó –∫–∞—Ä—Ç–∫–∏,4829,4829,10000,10000,980,0,0,52609,True
tMdlQc9Qwj0kPYvo7w,1703414052,APTEKA 13,5912,5912,-169179,-169179,980,0,1268,42609,False,8H4B-X3MT-P988-6B96
tXo4IAHuLogfr8aidw,1703412593,–°—ñ–ª—å–ø–æ,5411,5411,-93800,-93800,980,0,0,211788,False,T112-9X08-M30H-P3KM
yXYw4VYS9ME5T3527w,1703343952,Foundation,5814,5814,-83475,-83475,980,0,0,305588,False,E5XM-BT04-AX8B-TH1M
sTk6Sj8vmhmNxw4ofw,1703342871,Novus,5411,5411,-41947,-41947,980,0,0,389063,False,4E57-C121-HEXB-7MET
SP9O6TqFPfw15tjI6Q,1703335276,FOP SEMENOV O.O. 1,5651,5651,-5500,-5500,980,0,0,431010,False,13TP-X2T9-4M38-7TBT
VwRm6D7APvbKZrJ_PQ,1703324021,Rozetka,5399,5399,-43800,-43800,980,0,0,436510,False,EX4A-K61K-B4AX-X0MA
7LBXWbYppO5azF2v0Q,1703322378,Oberig,8099,8099,-207000,-207000,980,0,1552,480310,False,K95P-08M7-12X1-4TAK
8CUaa8NB-WOiTOykNg,1703317816,Novus,5411,5411,-13396,-13396,980,0,0,687310,False,671X-89KA-PH2P-7TBC
FRPeuNRpYpoH8jadKQ,1703275728,Novapay,8999,8999,-5000,-5000,980,0,0,700706,False,T9MA-15M2-K261-52ET
_88P80FVFKvRUpwnlQ,1703269427,Novapay,8999,8999,-5000,-5000,980,0,0,705706,False,XH8B-7K66-C9CH-H7E0
mcEcJ8tGl8XwdCQ94A,1703269381,Novapay,8999,8999,-5000,-5000,980,0,0,710706,False,XMX2-BK01-H9K2-C6KH
VnblRGAhEnIaJCqZXg,1703269313,Novapay,8999,8999,-8000,-8000,980,0,0,715706,False,MP2C-9MTE-78XH-X2CP
gFRbJH-Hd18DcIFBSg,1703245176,–ö–∏—ó–≤ –¶–∏—Ñ—Ä–æ–≤–∏–π,9222,9222,-36750,-36750,980,0,0,723706,False,7P8C-M4M7-493P-E177
vwp19H-WhiWiaQTLiA,1703229437,Bestwaytocup,5814,5814,-7500,-7500,980,0,0,760456,False,41CB-124E-2848-05HX
xoYzzsE2qzD12fMNcA,1703229220,–¢–∞–±–∞–∫–µ—Ä–∫–∞,5993,5993,-163800,-163800,980,0,0,767956,False,ETC5-3KKP-8AKK-XAEP
XtSIvOPRuAasLc3LQg,1703228877,Novapay,8999,8999,-5000,-5000,980,0,0,931756,False,7HM6-AMTB-56ET-4231
eY5IZmoC_8uBm2uJFA,1703227933,–ï–ø—ñ—Ü–µ–Ω—Ç—Ä,5211,5211,-25300,-25300,980,0,0,936756,False,PP28-873T-AP89-21MM
68grYb_m1DAweXIDKA,1703192971,SUPER PUPERS,5399,5399,-33000,-33000,980,0,0,962056,True,A2KK-30KA-7MM3-8806
7yhP3P4Y3ndpm8E8Qw,1703188786,Novapay,8999,8999,-16300,-16300,980,0,0,995056,False,268M-P0X6-3A9M-ACBE
O-wJe9btn1qZeVj6tw,1703188783,Novapay,8999,8999,-58000,-58000,980,0,0,1011356,False,6CT0-25E4-7EPT-64CK
ddMUOevIb8MYWpxr8A,1703185092,Socar,5541,5541,-37790,-37790,980,0,0,1069356,False,TXT2-4EM3-9MHP-CHB7
lYPn6b6KMmHPKpfbGg,1703177573,–ö—ñ–Ω–æ–º–∞—Ä–∫–µ—Ç –ü–ª–∞–Ω–µ—Ç–∞ –ö—ñ–Ω–æ,5411,5411,-6000,-6000,980,0,0,1107146,False,248B-CEMH-126X-2APM
GFx4Blo--5B2DyeX1w,1703166196,–ú—ñ—Å—å–∫–∞ –∫–∞–≤'—è—Ä–Ω—è,5812,5812,-16500,-16500,980,0,0,1113146,False,6416-A0TK-PEAT-XP55
u96Tx5QZuHFv7TaQwQ,1703166074,KHUDOZHNII SALON,5970,5970,-2600,-2600,980,0,0,1129646,False,BM06-CE0B-411T-T66P
E_nIIK85DSJXqx2ohg,1703159911,Pethouse,5995,5995,-306100,-306100,980,0,2295,1132246,False,TXHT-2KKC-C94C-0TC8
8La6tdcXPk62y4EgKA,1703153742,–íi–¥: –ü–†–ò–•–û–î–¨–ö–û –ï.–í. –§–û–ü,"–î–ª—è –ø–æ–ø–æ–≤–Ω–µ–Ω–Ω—è –∫–∞—Ä—Ç–∫–∏ 5375414101190360, –ü—Ä–∏—Ö–æ–¥—å–∫–æ –ï—Ä–Ω–µ—Å—Ç –íi–∫—Ç–æ—Ä–æ–≤–∏—á, 3487403339",4829,4829,900000,900000,980,0,0,1438346,True
taVzRNvUw7GLcAfCRQ,1703098308,Foundation,5814,5814,-138980,-138980,980,0,0,538346,False,T1TT-AK35-11PP-EHTP
gRrFxGXm6XLm6T4YMQ,1703092937,Apteka Bazhaiemo zdorovia,5399,5399,-21395,-21395,980,0,0,677326,False,547K-5X9A-74XT-85MK
qYD7eXgHIJ_v9z3N_Q,1703092883,Apteka Bazhaiemo zdorovia,5399,5399,-120665,-120665,980,0,0,698721,False,6H7P-BP7E-8HXC-X9A4
OSrUwz7bJ7kfnl85Hg,1703080332,Yaroslaviv Val 37-1,5921,5921,-66300,-66300,980,0,0,819386,False,M3K4-0089-66BB-80MX
8x56LHs7771Jr3HYKg,1703078849,2085,5921,5921,-43500,-43500,980,0,0,885686,True,THHT-8PA7-16TK-7C30
uQPQlzi3KrDvnA8DhQ,1703074632,–°—ñ–ª—å–ø–æ,5411,5411,-25600,-25600,980,0,0,929186,False,6595-3ME5-03PE-958A
NhLF04rCSCx8EhYAsw,1703073811,FOP Trenin MS,5814,5814,-65900,-65900,980,0,0,954786,False,C5XH-2XC0-CKCE-3BK7
A50KKltAFSOsq62aJg,1703071695,FDY*CLOTHING,5691,5691,-174000,-174000,980,0,0,1020686,False,7CM9-7A03-49H9-KH44
7bWHbsaBmcEXMx2i8w,1703071543,LIQPAY*Sabi,5699,5699,-190000,-190000,980,0,0,1194686,False,TH90-CK90-P9B0-47TP
mHaWsdjCz3MLpPcyRA,1703060443,Libid,5814,5814,-7500,-7500,980,0,0,1384686,False,0EKC-K93T-M01P-1T34
0G-PYWS36QgzuDH7Qw,1703060136,Bestwaytocup,5814,5814,-24500,-24500,980,0,0,1392186,False,6133-198H-M0CH-KCKX
knGBSXlEloDceG29Vg,1703056582,"Lifecell
+380631692598",4814,4814,-20000,-20000,980,0,0,1416686,True,PHEK-M484-41BT-145B
ake4XrZVPTbob3Qk5g,1703009629,Apteka Bazhaiemo zdoro,5399,5399,-8050,-8050,980,0,0,1436686,False,7CBB-EXEA-58TX-C6PE
GrMmYpYJonMnh4oMhg,1703009015,–ú—ñ—Å—å–∫–∞ –∫–∞–≤'—è—Ä–Ω—è,5812,5812,-10000,-10000,980,0,0,1444736,False,5392-0KB3-6K21-X44E
R-I4gAigiZ-H3wBrzA,1702996980,Novapay,8999,8999,-2500,-2500,980,0,0,1454736,False,1BHT-M8BE-M90H-ETC0
RLjsUZpXcLibMD6LoQ,1702984811,Bestwaytocup,5814,5814,-7500,-7500,980,0,0,1457236,False,8PM1-70C4-ET5B-69A7
Gfr5AW7HhVLXUDDtUQ,1702980190,Bestwaytocup,5814,5814,-10000,-10000,980,0,0,1464736,False,XT7T-4BK6-PE8A-747E
wPiGXO5kmW_uGx4u0A,1702971741,Bestwaytocup,5814,5814,-8000,-8000,980,0,0,1474736,False,H6BH-7AM2-1MXC-0157
sZVvZbpTRKYoWLV1Bg,1702971568,HliBar,5462,5462,-4000,-4000,980,0,0,1482736,False,T258-TB4H-8HC2-6A27
UK3iNcfQpp73JFMKpQ,1702823421,Bestwaytocup,5814,5814,-17500,-17500,980,0,0,1486736,False,5T4B-0CT0-PCCK-636M
whEUpVu4I70n5KgsSQ,1702820385,FDY*Merchandise,5399,5399,-104030,-104030,980,0,0,1504236,False,0749-1EAK-9308-HT88
WCoMvRh8-YYGljV-Kw,1702815403,Novus,5411,5411,-23898,-23898,980,0,0,1608266,False,T43K-20C1-139B-6PEH
Ffy4RzNrZsq6Pnlo2Q,1702815078,magazin 762597,5912,5912,-78310,-78310,980,0,587,1632164,False,E5X1-0AKE-PPPC-A10T
HFwIp2hPgEdgzvBcZg,1702810049,–ê—Ñ—Ç–µ—Ä–Ω—É–Ω,5812,5812,-20400,-20400,980,0,0,1710474,True,BC31-987T-8HAE-17A6
JKwItKlC8nFF4QDdzg,1702744169,–¢–∞–±–∞–∫–µ—Ä–∫–∞,5993,5993,-81900,-81900,980,0,0,1730874,False,30H5-2XT0-39P1-1B23
HxYjtPSVkiVNDnNnxw,1702744094,Novus,5411,5411,-19900,-19900,980,0,0,1812774,False,464X-HBAA-MA11-T5E8
rQFuiNhQrCG2iJSdJg,1702730712,Liki24,5912,5912,-136900,-136900,980,0,1026,1832674,False,KAET-4BMC-0EE9-4T17
yecTxGA9lB7sPwgogg,1702725008,Yaroslaviv Val 37-1,5921,5921,-21550,-21550,980,0,0,1969574,False,C2PE-K1HX-03P8-89CB
i80ZIESsVLcj8tAizQ,1702724391,FOP STVOLOVA IV,5814,5814,-5800,-5800,980,0,0,1991124,False,H9HP-KC7E-3X3B-C8E5
-lBFn3eN_VimL6Sang,1702723997,MagazinBookua,5942,5942,-96000,-96000,980,0,0,1996924,False,7CP7-03HH-CTAK-P756
WI5fCvauFe41Hu0agQ,1702720693,Pivna Duma,5812,5812,-33500,-33500,980,0,0,2092924,False,M574-HHA6-8HH9-PP3A
HOxamkHTJwx6o92NAQ,1702551285,–°—ñ–ª—å–ø–æ,5411,5411,-43842,-43842,980,0,0,2126424,False,BE0T-A434-H5MH-57HP
VvARxs-zQ3Tf3-_NEA,1702550657,Apteka Bazhaiemo zdoro,5399,5399,-40380,-40380,980,0,0,2170266,False,7E83-B564-95HP-6CXH
8_WxqQ_7mAW6ZnUCiA,1702538530,Bestwaytocup,5814,5814,-15500,-15500,980,0,0,2210646,False,0155-PE2B-6C50-8A2H
5479VrmH3D66Mj5NKg,1702490225,–ü–æ–ø–æ–≤–Ω–µ–Ω–Ω—è ¬´–ù–∞ –∫–∞–º–ø—É—Ç—î—Ä –¥–ª—è –≥—Ç–∞6¬ª,4829,4829,-6500,-6500,980,0,0,2226146,True
Oz4UQki1Uc8rNKBqlA,1702490197,–ü–µ—Ä–µ–∫–∞–∑ –Ω–∞ –∫–∞—Ä—Ç–∫—É,4829,4829,-700000,-700000,980,0,0,2232646,True
N1GjAnEIoD8KStSnWw,1702488062,Yaroslaviv Val 37-1,5921,5921,-74280,-74280,980,0,0,2932646,False,X425-X891-MB97-5XK7
hqMhzdSaDIJyfcVtXw,1702487616,–ù–æ–≤–∞ –ø–æ—à—Ç–∞,7399,7399,-10800,-10800,980,0,0,3006926,False,8AT8-X0KX-M0HP-207T
myIQTNb8pTl8aJUNWQ,1702483362,EasyPay,5411,5411,-365237,-365237,980,0,0,3017726,False,8KPB-P75P-P24K-XTE1
mfuJTw6IxV22Y863bw,1702470817,FDY*FOOD,5499,5499,-50465,-50465,980,0,0,3382963,False,ET1K-KT30-XEK9-A57H
DpoND8imMeIS62x2VA,1702469876,FOP Trenin MS,5814,5814,-10900,-10900,980,0,0,3433428,False,08K0-A753-2X33-XM27
Wlk8udLDUwhYGuaZjg,1702466351,Bolt Food,4215,4215,-52110,-52110,980,0,0,3444328,False,H61E-X3P5-T11A-T748
CDLSnyR6P_CsVGQxiw,1702466276,–°–∫–∞—Å—É–≤–∞–Ω–Ω—è. Bolt Food,4215,4215,39190,39190,980,0,0,3496438,False
Y1r6cF2dh3xuXxDYQQ,1702465869,Bolt Food,4215,4215,-39190,-39190,980,0,0,3457248,False
uHBSvdY25drcMjK57Q,1702462640,Beerplace,5814,5814,-17500,-17500,980,0,0,3496438,False,MT6T-4M04-T475-2CCP
sxQnqUVtdrBO4POxvg,1702460899,Bestwaytocup,5814,5814,-23500,-23500,980,0,0,3513938,False,2ET5-3HE3-CHK3-38TX
VCS3EPg0hY1ATPNwRQ,1702459339,–°—ñ–ª—å–ø–æ,5411,5411,-134600,-134600,980,0,0,3537438,False,HM4H-5806-74PT-H8X6
DhUU3vWcYSLXXs9umw,1702459085,–íi–¥: –ü–†–ò–•–û–î–¨–ö–û –ï.–í. –§–û–ü,"–î–ª—è –ø–æ–ø–æ–≤–Ω–µ–Ω–Ω—è –∫–∞—Ä—Ç–∫–∏ 5375414101190360, –ü—Ä–∏—Ö–æ–¥—å–∫–æ –ï—Ä–Ω–µ—Å—Ç –íi–∫—Ç–æ—Ä–æ–≤–∏—á, 3487403339",4829,4829,3300000,3300000,980,0,0,3672038,True
-s6q_jCbCvrjJxXFmyUW,1702425865,"–°–∫–∞—Å—É–≤–∞–Ω–Ω—è. LIQPAY*SHINE BRIGHT,DNIPRO,UA",5977,5977,59500,59500,980,0,0,372038,True
mqs1LThAbtbEmGMZXw,1702382746,KAFE AVI,5812,5812,-3900,-3900,980,0,0,312538,False,3BXT-48K2-BX4M-1PXC
MUWFBGKo3HgBBIab9Q,1702329559,FIT_STRETCH HUB,7997,7997,-70000,-70000,980,0,0,316438,True,2K58-9EH7-X78M-ABE1
swxQKdVRD0sNpVQCRg,1702319410,–°–∫–∞—Å—É–≤–∞–Ω–Ω—è. LOKO,5411,5411,3322,3322,980,0,0,386438,False
VSo90bC6kLx_XY_aMQ,1702319063,LOKO,5411,5411,-60530,-60530,980,0,0,383116,False
DeA5KtudEQ9mKWEYbw,1702292223,–°—ñ–ª—å–ø–æ,5411,5411,-24400,-24400,980,0,0,443646,False,H22C-KM45-XMB1-921T
0HNJBXbwdeRyK101zg,1702287095,FOP Trenin MS,5814,5814,-8900,-8900,980,0,0,468046,False,2AKC-C27C-B4K3-B5AX
hpW3wlKec1_nvK84Mw,1702240254,Pethouse,5995,5995,-408200,-408200,980,0,3061,476946,False,K52E-EX0M-CEBP-MCK0
iQ4IHJNimaqMALpAng,1702227882,Yaroslaviv Val 37-1,5921,5921,-49700,-49700,980,0,0,885146,False,540A-B99M-5627-8A7B
GPgKDMOxnaX5kOr8Nw,1702227603,–ú—ñ—Å—å–∫–∞ –∫–∞–≤'—è—Ä–Ω—è,5812,5812,-10000,-10000,980,0,0,934846,False,925H-0CP5-MPME-107K
AE344UFO2mhSicjg3Q,1702209897,StudijaKvitivtadekoruS,5992,5992,-175000,-175000,980,0,0,944846,False,A2TM-8KC8-C108-311A
shdjQEGVF9FRLGxJNg,1702209742,PROSTOR 7216,5977,5977,-35534,-35534,980,0,266,1119846,False,PH13-286T-10M7-7T3P
3gxUoFJ3avemFEWoEQ,1702209464,magazin 762597,5912,5912,-148750,-148750,980,0,1115,1155380,False,X1HA-TKKM-06AE-199A
xzfsDZt1x_Z0X2Qm2Q,1702208934,Novus,5411,5411,-7513,-7513,980,0,0,1304130,False,TK65-205E-61BA-X28H
rl1yaUd9w5pcZ7Zofg,1702208860,–¢–∞–±–∞–∫–µ—Ä–∫–∞,5993,5993,-81900,-81900,980,0,0,1311643,False,XKK5-5P80-PB82-5KET
l0Nz1pZPt0QGny4jmA,1702208779,Novus,5411,5411,-5198,-5198,980,0,0,1393543,False,C79P-T2BA-177B-3863
2DeIDGzmFcaYDHazmA,1702138089,–ê–¢–ë,5499,5411,-3740,-3740,980,0,0,1398741,False,H8MM-BHTC-T602-P123
8S4-djNmm4iYnjDkRg,1702137457,Mates,5812,5812,-80300,-80300,980,0,0,1402481,True,96K8-TCMK-962H-6497
CVmnuSuzPJ6cZvG1Ow,1702136866,Socar,5541,5541,-266958,-266958,980,0,0,1482781,False,19HT-18HC-ATXX-0H6X
A1-3ENnDeVXhf84VjQ,1702135849,Knigarnia SENS,5942,5942,-99500,-99500,980,0,0,1749739,False,A7KK-PAA3-B10C-M1T9
pegFgANveblf7zPDMw,1702132295,–°–µ–Ω—Å,5812,5812,-18900,-18900,980,0,0,1849239,True,B3XX-0EH7-P47H-C8TB
XW7CMGZsrSa4DRhL5g,1702131305,Bolt,4121,4121,-9500,-9500,980,0,0,1868139,False,E45H-4M60-95PT-7724
ZFEVIKPV-Z1Mm13eSw,1702130923,Kiev Filatova 2,5499,5499,-4500,-4500,980,0,0,1877639,False,49EA-08C8-94MX-2XC3
kb299fP8oIryJ4k2iw,1702123460,City Pharm,5912,5912,-1800,-1800,980,0,13,1882139,False,8706-6C55-XHBH-5A6C
s6Oq1CNR1g04YweyGQ,1702116394,Bestwaytocup,5814,5814,-37500,-37500,980,0,0,1883939,False,45H5-E758-68AH-5551
rZ4rPm3lLWrRlDiaJQ,1702111991,Leilia Bakery,5814,5814,-30000,-30000,980,0,0,1921439,False,X026-7854-T765-5301
qBXEciuVwybN5sIskg,1702111543,t.c.pizza,5812,5812,-83600,-83600,980,0,0,1951439,True,46M9-9360-68TP-HH3H
Bk2bfH9eKFfK5fvTWg,1702035450,–ü–µ—Ä–µ–∫–∞–∑ –Ω–∞ –∫–∞—Ä—Ç–∫—É,4829,4829,-900000,-900000,980,0,0,2035039,True
4GELpa03CsApdh9vsA,1702035404,–ü–æ–ø–æ–≤–Ω–µ–Ω–Ω—è ¬´–ù–∞ —Ç—É—Ä–Ω—ñ–∫–µ—Ç–∏ 228 –¢—Ä–û¬ª,4829,4829,-350000,-350000,980,0,0,2935039,True,A130-55B6-6258-5C50
xQVG3a2wdVlmtgDA5A,1702033775,–íi–¥: –ü–†–ò–•–û–î–¨–ö–û –ï.–í. –§–û–ü,"–î–ª—è –ø–æ–ø–æ–≤–Ω–µ–Ω–Ω—è –∫–∞—Ä—Ç–∫–∏ 5375414101190360, –ü—Ä–∏—Ö–æ–¥—å–∫–æ –ï—Ä–Ω–µ—Å—Ç –íi–∫—Ç–æ—Ä–æ–≤–∏—á, 3487403339",4829,4829,3200000,3200000,980,0,0,3285039,True
szHbrdnUqHU1Q0wGVg,1702020830,Bestwaytocup,5814,5814,-7500,-7500,980,0,0,85039,False,4P20-EMHC-TE11-45A1
fxlQW1LHEFGOQSMreA,1701970275,WFP.FASTFOOD,5811,5811,-101000,-101000,980,0,0,92539,False,C604-9BE8-7XK7-C23M
HvG7FqeA8gxKdLludA,1701970143,–ó –±—ñ–ª–æ—ó –∫–∞—Ä—Ç–∫–∏,4829,4829,100000,100000,980,0,0,193539,True
G-ln5CL5kKh6QOVGyQ,1701967281,Novapay,8999,8999,-13800,-13800,980,0,0,93539,False,PM21-AT12-19X6-8X05
RXXVxsck2rUNVK0bKg,1701967227,Novapay,8999,8999,-5300,-5300,980,0,0,107339,False,CKX6-T066-7M92-5BKP
BUewbicG_my7KTJuTg,1701965779,MasterZoo,5995,5995,-30875,-30875,980,0,1543,112639,False,K1B9-7K2M-EH0K-705K
SwXgzFh-ONkE4yuEIw,1701964596,–ó –±—ñ–ª–æ—ó –∫–∞—Ä—Ç–∫–∏,4829,4829,100000,100000,980,0,0,143514,True
DfagAP6AyQLz4i1VNQ,1701945022,Novus,5411,5411,-2399,-2399,980,0,0,43514,False,A1K9-43C2-9C57-6H2A
3KKbacyiHxnuVvgd2g,1701939265,Apteka Bazhaiemo zdoro,5399,5399,-45850,-45850,980,0,0,45913,False,T48E-KT6M-M6B7-E89E
6U04tbLXPTEWZ84ZNA,1701891343,Novapay,8999,8999,-5500,-5500,980,0,0,91763,False,47EA-C0AH-7T59-5P47
auY8iJgbxCFsYSy9bg,1701872351,Novapay,8999,8999,-7000,-7000,980,0,0,97263,False,0TBE-2PCX-X1MX-24E3
UHeZ38oDxYZQ1vYmPQ,1701861943,FOP Trenin MS,5814,5814,-20400,-20400,980,0,0,104263,False,4C6X-65E1-MTM7-2E64
T8eAjWPygfiarHNHbQ,1701849421,FDY*Merchandise,5399,5399,-79850,-79850,980,0,0,124663,False,6C3P-BC3H-18A8-E583
9lCcGz5K5cxhIS6DSA,1701805644,–°—ñ–ª—å–ø–æ,5411,5411,-6700,-6700,980,0,0,204513,False,5KC2-B9CM-H324-PPH3
qjXJk6qrcenyJDAB6w,1701776817,magazin 762597,5912,5912,-82330,-82330,980,0,617,211213,False,8TKK-9KXH-41P0-5X4X
yT6mWy1FNJvdP9r6qw,1701776605,Novus,5411,5411,-13599,-13599,980,0,0,293543,False,261E-8TA0-0140-EE34
UaC6VUOaji_PvYKB4A,1701775264,LIQPAY*Shine Bright,5977,5977,-119000,-119000,980,0,892,307142,False,9422-MXBE-3C7X-5MTT
yAftPoAeczkLZykIKw,1701773760,Bestwaytocup,5814,5814,-6000,-6000,980,0,0,426142,False,HCTP-7AET-M8P7-B70P
jerlKCfsEzoprO8Cmg,1701772478,Bestwaytocup,5814,5814,-34000,-34000,980,0,0,432142,False,6C7K-C37T-XCTC-8TB8
pU8eZo71LCe4vm3nCQ,1701762349,LOKO,5411,5411,-24300,-24300,980,0,0,466142,False,APE0-H0B0-03X4-X21E
zmpJD0d-WJiS8JdZ0Q,1701673528,Bestwaytocup,5814,5814,-7000,-7000,980,0,0,490442,False,24A5-H4ME-81TC-3XPC
XakWUxP80sumw5Prhg,1701609980,–¢–∞–±–∞–∫–µ—Ä–∫–∞,5993,5993,-163800,-163800,980,0,0,497442,False,6HMM-02HE-P4X2-T07M
FK4xYehnGR8vxOQLjg,1701513081,magazin 762597,5912,5912,-71340,-71340,980,0,535,661242,False,AA5M-X54H-B6CE-M06X
lHmTIcc3WqH5aKJq-w,1701513064,Novus,5411,5411,-2499,-2499,980,0,0,732582,False,P25H-0414-92MA-2PM9
XVZ7tJUp92xRbcj-Rg,1701453742,Portmone,5651,5651,-460001,-460001,980,0,0,735081,False,57EC-MAA6-AH8C-2T19
-FPlwjmudaYcTU6atw,1701443982,–ü—Ä–æ–¥—É–∫—Ç–∏,5499,5499,-3380,-3380,980,0,0,1195082,False,H792-0EPK-1P63-MKMT
blAathSDBCy4oSJU4w,1701434807,Bestwaytocup,5814,5814,-7000,-7000,980,0,0,1198462,False,5707-145M-668X-K2T4
TKdO4ly3yF4_G_8y-Q,1701432774,Bestwaytocup,5814,5814,-31000,-31000,980,0,0,1205462,False,7MPB-0BX2-317M-T4HP
gNpHSj5T5ZJyluP7yg,1701422017,Apteka Bazhaiemo zdorovia,5399,5399,-149001,-149001,980,0,0,1236462,False,PXCX-M4H5-59XC-00H9
0CNabacG5DUmRDuIFw,1701421872,Bolt,4121,4121,-11900,-11900,980,0,0,1385463,False,MEM5-P215-9MMX-75T3
GjKpoa96NV8WOBQMrA,1701421655,–°—ñ–ª—å–ø–æ,5411,5411,-15375,-15375,980,0,0,1397363,False,BT5B-6615-56A5-9128
V_3pTOwEWnk0KuELew,1701413099,Bolt,4121,4121,-13300,-13300,980,0,0,1412738,False,C1KM-74B3-B8PB-AKBX
UnNf6d29uRoe-_v4Pg,1703849119,Lesya,4829,4829,-15000,-15000,980,0,0,525821,True,5P29-992B-XPT9-89A9
ttxbWNBBLkJPnpRpbw,1703673095,–ó –ø–ª–∞—Ç–∏–Ω–æ–≤–æ—ó –∫–∞—Ä—Ç–∫–∏,4829,4829,120000,120000,980,0,0,540821,True
9FdoTMAdRKTg9oeUoA,1703513233,–ü–µ—Ä–µ–∫–∞–∑ –Ω–∞ –∫–∞—Ä—Ç–∫—É,4829,4829,-50000,-50000,980,0,0,420821,True
JXsAgjjVLQ1Ayy9N9w,1703511213,414943****6033,4829,4829,-163000,-163000,980,0,0,470821,True,KMB1-390P-5T1E-4P91
eyUWLoJqWPuag16Wew,1703431784,–ü–µ—Ä–µ–∫–∞–∑ –Ω–∞ –∫–∞—Ä—Ç–∫—É,4829,4829,-10000,-10000,980,0,0,633821,True
hdMpqs5WhPBJ8jC8Pg,1703388312,–†–µ–≥—É–ª—è—Ä–Ω–µ –ø–æ–ø–æ–≤–Ω–µ–Ω–Ω—è ¬´–§–æ–Ω–¥ –ü–æ–≤–µ—Ä–Ω–∏—Å—å –∂–∏–≤–∏–º¬ª,4829,4829,-25000,-25000,980,0,0,643821,True
xoJi-eT0eq1R00H1ng,1703198829,–ü–æ–ø–æ–≤–Ω–µ–Ω–Ω—è ¬´–ù–∞ –∫–∞–º–ø—É—Ç—î—Ä –¥–ª—è –≥—Ç–∞6¬ª,4829,4829,-5500,-5500,980,0,0,668821,True
dmX6ItzvmdOm2BE57g,1703152694,–ü—Ä–∏–≤–∞—Ç24: Ernest Prykhodko,6536,6536,350000,350000,980,0,0,674321,False
-Ac4SdIKe7uqPJyvhw,1702981457,–ü–æ–ø–æ–≤–Ω–µ–Ω–Ω—è ¬´–ù–∞ —Ä–µ–º–æ–Ω—Ç —Ç–∞—á–æ–∫ 77¬ª,4829,4829,-50000,-50000,980,0,0,324321,True,XH9A-X711-465B-4TTA
Zt65hX-4Mlyh6QhIGg,1702981426,–ü–æ–ø–æ–≤–Ω–µ–Ω–Ω—è ¬´–ù–∞ —Ç—É—Ä–Ω—ñ–∫–µ—Ç–∏ 228 –¢—Ä–û¬ª,4829,4829,-100000,-100000,980,0,0,374321,True,M3HB-63XE-3531-X0CA
syqfONE7YythuKPK7Q,1702828310,–¢–µ—Ç—è–Ω–∞ –ö.,–°–ø—ñ–¥–Ω–∏—á–∫–∞,4829,4829,-20000,-20000,980,0,0,474321,True,HMA9-5TB8-2CPA-70B7
OJW9LN69yJc_W_wcog,1702783434,–†–µ–≥—É–ª—è—Ä–Ω–µ –ø–æ–ø–æ–≤–Ω–µ–Ω–Ω—è ¬´–§–æ–Ω–¥ –ü–æ–≤–µ—Ä–Ω–∏—Å—å –∂–∏–≤–∏–º¬ª,4829,4829,-25000,-25000,980,0,0,494321,True
PV_TqUStxo6-sGhC-Q,1702576002,–ñ–∞–Ω–Ω–∞ –ñ.,4829,4829,-250000,-250000,980,0,0,519321,True,HBKC-0235-136M-3P1H
aD4kos5lbCXMZzXFZg,1702490197,–ó –ø–ª–∞—Ç–∏–Ω–æ–≤–æ—ó –∫–∞—Ä—Ç–∫–∏,4829,4829,700000,700000,980,0,0,769321,True
7QN9hPVHTSiNdaSwAQ,1702385926,–ü–æ–ø–æ–≤–Ω–µ–Ω–Ω—è ¬´–ï–ª–µ–∫—Ç—Ä–æ–¥–≤.for a boat¬ª,–ó –î–Ω–µ–º –ù–∞—Ä–æ–¥–∂–µ–Ω–Ω—è!!! üá∫üá¶,4829,4829,-200000,-200000,980,0,0,69321,True,8TK9-KC14-3XXT-5X6M
TeipvTGWiWi0OX9Ghg,1702385803,Lesya,4829,4829,-200000,-200000,980,0,0,269321,True,920M-0HAB-XX66-K88E
MpHvSZ62Bdr9DA6JDw,1702382358,Lesya,4829,4829,-200000,-200000,980,0,0,469321,True,11KK-T57M-7XA8-6EMX
SVawntTTSivJBJ5X7Q,1702288220,–ü–æ–ø–æ–≤–Ω–µ–Ω–Ω—è ¬´–ê—Ä–µ–∞–ª –±–µ–∑–ø–µ–∫–∏58 –û–ú–ë–†¬ª,4829,4829,-5500000,-5500000,980,0,0,669321,True,2EHM-T4AX-P57C-E653
_nEk0MD2wwloULEQXQ,1702288108,–í–∏–ø–ª–∞—Ç–∞ –±–∞–Ω–∫–∏ ¬´–ê—Ä–µ–∞–ª –±–µ–∑–ø–µ–∫–∏¬ª,4829,4829,5330042,5330042,980,0,0,6169321,True
joFIGzBZrqfNJ4XyeA,1702178863,–†–µ–≥—É–ª—è—Ä–Ω–µ –ø–æ–ø–æ–≤–Ω–µ–Ω–Ω—è ¬´–§–æ–Ω–¥ –ü–æ–≤–µ—Ä–Ω–∏—Å—å –∂–∏–≤–∏–º¬ª,4829,4829,-25000,-25000,980,0,0,839279,True
Sw94fE2sAigk1Kfirg,1702163182,–ü–æ–ø–æ–≤–Ω–µ–Ω–Ω—è ¬´–ö–ï–ô–°–ï–í–ê–ö¬ª,4829,4829,-50000,-50000,980,0,0,864279,True,1K2T-815B-A1M9-2X43
lC-bVtrz-6ADslUrSQ,1702120215,Lesya,4829,4829,-200000,-200000,980,0,0,914279,True,HPHH-4MX0-4T60-7MEP
VF6WN31pKlrJClECFw,1702035450,–ó –ø–ª–∞—Ç–∏–Ω–æ–≤–æ—ó –∫–∞—Ä—Ç–∫–∏,4829,4829,900000,900000,980,0,0,1114279,True
2x12R9P1fLmmr7pBBw,1701984119,–ü–æ–ø–æ–≤–Ω–µ–Ω–Ω—è ¬´–ù–∞ –∫–∞–º–ø—É—Ç—î—Ä –¥–ª—è –≥—Ç–∞6¬ª,4829,4829,-1000,-1000,980,0,0,214279,True
KXMhQg9zRawlkp0WOg,1701970143,–ü–µ—Ä–µ–∫–∞–∑ –Ω–∞ –∫–∞—Ä—Ç–∫—É,4829,4829,-100000,-100000,980,0,0,215279,True
i1GrV00trwO8buPHDw,1701964595,–ü–µ—Ä–µ–∫–∞–∑ –Ω–∞ –∫–∞—Ä—Ç–∫—É,4829,4829,-100000,-100000,980,0,0,315279,True
xme6inEtCkcryF5dMA,1701961819,–ü–æ–ø–æ–≤–Ω–µ–Ω–Ω—è ¬´–ù–∞ —Ä–µ–º–æ–Ω—Ç –∞–≤—Ç–æ¬ª,4829,4829,-100000,-100000,980,0,0,415279,True,C630-247E-P038-E930
Zr8LG-UPu6ItejzQKw,1701939326,Lesya,4829,4829,-100000,-100000,980,0,0,515279,True,HXEK-4A24-CC12-3H7B
a_47_LT9AKCKTw5LOw,1701880221,–ü–æ–ø–æ–≤–Ω–µ–Ω–Ω—è ¬´–î–ª—è 58-–æ—ó –û–ú–ë–†¬ª,–ú–∞–ª–µ–Ω—å–∫–∏–π –≥–≤–∏–Ω—Ç—ñ–∫ üî©‚ò†Ô∏èüéâ,4829,4829,-10000,-10000,980,0,0,615279,True,73C4-K39H-XM33-0H5M
io25KSeOKRwYrft0bg,1701863191,–ü–æ–ø–æ–≤–Ω–µ–Ω–Ω—è ¬´–î–ª—è 58-–æ—ó –û–ú–ë–†¬ª,–©–æ–± —Ä–æ–∑–∫–∞—á–∞—Ç–∏ —Ç—Ä–æ—Ö–∏ –±–∞–Ω–∫—É ü•∫,4829,4829,-50000,-50000,980,0,0,625279,True,P88P-TETA-5KM7-B329
iDdOV0z3JWOTO16sLw,1701573861,–†–µ–≥—É–ª—è—Ä–Ω–µ –ø–æ–ø–æ–≤–Ω–µ–Ω–Ω—è ¬´–§–æ–Ω–¥ –ü–æ–≤–µ—Ä–Ω–∏—Å—å –∂–∏–≤–∏–º¬ª,4829,4829,-25000,-25000,980,0,0,675279,True
C9KAm-JnWP2TrGtTHg,1701456282,–ü–æ–ø–æ–≤–Ω–µ–Ω–Ω—è ¬´–ó–±—ñ—Ä –¥—Ä—É–∑—ñ–≤ –ù–∞–∑–∞—Ä—ñ—é¬ª,4829,4829,-50000,-50000,980,0,0,700279,True,H5BP-40H9-K5XX-PB61
enjsM6n2CO2RugbQxw,1706647793,Pethouse,5995,5995,-306100,-306100,980,0,0,329792,False,9315-325A-XKC8-B2HP
52vkA4CmcoJDhVFBjg,1706632550,–ü–∏—Ä—ñ–∂–∫–æ–≤–∞ ¬´–¢—ñ—Ç–∫–∞ –ö–ª–∞—Ä–∞¬ª,5814,5814,-12600,-12600,980,0,94,635892,False,HTMP-M96E-90B7-KXMA
PLp2LluNjY3BN93QpA,1706548039,WOG A2511,5541,5541,-249616,-249616,980,0,7488,648492,False,HE86-XHM9-6P7E-2BP8
tjmVZ1_uVPy-nglhkQ,1706545719,–ê–ø—Ç–µ–∫–∞ –ê–ù–¶,5912,5912,-136170,-136170,980,0,6808,898108,False,H625-CKKX-C24K-3EAM
A_g56-sUPDXiZPuCVA,1706534211,PRTMN  *INTERNET,4816,4816,-30450,-30450,980,0,0,1034278,False,A768-T1BE-P4HK-AP6X
uX5ay3DVdeEjLc7OwQ,1706523314,FOP Trenin MS,5814,5814,-10900,-10900,980,0,81,1064728,False,M1P4-T6A7-56K1-596E
GXRiLosMt3CnMwrDRQ,1706512485,–û–±—Å–ª—É–≥–æ–≤—É–≤–∞–Ω–Ω—è –ø–ª–∞—Ç–∏–Ω–æ–≤–æ—ó –∫–∞—Ä—Ç–∫–∏,4829,4829,-30000,-30000,980,0,0,1075628,True
pGIRutkacThxe41ASw,1706464146,OK Wine,5411,5411,-14800,-14800,980,0,111,1105628,False,AAM1-47B2-7T66-XXHH
mgaHHwpWEMzRPHO01g,1706451250,MagazinBookua,5942,5942,-8100,-8100,980,0,0,1120428,False,XXCX-HA0T-186P-5MCC
IaA343cIyA7TeNEWJw,1706450090,–ö–∏—ó–≤—Å—å–∫–µ –º–µ—Ç—Ä–æ,4111,4111,-800,-800,980,0,0,1128528,False,73CA-KABB-8021-1C4M
ZpDh2LenDaS3ShN3Cw,1706450085,–ö–∏—ó–≤—Å—å–∫–µ –º–µ—Ç—Ä–æ,4111,4111,-800,-800,980,0,0,1129328,False,C543-CB51-TCBC-B93H
5NB6CS4Wxrlt5NiJgA,1706449753,Goodwine,5921,5921,-139100,-139100,980,0,1043,1130128,False,05CM-B19H-T496-4C9B
JcdGZEgAcK3BTZubiQ,1706447445,Ideashop,5399,5399,-49900,-49900,980,0,374,1269228,False,00XC-M1BP-2726-X48B
o8_-bYQzJfpHFGzIxA,1706446222,Musafir | –ë. –•–º–µ–ª—å–Ω–∏—Ü—å–∫–æ–≥–æ,5812,5812,-34300,-34300,980,0,257,1319128,True,751X-HK35-C46K-5B37
ocrpmE3VW-VYPAQhdA,1706442500,–ù–æ–≤–∞ –ø–æ—à—Ç–∞,7399,7399,-81500,-81500,980,0,0,1353428,False,5C57-2TTM-MC12-7914
a61SwY-uGbg3HT7T7A,1706438435,–°—ñ–ª—å–ø–æ,5411,5411,-81900,-81900,980,0,614,1434928,False,AE0K-8C7X-2PEK-35BK
_ZBOmEvmzWq6ahBy0Q,1706438366,–°—ñ–ª—å–ø–æ,5411,5411,-176500,-176500,980,0,1323,1516828,False,288E-0542-TA4P-A46P
0cXH6knkpDfU6JDaBA,1706428303,KAFE VESNA,5812,5812,-11500,-11500,980,0,86,1693328,False,X244-B806-4936-KKC3
alBmLe1TtqUzXi806Q,1706389134,LIQPAY*Seizo,7298,7298,-20000,-20000,980,0,0,1704828,False,19X1-5XE2-8H7T-3312
ZGPAzbLcGgB8U2W8ug,1706382155,Vodafone,4814,4814,-18500,-18500,980,0,0,1724828,False,BAXT-BX31-E0X6-3X7A
0D1EJlHyqpPqS66csw,1706378326,–ü–∞—Ä–∫–æ–≤–∫–∞,7523,7523,-18000,-18000,980,0,0,1743328,False,MAE8-90P8-9247-0XKK
nH6OtWqUA4eSTv5tzQ,1706376234,Gulliver –ë–æ—É–ª–∏–Ω–≥,7933,5812,-19000,-19000,980,0,0,1761328,False,BX3P-5B05-6634-4261
8tuPH2ADbryl-8F1AA,1706348687,One Tea Tree,5812,5812,-45100,-45100,980,0,338,1780328,True,T5A8-8K4B-HMCM-06M7
MxRo2eZH49Pfe9G1Eg,1706340230,Bestwaytocup,5814,5814,-41100,-41100,980,0,308,1825428,False,KPTA-P13T-2B0K-05K5
bPc1YeDa1Fb9dJgB_w,1706298627,Guculkraftpab,5814,5814,-75500,-75500,980,0,566,1866528,False,2BP6-9198-1XAP-19EE
wcLx8NihoYeSa9EUnw,1706298622,BAR HUTSUL KRAFT PAB,5813,5813,-77000,-77000,980,0,815,1942028,False,358A-9C4M-H72B-HCA3
Qjxh9XolvEpVW0eYew,1706287756,–ú—ñ—Å—å–∫–∞ –∫–∞–≤'—è—Ä–Ω—è,5812,5812,-10000,-10000,980,0,200,2019028,False,KETX-EAMB-2E87-1T7C
3nsyjTqIQR8uyvpDGw,1706284165,Novapay,8999,8999,-13500,-13500,980,0,0,2029028,False,5972-180M-4THM-2TP4
_cYcxKVYWsojhjRi8Q,1706277077,–ü–µ—Ä–µ–∫–∞–∑ –Ω–∞ –∫–∞—Ä—Ç–∫—É,4829,4829,-900000,-900000,980,0,0,2042528,True
gsX9pXgtEEbANvb68w,1706269854,–íi–¥: –ü–†–ò–•–û–î–¨–ö–û –ï.–í. –§–û–ü,"–î–ª—è –ø–æ–ø–æ–≤–Ω–µ–Ω–Ω—è –∫–∞—Ä—Ç–∫–∏ 5375414101190360, –ü—Ä–∏—Ö–æ–¥—å–∫–æ –ï—Ä–Ω–µ—Å—Ç –íi–∫—Ç–æ—Ä–æ–≤–∏—á, 3487403339",4829,4829,1800000,1800000,980,0,0,2942528,True
xQG866TjptsyhUOITg,1706210005,BURGER FARM,5814,5814,-39900,-39900,980,0,299,1142528,False,3H74-XEE4-5P07-511B
JJq7Tc_6pbV9LY5DEQ,1706207677,Beerplace,5814,5814,-41500,-41500,980,0,311,1182428,False,7848-1C21-M40K-5BK8
H6h4a2srfNXA2NfcTQ,1706183216,–°–∫–∞—Å—É–≤–∞–Ω–Ω—è. Novapay,8999,8999,5300,5300,980,0,0,1223928,False
GgffWdwX15XWxSvSMA,1706181178,–°–∫–∞—Å—É–≤–∞–Ω–Ω—è. Novapay,8999,8999,5300,5300,980,0,0,1218628,False
WhGilJpV4IzHmhejaQ,1706181161,Novapay,8999,8999,-5300,-5300,980,0,0,1213328,False
E4FBIQzwKksyiXbIiQ,1706181031,Novapay,8999,8999,-5300,-5300,980,0,0,1218628,False
pUMUnjZ4k30-q8Ymyw,1706171115,Apteka Bazhaiemo zdorovia,5399,5399,-70760,-70760,980,0,530,1223928,False,M6CE-6TH3-25KP-CK7X
jxnPCFoOivUUEHALgg,1706086581,FOP Trenin MS,5814,5814,-12900,-12900,980,0,96,1294688,False,3HCX-8880-M48H-17AP
Da-NVeCyIPk6fFdecg,1706036062,magazinproduktiv,5499,5499,-1550,-1550,980,0,11,1307588,False,EBB2-M9XM-X273-B48K
Y3BPFktPndeKCQRyMQ,1706023963,Novapay,8999,8999,-7000,-7000,980,0,0,1309138,False,714C-K476-00PP-KE93
ODMW75OS4ObmV7hcfw,1706004477,Pethouse,5995,5995,-306100,-306100,980,0,0,1316138,False,10MA-T6P2-K4EP-C3TH
c-CfiJj2oXJBY9-1Ww,1706004167,–íi–¥: –ü–†–ò–•–û–î–¨–ö–û –ï.–í. –§–û–ü,"–î–ª—è –ø–æ–ø–æ–≤–Ω–µ–Ω–Ω—è –∫–∞—Ä—Ç–∫–∏ 5375414101190360, –ü—Ä–∏—Ö–æ–¥—å–∫–æ –ï—Ä–Ω–µ—Å—Ç –íi–∫—Ç–æ—Ä–æ–≤–∏—á, 3487403339",4829,4829,1200000,1200000,980,0,0,1622238,True
ShuLT-MG9K-qNrxAtg,1706003213,–ó –±—ñ–ª–æ—ó –∫–∞—Ä—Ç–∫–∏,4829,4829,300000,300000,980,0,0,422238,True
zwh80zZMNXm_Xxwn6Q,1706001822,Yaroslaviv Val 37-1,5921,5921,-27600,-27600,980,0,207,122238,False,TE0B-733C-5KCA-6BKX
1Rb9wUHnJ2IZNKiCxA,1705938550,FDY*SPORTINGGOODS,5941,5941,-80000,-80000,980,0,0,149838,False,E690-7943-H9B4-HXX2
Ev810r5tTEgnuvDrwQ,1705917162,–°—ñ–ª—å–ø–æ,5411,5411,-8998,-8998,980,0,67,229838,False,EE44-79PM-9EK9-XA43
arVQJJoWifzFj0pX8Q,1705916345,FOP Trenin MS,5814,5814,-12900,-12900,980,0,96,238836,False,KXHE-071X-PHHB-6H9K
iB2l0mE3cX4gCkQZFg,1705914562,–ö—ñ–Ω–æ—Ç–µ–∞—Ç—Ä –ñ–æ–≤—Ç–µ–Ω—å,7832,7832,-26000,-26000,980,0,0,251736,False,7A73-1T2P-4532-T2K3
aC1SlXxYclh3Ryk72g,1705913202,POLENE,5948,5948,-1641252,-39500,978,0,0,277736,False,423B-44P3-2B5P-95K9
gIWTh_Xiw5js20UwKQ,1705911108,–°—ñ–ª—å–ø–æ,5411,5411,-17800,-17800,980,0,133,1918988,False,8TEC-1TTK-T22P-0496
6UDbW-HKLOrCY5xPWg,1705842699,Novapay,8999,8999,-7300,-7300,980,0,0,1936788,False,XKP1-8MKK-2M3B-97E4
2SIDLTNt4tXLHcSJmA,1705842684,Apteka Bazhaiemo zdoro,5399,5399,-103832,-103832,980,0,898,1944088,False,C34H-8P6X-5775-6CTK
cCn1xsGJI4FzP2IQUQ,1705842146,Yaroslaviv Val 37-1,5921,5921,-13700,-13700,980,0,137,2047920,False,XH5K-4129-5BTX-HXE6
2XRnGAWCVWGa0kg3Ow,1705842097,–ï–∫–æ-–õ–∞–≤–∫–∞,5411,5499,-12900,-12900,980,0,129,2061620,False,06HP-EHP7-7X6T-H4ET
g4XPFf3OMp8CkG7DXg,1705823788,LyaFabrk,5814,5814,-8500,-8500,980,0,170,2074520,False,54ME-CC50-17A1-0077
oXBAfsCqGTtPWWSH7g,1705773489,–°—ñ–ª—å–ø–æ,5411,5411,-37143,-37143,980,0,371,2083020,False,TA16-05TC-AKAK-HC4E
Ovjv46nyJnZz6AaO1A,1705772625,–°—ñ–ª—å–ø–æ,5411,5411,-109300,-109300,980,0,1093,2120163,False,0XAT-4ET1-8KMA-6A8H
HMoQ1hIcdui0nc8PwA,1705766091,Foundation,5499,5499,-59325,-59325,980,0,593,2229463,False,8492-651H-EXXT-2P95
mza3xJh-brlJFA36rw,1705759252,Ukrkhalial,5499,5499,-20000,-20000,980,0,200,2288788,False,E1EM-PA83-4C27-04P8
qwFroEILdwBi95Klpg,1705756550,–ö–∏—ó–≤—Å—å–∫–µ –º–µ—Ç—Ä–æ,4111,4111,-800,-800,980,0,0,2308788,False,6H6X-3X5T-TAA9-34HM
NdkGrRlHDRWWbyGw9A,1705756050,Box Express Market,5499,5499,-2850,-2850,980,0,28,2309588,False,0TH5-4276-0605-CX53
HGQEhDfJjUoKwiE0fQ,1705752435,YOLO,5814,5814,-19500,-19500,980,0,390,2312438,False,T7E4-542P-7KPK-XM36
4LPEWraLl7KqEqmu0g,1705752141,Magazyn Tkanyny,5949,5949,-26400,-26400,980,0,0,2331938,False,5379-5H26-P1MK-3EX5
YqwLmqbEVIbo2TymwA,1705745706,Food Spot,5812,5812,-103000,-103000,980,0,2060,2358338,True,XTH0-T54A-5XXX-HH7X
jHn3e3bX5JuC6m527A,1705742839,–ù–æ–≤–∞ –ø–æ—à—Ç–∞,7399,7399,-6400,-6400,980,0,0,2461338,False,P3H8-H5XB-M6CK-1B30
ANHY3yPl4xQ5CpEnGg,1705692408,Konteiner,5814,5814,-40500,-40500,980,0,810,2467738,False,X8T6-8P9A-6E53-239X
6l3v7_m02QFtiIpztQ,1705671626,Novapay,8999,8999,-7000,-7000,980,0,0,2508238,False,KBK4-9HA9-4A67-8T3P
sur153lF_ctsXXG3DA,1705662789,–íi–¥: –ü–†–ò–•–û–î–¨–ö–û –ï.–í. –§–û–ü,"–î–ª—è –ø–æ–ø–æ–≤–Ω–µ–Ω–Ω—è –∫–∞—Ä—Ç–∫–∏ 5375414101190360, –ü—Ä–∏—Ö–æ–¥—å–∫–æ –ï—Ä–Ω–µ—Å—Ç –íi–∫—Ç–æ—Ä–æ–≤–∏—á, 3487403339",4829,4829,1500000,1500000,980,0,0,2515238,True
lz67oxoYIcUPvY2lhQ,1705651374,–¢–∞–±–∞–∫–µ—Ä–∫–∞,5993,5993,-163800,-163800,980,0,0,1015238,False,H4P7-H1X7-K5AE-H8A9
mNSWBtBczo4cd4VuFg,1705651258,Novus,5411,5411,-6398,-6398,980,0,47,1179038,False,CTX5-5A80-EXTB-224A
1P901pSYlwe0ZOlV-w,1705605015,Beerplace,5814,5814,-26000,-26000,980,0,195,1185436,False,7ME8-CCTK-2AM9-PPAH
WBMHFTASpc1r55i0uQ,1705604610,Novus,5411,5411,-19190,-19190,980,0,143,1211436,False,P0H8-6T36-511H-HEBE
MUvU7b9Qeha_RN7jGA,1705584682,CRUMB,5977,5977,-205000,-205000,980,0,0,1230626,True,K8HM-X808-B82P-5K59
EtM1UHMY1kr3CPomXw,1705572055,APTEKA 13,5912,5912,-185952,-185952,980,0,0,1435626,False,7H5A-0EH9-99P4-8764
-kPqAydLQAX_1VLkqg,1705567588,–°—ñ–ª—å–ø–æ,5411,5411,-89800,-89800,980,0,673,1621578,False,T900-4PHT-4HBE-8218
qH_zISFXETBQ913Bdw,1705483100,FOP Trenin MS,5814,5814,-8900,-8900,980,0,66,1711378,False,78P0-143C-CPM7-5P07
kDwsPsBvjfuTjtF5Dg,1705481970,"Lifecell
+380631692598",4814,4814,-30000,-30000,980,0,0,1720278,True,H8H9-E438-MH47-7BMB
5Xyse-SLJQuLnK9ULg,1705425007,Konteiner,5814,5814,-75500,-75500,980,0,566,1750278,False,9M77-7A8X-M0TH-KK3C
UYJtiMffZFa-Cxhf1Q,1705407580,MEDYCHNYI TSENTR 22,8099,8099,-178000,-178000,980,0,0,1825778,False,AXEE-XA61-965K-TCTC
PByO4pLjVeeg04qSgQ,1705401002,–ü–µ—Ä–µ–∫–∞–∑ –Ω–∞ –∫–∞—Ä—Ç–∫—É,4829,4829,-500000,-500000,980,0,0,2003778,True
Ac4ReB22KhwoMkYfzw,1705400575,–íi–¥: –ü–†–ò–•–û–î–¨–ö–û –ï.–í. –§–û–ü,"–î–ª—è –ø–æ–ø–æ–≤–Ω–µ–Ω–Ω—è –∫–∞—Ä—Ç–∫–∏ 5375414101190360, –ü—Ä–∏—Ö–æ–¥—å–∫–æ –ï—Ä–Ω–µ—Å—Ç –íi–∫—Ç–æ—Ä–æ–≤–∏—á, 3487403339",4829,4829,2400000,2400000,980,0,0,2503778,True
tvNugwlhsRHOnJ6mPQ,1705392959,–ö–æ–ª–æ,5411,5499,-5650,-5650,980,0,42,103778,False,3AT0-X640-75M2-EH68
9YkeiagwGvFgcXbxew,1705392634,128Cafe4,5814,5814,-67000,-67000,980,0,502,109428,False,X68M-K53X-PAMM-938B
h4H3J2456V7Nv-TwkA,1705310500,Pethouse,5995,5995,-306100,-306100,980,0,0,176428,False,5KXH-E893-K621-HKC5
TZSyPLkbkhYdLgzn-w,1705302982,–ó –±—ñ–ª–æ—ó –∫–∞—Ä—Ç–∫–∏,4829,4829,300000,300000,980,0,0,482528,True
mmhJTc26TJAxTV6ieg,1705301760,Bestwaytocup,5814,5814,-17500,-17500,980,0,131,182528,False,A9P7-3796-BPAE-689A
6rerL4xa4i5eRzluIg,1705250012,–¢–∞–±–∞–∫–µ—Ä–∫–∞,5993,5993,-81900,-81900,980,0,0,200028,False,6946-0CEX-KK33-P80P
NRQG6RsAFYIyJb95ug,1705230083,–ó –±—ñ–ª–æ—ó –∫–∞—Ä—Ç–∫–∏,4829,4829,200000,200000,980,0,0,281928,True
qWhkRNyZfmymvO5pgA,1705168205,–§–ö –ï–í–û,5399,5399,-79900,-79900,980,0,599,81928,False,9575-PM9H-055M-XC11
eC6MsElP5Cao27ZULg,1705140740,–ö–∏—ó–≤—Å—å–∫–µ –º–µ—Ç—Ä–æ,4111,4111,-800,-800,980,0,0,161828,False,23EM-H2B2-EP6M-B744
Dv_ArEWWblk9rV3cpg,1705140732,–ö–∏—ó–≤—Å—å–∫–µ –º–µ—Ç—Ä–æ,4111,4111,-800,-800,980,0,0,162628,False,KMC2-H66M-4M2M-7M2E
8L_YzlUILNvD__eqJA,1705139733,Magazin produktv Food,5499,5499,-1350,-1350,980,0,10,163428,False,K14H-AP8C-XMPK-X0BC
oVB_T1vo8ehDedCw0w,1705080318,–ó–æ–æ–º–∞–≥–∞–∑–∏–Ω,742,742,-1145000,-1145000,980,0,0,164778,False,80A1-7TTC-E9AH-XH4H
hVIDO7_Yqduh9rPQWQ,1705080304,–ó –±—ñ–ª–æ—ó –∫–∞—Ä—Ç–∫–∏,4829,4829,200000,200000,980,0,0,1309778,True
oF_d46q-0V5QSgp1rA,1705075023,Apteka Bazhaiemo zdoro,5399,5399,-135339,-135339,980,0,1015,1109778,False,C16M-KM69-XTX7-K37A
F13CxzqDuVJ2-WGzig,1704996238,Bolt,4121,4121,-20500,-20500,980,0,0,1245117,False,E506-B1M2-2400-B73P
d4Y7gJOScxFWjHs3qg,1704967403,–ö–∏—ó–≤–ø–∞—Å—Ç—Ä–∞–Ω—Å,4111,4111,-800,-800,980,0,0,1265617,False,6HAM-KMEE-27XT-KT6K
rOVrk5hIoWjV36raKA,1704959924,Magazin BergHOFF,5719,5719,-179900,-179900,980,0,0,1266417,False,K729-4M8M-CT79-MKK1
EUGE8wmq1-eq1rlW2g,1704959153,Bestwaytocup,5814,5814,-24000,-24000,980,0,180,1446317,False,XTT5-MM07-C8T4-9A49
XScmODQcXK1ucdoDxA,1704958954,Novus,5411,5411,-47347,-47347,980,0,355,1470317,False,E16B-X5XT-H4AC-91K7
7IJIUA_dAaI-CHDeLw,1704907919,Novus,5411,5411,-40198,-40198,980,0,301,1517664,False,2748-B5BB-AK28-865X
A9YFh2ADZ5Pn_4cPRQ,1704900535,EasyPay,5411,5411,-396177,-396177,980,0,2971,1557862,False,A2XM-277B-7MHC-4CH2
T_ZLCw5M90sItpDJdw,1704869494,–°—ñ–ª—å–ø–æ,5411,5411,-96000,-96000,980,0,845,1954039,False,T306-7X90-B519-E75P
81ydyXYjQCGtGUO4ZA,1704820313,FIT_STRETCH HUB,7997,7997,-100000,-100000,980,0,0,2050039,True,9EK3-P33X-B952-B211
DyS8V-Zh8mdTVh4YkQ,1704789346,Zigzag,5814,5814,-40200,-40200,980,0,804,2150039,False,K693-PP89-TBX1-6C77
JPiFcjDEOIPY2jYVUQ,1704743780,–ü–µ—Ä–µ–∫–∞–∑ –Ω–∞ –∫–∞—Ä—Ç–∫—É,4829,4829,-1500000,-1500000,980,0,0,2190239,True
RjgUUObfN-q5Gks1FQ,1704740476,FOPKrivoruchenkoNV,7230,7230,-283000,-283000,980,0,0,3690239,False,E2X9-PT07-2358-28KP
DOkQSClxWTLXCiczCQ,1704715150,FDY*Merchandise,5399,5399,-98590,-98590,980,0,985,3973239,False,05MT-8313-ATK8-M3HE
crLgcxem2CE4RmtiOg,1704703358,–íi–¥: –ü–†–ò–•–û–î–¨–ö–û –ï.–í. –§–û–ü,"–î–ª—è –ø–æ–ø–æ–≤–Ω–µ–Ω–Ω—è –∫–∞—Ä—Ç–∫–∏ 5375414101190360, –ü—Ä–∏—Ö–æ–¥—å–∫–æ –ï—Ä–Ω–µ—Å—Ç –íi–∫—Ç–æ—Ä–æ–≤–∏—á, 3487403339",4829,4829,4000000,4000000,980,0,0,4071829,True
9Vr449oll535US69_w,1704700398,Apteka Bazhaiemo zdorovia,5399,5399,-111115,-111115,980,0,833,71829,False,402B-ETBH-3663-66PK
GAGTbG_mcoTaGnZ7Gg,1704699596,–ó –±—ñ–ª–æ—ó –∫–∞—Ä—Ç–∫–∏,4829,4829,100000,100000,980,0,0,182944,True
D7LTmRQUCUOCaeWrNA,1704635588,–°—ñ–ª—å–ø–æ,5411,5411,-212700,-212700,980,0,1595,82944,False,K3E5-0CX2-C946-9C68
Ht1g3c6X3pe1GctYHA,1704632953,–ó –±—ñ–ª–æ—ó –∫–∞—Ä—Ç–∫–∏,4829,4829,200000,200000,980,0,0,295644,True
mlUBtgwQh6vrveiB1w,1704620632,MasterZoo,5995,5995,-83505,-83505,980,0,4175,95644,False,E35H-CHT7-HBH7-M633
bue21WqWT85KEwXCBQ,1704619218,–ú—ñ—Å—å–∫–∞ –á–¥–∞–ª—å–Ω—è,5814,5814,-21000,-21000,980,0,157,179149,False,KXK9-1P3T-M7A7-7PC5
tQUxcm8NQqiIl8N-Yg,1704619128,–ú—ñ—Å—å–∫–∞ –á–¥–∞–ª—å–Ω—è,5814,5814,-29000,-29000,980,0,217,200149,False,E34X-PA5K-EPH2-M9P6
9gkRcw4TRacZm00Org,1704615642,Pethouse,5995,5995,-335400,-335400,980,0,0,229149,False,EX37-C7XM-H103-7BC4
TOt3ZaNVmPLudPsogg,1704615625,–ó –±—ñ–ª–æ—ó –∫–∞—Ä—Ç–∫–∏,4829,4829,300000,300000,980,0,0,564549,True
OCotYBGiUgFWM1PG0g,1704567659,LIQPAY*Shibuya Yarosla,5812,5812,-46725,-46725,980,0,350,264549,False,C374-5P95-E6P2-5AA5
X3Y8-V4S3SXXbHWd1g,1704550269,–ê–¢–õ,5533,5533,-389900,-389900,980,0,0,311274,False,439E-5M4B-XC00-E8XE
l9Z-Uox4IZ0Bg5R41w,1704547081,–ú—ñ—Å—å–∫–∞ –∫–∞–≤'—è—Ä–Ω—è,5812,5812,-10000,-10000,980,0,75,701174,False,X7HH-46KH-06ET-T729
eNhELQC3_ml6nVq8Ow,1704536645,–¢–∞–±–∞–∫–µ—Ä–∫–∞,5993,5993,-81900,-81900,980,0,0,711174,False,37EE-X32C-2E68-AXBE
zXOe_QntbqsDOMrlFA,1704536577,Novus,5411,5411,-11296,-11296,980,0,84,793074,False,01M3-5HCM-KKTH-40XE
KpXdjY2kgie5XGwQOQ,1704532566,Kafe Kaviarnia humans,5814,5814,-59500,-59500,980,0,446,804370,False,BPHB-P6P2-4097-X0CB
TMojp-4s_7Dt648NaQ,1704458276,–ó–∞–≤–µ—Ä—Ç–∞–π–ª–æ –°–æ—Ñ—ñ—è ,5812,5812,-107800,-107800,980,0,808,863870,True,2XB6-H7P5-TP50-PBKM
QMQJEWIVMP7cegIf-w,1704454085,–ö–∏—ó–≤–ø–∞—Å—Ç—Ä–∞–Ω—Å,4111,4111,-800,-800,980,0,0,971670,False,ABPE-08E5-HPCB-60HH
clhcCoi7QXbPmsLkBA,1704453998,–°–∫–∞—Å—É–≤–∞–Ω–Ω—è. Uklon,4121,4121,5600,5600,980,0,0,972470,False
gquFy-6-8_JnnVwREA,1704453983,Uklon,4121,4121,-5600,-5600,980,0,0,966870,False
d_OIOfevFkXQCq2sNQ,1704442395,LOKO,5411,5411,-29650,-29650,980,0,222,972470,False,K318-3H8P-2C8P-6CPM
DhP_DaS3D2mtzDNA4A,1704440202,Bestwaytocup,5814,5814,-10000,-10000,980,0,75,1002120,False,XAX3-0K2B-AX98-337M
MAOgVVdbZAdEIMnF3g,1704439788,Bestwaytocup,5814,5814,-44600,-44600,980,0,334,1012120,False,MP8A-T815-9B96-1P53
NZ_QT2I1uYlCmgUlsA,1704392786,Novus,5411,5411,-35295,-35295,980,0,264,1056720,False,M5AB-0K5M-T31T-845T
yCeuoG7GSL_EXgUOkg,1704387869,–ï–ø—ñ—Ü–µ–Ω—Ç—Ä,5200,5200,-338140,-338140,980,0,0,1092015,False,4P8P-H6KM-422B-X89X
x84mqyACwvNovK2wpw,1704381649,KFC,5814,5812,-12500,-12500,980,0,93,1430155,False,C9B2-0759-419K-8TX1
uCeeM0YOR75W_tHXPw,1704381309,Novapay,8999,8999,-5300,-5300,980,0,0,1442655,False,B61E-M710-83CM-9E85
RyXc078JWson9RD57Q,1704381305,Novapay,6538,6538,-74934,-74934,980,2534,0,1447955,False,B1XA-490A-84T9-1BBE
oOsE8A8SHRd3ujxsyw,1704379743,BERKOVECKAAShANGRAP,5944,5944,-223400,-223400,980,0,0,1522889,False,TC38-20K9-AH90-1642
4uRytHkpHI9sNNx4nQ,1704373800,MauDau,5331,5411,-199900,-199900,980,0,1499,1746289,False,C2HM-5P64-KC5T-25X0
56BankwZ8T40UAmRYg,1704373372,"Lifecell
+380731983817",4814,4814,-10000,-10000,980,0,0,1946189,True,B7KX-5T8C-XH9M-EE27
lOYVALCEBXqkCzNNIw,1704306512,Apteka Bazhaiemo zdorovia,5399,5399,-62070,-62070,980,0,511,1956189,False,T9CB-C801-HPB5-8PE5
lP02JlbBVgObM-laYA,1704306397,–ö–æ–ª–æ,5411,5499,-4650,-4650,980,0,46,2018259,False,TH86-4BB6-EAHE-K1CH
xr6uOIsMiwKQOQBvUA,1704303619,Rozetka,5399,5399,-22900,-22900,980,0,229,2022909,False,X7HE-B017-XE36-B66P
ZPPZC0gIZrkb1TelHg,1704287804,*=34044,5912,5912,-26900,-26900,980,0,0,2045809,False,T772-BT63-P0AX-KE4K
Xzs0YyiuIMoArkZRQQ,1704286636,Mates,5812,5812,-36800,-36800,980,0,736,2072709,True,867T-P5PM-B98E-6K88
F4pq8s-eyCOH-Lr8Ow,1704280260,–ü–æ–ø–æ–≤–Ω–µ–Ω–Ω—è ¬´–ù–∞ –∫–∞–º–ø—É—Ç—î—Ä –¥–ª—è –≥—Ç–∞6¬ª,4829,4829,-7500,-7500,980,0,0,2109509,True
n6cygCKbWan6QeHLUg,1704280176,–ü–µ—Ä–µ–∫–∞–∑ –Ω–∞ –∫–∞—Ä—Ç–∫—É,4829,4829,-1000000,-1000000,980,0,0,2117009,True
-DTwEDc2O-o0s0GnoA,1704278085,–íi–¥: –ü–†–ò–•–û–î–¨–ö–û –ï.–í. –§–û–ü,"–î–ª—è –ø–æ–ø–æ–≤–Ω–µ–Ω–Ω—è –∫–∞—Ä—Ç–∫–∏ 5375414101190360, –ü—Ä–∏—Ö–æ–¥—å–∫–æ –ï—Ä–Ω–µ—Å—Ç –íi–∫—Ç–æ—Ä–æ–≤–∏—á, 3487403339",4829,4829,3000000,3000000,980,0,0,3117009,True
xK322D-J78LkIBtztw,1704272099,Bestwaytocup,5814,5814,-25000,-25000,980,0,187,117009,False,29B8-HBM6-1XX7-1M8B
5jF5WpawqO2NSwAqOg,1704214184,Novapay,8999,8999,-5000,-5000,980,0,0,142009,False,P12A-HBH8-C522-HMM0
a7ozcxxZU2xEIh9iCw,1704200073,–¢–∞–±–∞–∫–µ—Ä–∫–∞,5993,5993,-81900,-81900,980,0,0,147009,False,2MA4-BXHC-K662-X132
bl6hZe5rboPammeEzQ,1704200004,Novus,5411,5411,-28446,-28446,980,0,213,228909,False,7MP5-H7K3-B6X2-4AMT
HnxEi3zpLUtlNZc5Kw,1704199602,–ó –±—ñ–ª–æ—ó –∫–∞—Ä—Ç–∫–∏,4829,4829,100000,100000,980,0,0,257355,True
RXgMOj_AOrQn-S3vGw,1704197061,–ê–ø—Ç–µ–∫–∞ –ê–ù–¶,5912,5912,-119750,-119750,980,0,5987,157355,False,KBX4-0EMX-K8XK-19M8
nmhIT40H2ht9HFoPGg,1704192878,–ú—ñ—Å—å–∫–∞ –∫–∞–≤'—è—Ä–Ω—è,5812,5812,-5500,-5500,980,0,0,277105,False,5C22-MX0X-BXCM-9PCC
suZ75NFPDJNm3zdDdA,1704185016,Bestwaytocup,5814,5814,-7500,-7500,980,0,0,282605,False,M13B-3390-C1K3-3AT5
3xRQkdgQd9YIZywwXg,1704098371,Produkti,5499,5499,-5900,-5900,980,0,0,290105,False,63KX-31EK-9P2M-0KA9
ljVImxVHcJDFIVU9FQ,1706601335,–ó–æ—Ä—è–Ω–∞ –í.,4829,4829,-15000,-15000,980,0,0,476926,True,M007-KE2K-KMM2-X97X
hkZK226HlHo5P6y4jA,1706601186,–û–ª–µ–∫—Å–∞–Ω–¥—Ä –£.,4829,4829,-41900,-41900,980,0,0,491926,True,EA8X-1781-6H7P-2E5M
xJ_CYfHBNaJqglg6TQ,1706512583,Lesya,4829,4829,-300000,-300000,980,0,0,533826,True,55K4-E603-BPH7-2A3M
d4mcz9L17BAyH3l5OA,1706463518,PRTMN  *INTERNET,4816,4816,-10200,-10200,980,0,0,833826,False,1A95-69B7-HXB6-0HM4
_x4x5mHPJIdfIX-c2A,1706462742,–Æ–ª—ñ—è –ë.,4829,4829,-95000,-95000,980,0,0,844026,True,9H1M-HTKX-6MPE-30C4
m1DTlK4Rvj9khjKs1A,1706412390,–†–µ–≥—É–ª—è—Ä–Ω–µ –ø–æ–ø–æ–≤–Ω–µ–Ω–Ω—è ¬´–§–æ–Ω–¥ –ü–æ–≤–µ—Ä–Ω–∏—Å—å –∂–∏–≤–∏–º¬ª,4829,4829,-25000,-25000,980,0,0,939026,True
ahQEp5vddlPo_mTNhw,1706277077,–ó –ø–ª–∞—Ç–∏–Ω–æ–≤–æ—ó –∫–∞—Ä—Ç–∫–∏,4829,4829,900000,900000,980,0,0,964026,True
REtzKzeC425Wt6CA6Q,1706082936,Lesya,4829,4829,-200000,-200000,980,0,0,64026,True,TT27-2B7E-06AA-7EEX
KRkpY61iifYzsNjfqg,1706003213,–ü–µ—Ä–µ–∫–∞–∑ –Ω–∞ –∫–∞—Ä—Ç–∫—É,4829,4829,-300000,-300000,980,0,0,264026,True
Knuv9oXey97__xqWDg,1705915251,Lesya,4829,4829,-300000,-300000,980,0,0,564026,True,516H-163P-E4X6-68E5
v0dfehaiQ8bFeuDUjQ,1705807468,–†–µ–≥—É–ª—è—Ä–Ω–µ –ø–æ–ø–æ–≤–Ω–µ–Ω–Ω—è ¬´–§–æ–Ω–¥ –ü–æ–≤–µ—Ä–Ω–∏—Å—å –∂–∏–≤–∏–º¬ª,4829,4829,-25000,-25000,980,0,0,864026,True
p0wBOvJKa6PiZQl0eg,1705660159,–ü–æ–ø–æ–≤–Ω–µ–Ω–Ω—è ¬´–ù–∞ –∫–∞–º–ø—É—Ç—î—Ä –¥–ª—è –≥—Ç–∞6¬ª,4829,4829,-8000,-8000,980,0,0,889026,True
w6c8osn_ooq3BVx8Fg,1705660136,Lesya,4829,4829,-370000,-370000,980,0,0,897026,True,AAKE-192C-4784-8352
s9DQ_1k_RIb7Mc4K-A,1705651835,–¢–µ—Ä–º—ñ–Ω–∞–ª City24,4829,4829,370000,370000,980,0,0,1267026,True
8lMiPFE1BvVoA6XqXQ,1705401033,–ü–æ–ø–æ–≤–Ω–µ–Ω–Ω—è ¬´–ù–∞ –∞–≤—Ç–æ –¥–ª—è –ë–ü–õ–ê¬ª,4829,4829,-150000,-150000,980,0,0,897026,True,K2PB-7H1X-06A1-26HK
Dm5cnJIRIBQ2VSc60w,1705401002,–ó –ø–ª–∞—Ç–∏–Ω–æ–≤–æ—ó –∫–∞—Ä—Ç–∫–∏,4829,4829,500000,500000,980,0,0,1047026,True
7BSynNpQZrPAQOQO8g,1705302982,–ü–µ—Ä–µ–∫–∞–∑ –Ω–∞ –∫–∞—Ä—Ç–∫—É,4829,4829,-300000,-300000,980,0,0,547026,True
MldX6-YNBXmsub6IYA,1705230083,–ü–µ—Ä–µ–∫–∞–∑ –Ω–∞ –∫–∞—Ä—Ç–∫—É,4829,4829,-200000,-200000,980,0,0,847026,True
r5mR4Yqcpr9NqVqj2g,1705202639,–†–µ–≥—É–ª—è—Ä–Ω–µ –ø–æ–ø–æ–≤–Ω–µ–Ω–Ω—è ¬´–§–æ–Ω–¥ –ü–æ–≤–µ—Ä–Ω–∏—Å—å –∂–∏–≤–∏–º¬ª,4829,4829,-25000,-25000,980,0,0,1047026,True
0tE2IsrAka6wyK-YvA,1705080304,–ü–µ—Ä–µ–∫–∞–∑ –Ω–∞ –∫–∞—Ä—Ç–∫—É,4829,4829,-200000,-200000,980,0,0,1072026,True
_O6gcCiYZuFydCijXw,1704999179,–ñ–∞–Ω–Ω–∞ –ñ.,4829,4829,-250000,-250000,980,0,0,1272026,True,KKCM-M9E3-E2H2-7BXP
VdABAWrXWcNLdHXtYA,1704884897,Lesya,4829,4829,-500000,-500000,980,0,0,1522026,True,3PPH-88H0-T4B8-B1AM
JXsAgjrRLAJByihA9Q,1704743780,–ó –ø–ª–∞—Ç–∏–Ω–æ–≤–æ—ó –∫–∞—Ä—Ç–∫–∏,4829,4829,1500000,1500000,980,0,0,2022026,True
_Ww2gUUYM1kC3dlEUg,1704704729,–ü–æ–ø–æ–≤–Ω–µ–Ω–Ω—è ¬´MAVIC 3T Thermal¬ª,4829,4829,-2701000,-2701000,980,0,0,522026,True,PCBC-TE7A-BM46-B237
FTIx8j2Td3vDHymwCQ,1704704677,–í–∏–ø–ª–∞—Ç–∞ –±–∞–Ω–∫–∏ ¬´–ù–∞ Mavic¬ª,4829,4829,2701005,2701005,980,0,0,3223026,True
7sF4YtXLJm6disupng,1704699596,–ü–µ—Ä–µ–∫–∞–∑ –Ω–∞ –∫–∞—Ä—Ç–∫—É,4829,4829,-100000,-100000,980,0,0,522021,True
HFhUt96cMEDeSMz_tQ,1704632953,–ü–µ—Ä–µ–∫–∞–∑ –Ω–∞ –∫–∞—Ä—Ç–∫—É,4829,4829,-200000,-200000,980,0,0,622021,True
jqrn2hwigxpB4I6GAQ,1704615625,–ü–µ—Ä–µ–∫–∞–∑ –Ω–∞ –∫–∞—Ä—Ç–∫—É,4829,4829,-300000,-300000,980,0,0,822021,True
Q3GO1K9FzosmcAhLew,1704597903,–†–µ–≥—É–ª—è—Ä–Ω–µ –ø–æ–ø–æ–≤–Ω–µ–Ω–Ω—è ¬´–§–æ–Ω–¥ –ü–æ–≤–µ—Ä–Ω–∏—Å—å –∂–∏–≤–∏–º¬ª,4829,4829,-25000,-25000,980,0,0,1122021,True
5YKwkATQL4OVfatCHQ,1704574580,Lesya,4829,4829,-150000,-150000,980,0,0,1147021,True,23XM-76E2-99MX-6T93
dwtAgcaseW56UHnXkw,1704531004,–ü–æ–ø–æ–≤–Ω–µ–Ω–Ω—è ¬´–î–ª—è –º–æ—Ä–ø—ñ—Ö—ñ–≤¬ª,4829,4829,-100,-100,980,0,0,1297021,True,129B-HH9C-KP70-11C0
ev2o6STz9J4P4YWoRA,1704467804,–ü–æ–ø–æ–≤–Ω–µ–Ω–Ω—è ¬´–ù–∞ –∫–∞–º–ø—É—Ç—î—Ä –¥–ª—è –≥—Ç–∞6¬ª,4829,4829,-3700,-3700,980,0,0,1297121,True
9F7YJ2OeVRh2HzKEsw,1704467778,–ü–æ–ø–æ–≤–Ω–µ–Ω–Ω—è ¬´–ù–∞ –°—Ç–∞–ª–µ–≤—ñü¶øü¶ø¬ª,4829,4829,-50000,-50000,980,0,0,1300821,True,C445-MXBB-410E-9894
x3qwa-2OBG-UCXVjTw,1704448689,–ü–æ–ø–æ–≤–Ω–µ–Ω–Ω—è ¬´–ù–∞ FPV –¥–ª—è ¬´–©–µ–¥—Ä–∏–∫–∞¬ª¬ª,4829,4829,-50000,-50000,980,0,0,1350821,True,HK10-7H6M-0HBB-7C0H
aOTbL5eooYURi9dJOQ,1704280176,–ó –ø–ª–∞—Ç–∏–Ω–æ–≤–æ—ó –∫–∞—Ä—Ç–∫–∏,4829,4829,1000000,1000000,980,0,0,1400821,True
SQ8ggY5RNnvS7H_a2Q,1704199602,–ü–µ—Ä–µ–∫–∞–∑ –Ω–∞ –∫–∞—Ä—Ç–∫—É,4829,4829,-100000,-100000,980,0,0,400821,True
NpSRZKXatKHvHYhtRQ,1709154390,–Ü–Ω—Ç–µ—Ä–Ω–µ—Ç —ñ –¢–ë,4900,4900,-10000,-10000,980,0,0,2316326,True,3PE7-46K6-KH67-KAEA
0zQuSYYotnaCrPnH_w,1709145290,Novapay,8999,8999,-5400,-5400,980,0,0,2326326,False,TAT9-A1P3-E227-PAT2
eXwGzN1-5OHwubyzoQ,1709142108,Novus,5411,5411,-24596,-24596,980,0,0,2331726,False,1CK1-55XE-BBCP-M75M
MkeGNCqHQ4mRPFrvWg,1709141866,MasterZoo,5995,5995,-46035,-46035,980,0,2301,2356322,False,H259-5M0X-2666-P736
yaNBYG5kpJmmfzaksA,1709132914,Lesya,4829,4829,-500000,-500000,980,0,0,2402357,True,5TT5-95B0-X73B-C3E3
ZVMv9T8bCkveDdfkZg,1709116268,–íi–¥: –ü–†–ò–•–û–î–¨–ö–û –ï.–í. –§–û–ü,"–î–ª—è –ø–æ–ø–æ–≤–Ω–µ–Ω–Ω—è –∫–∞—Ä—Ç–∫–∏ 5375414101190360, –ü—Ä–∏—Ö–æ–¥—å–∫–æ –ï—Ä–Ω–µ—Å—Ç –íi–∫—Ç–æ—Ä–æ–≤–∏—á, 3487403339",4829,4829,2700000,2700000,980,0,0,2902357,True
Pcn2dFn-_CUslhVlGg,1709053960,–°—ñ–ª—å–ø–æ,5411,5411,-11000,-11000,980,0,0,202357,False,7627-P220-001C-6KHM
FyHjJl6LM6cSZhanBA,1709039472,–Ü–Ω—Ç–µ—Ä–Ω–µ—Ç —ñ –¢–ë,4900,4900,-35000,-35000,980,0,0,213357,True,7H6K-878H-1ECH-XTKP
rrGGIRxNaV25jdtQbQ,1708973534,–°—ñ–ª—å–ø–æ,5411,5411,-114346,-114346,980,0,0,248357,False,9900-P5E1-BP2E-174B
7H3_XjuBgaTdAEjpTA,1708879052,–ê–ø—Ç–µ–∫–∞ –ê–ù–¶,5912,5912,-40910,-40910,980,0,2045,362703,False,7C85-K43M-0T3P-M3MP
Ip7MyDc4eDbcQyUaJA,1708878817,–ö–æ–ª–æ,5411,5499,-12100,-12100,980,0,0,403613,False,E7KC-T3H1-TPA9-6171
-LLUbKFJu1mrd0rs7w,1708877916,Pethouse,5995,5995,-306100,-306100,980,0,2295,415713,False,3CE4-CBX8-CB94-0TMP
cwcO-HsI_GgeKPfwsA,1708877336,–ó –±—ñ–ª–æ—ó –∫–∞—Ä—Ç–∫–∏,4829,4829,400000,400000,980,0,0,721813,True
bSThrU6YM-gGeRaokg,1708872904,Knygosklad,5942,5942,-105300,-105300,980,0,0,321813,False,PC82-BHK8-7969-1P27
Zd-Tl5KUcDbmMCkR2w,1708867588,FDY*Merchandise,5399,5399,-73670,-73670,980,0,0,427113,False,4523-K1H4-HC03-K2KC
jG3aitY-y1bL707mQQ,1708855035,–ü–∞—Ä–∫ ¬´–ú—É—Ä–æ–º–µ—Ü—å¬ª,7523,7523,-3000,-3000,980,0,0,500783,False,M2HH-BBM2-3398-KAC0
OgdOSWR1-nSgnPtzZw,1708786599,–¢–∞–±–∞–∫–µ—Ä–∫–∞,5993,5993,-163800,-163800,980,0,0,503783,False,PX33-CPE8-H96B-07KH
h3QpwA-oWRXeS1EJSw,1708769191,–ö–∏—ó–≤–ø–∞—Å—Ç—Ä–∞–Ω—Å,4111,4111,-800,-800,980,0,0,667583,False,908P-573E-H84K-5K08
YisQl1Bolo3QYMElsA,1708766685,–í–µ—Ç–µ—Ä–∏–Ω–∞—Ä–Ω–∞ –∞–ø—Ç–µ–∫–∞,742,742,-570000,-570000,980,0,4275,668383,False,43KM-39AC-5E6T-TBA2
J7z5oIulsTRGnNhpfA,1708702304,–ê–ø—Ç–µ–∫–∞ ¬´–ë–∞–∂–∞—î–º–æ –∑–¥–æ—Ä–æ–≤'—è¬ª,5912,5399,-28811,-28811,980,0,216,1238383,False,8EB9-1P43-AEP3-0HHX
P22tgmNarLIX9QLs8g,1708677495,Bestwaytocup,5814,5814,-75600,-75600,980,0,0,1267194,False,C65C-96XT-KKHH-1PM4
hIdGPAhGQDunnqPv2Q,1708675273,–°—ñ–ª—å–ø–æ,5411,5411,-8899,-8899,980,0,0,1342794,False,E6KH-408H-031H-074T
fxlQWFHFEVmKTCMjfg,1708624763,–ê–ø—Ç–µ–∫–∞ –ê–ù–¶,5912,5912,-133300,-133300,980,0,6665,1351693,False,MB73-2T68-8T30-098B
XZ8r5F_kepofRwzbcw,1708624293,–°—ñ–ª—å–ø–æ,5411,5411,-70412,-70412,980,0,0,1484993,False,P95B-0H47-096H-6T2X
jMSqjxki5YtbE105Nw,1708605979,PARKINH PARKING,7523,7523,-16000,-16000,980,0,0,1555405,False,H4CC-5H4K-23PX-248T
crWYqLQ26M0WF6GWbQ,1708604055,PARKINGKAVA,5814,5814,-12500,-12500,980,0,0,1571405,False,K3TC-57CT-3K6M-2EH3
4fYSCFFKJIKUAP31AQ,1708587428,PetStoriesZootovari,5995,5995,-61000,-61000,980,0,457,1583905,False,513K-TXC4-ABHC-365A
90eV4dv-tnrzECNWxA,1708586807,kaviarnia the coffee Lviv,5812,5812,-4000,-4000,980,0,0,1644905,False,AXM8-CTAK-T9E7-1602
Nkxtmr6Zskjo6FtXhg,1708585481,Bestwaytocup,5814,5814,-20500,-20500,980,0,0,1648905,False,40E8-C31K-0C0C-6MAH
UBW1xQ_n1w811qSoNA,1708538963,–°—ñ–ª—å–ø–æ,5411,5411,-64642,-64642,980,0,0,1669405,False,EP3P-T56P-E607-842M
U83-irQlYjbm_n0rgg,1708514737,–ü–µ—Ä–µ–∫–∞–∑ –Ω–∞ –∫–∞—Ä—Ç–∫—É,4829,4829,-2008994,-2008994,980,8994,0,1734047,True
8_vGx366i9xu7Lrf3g,1708514737,EasyPay,5411,5411,-265675,-265675,980,0,0,3743041,False,A8H1-TXE2-TC5K-T2E2
E7TmMu3TCiTm3YNDBA,1708510089,–íi–¥: –ü–†–ò–•–û–î–¨–ö–û –ï.–í. –§–û–ü,"–î–ª—è –ø–æ–ø–æ–≤–Ω–µ–Ω–Ω—è –∫–∞—Ä—Ç–∫–∏ 5375414101190360, –ü—Ä–∏—Ö–æ–¥—å–∫–æ –ï—Ä–Ω–µ—Å—Ç –íi–∫—Ç–æ—Ä–æ–≤–∏—á, 3487403339",4829,4829,2000000,2000000,980,0,0,4008716,True
Dg4Vuoj6UsIYeCnK2w,1708510008,–íi–¥: –ü–†–ò–•–û–î–¨–ö–û –ï.–í. –§–û–ü,"–î–ª—è –ø–æ–ø–æ–≤–Ω–µ–Ω–Ω—è –∫–∞—Ä—Ç–∫–∏ 5375414101190360, –ü—Ä–∏—Ö–æ–¥—å–∫–æ –ï—Ä–Ω–µ—Å—Ç –íi–∫—Ç–æ—Ä–æ–≤–∏—á, 3487403339",4829,4829,2000000,2000000,980,0,0,2008716,True
jQ3-9WrUqkvxSMcDDQ,1708428786,Uklon,4121,4121,-17000,-17000,980,0,0,8716,False,8475-CEH6-4ACT-142E
_XeyUErTOwn4xO-pBw,1708353384,FOPKarasOksanaOlegivna,742,742,-270000,-270000,980,0,2025,25716,False,86HB-9XE2-5HBK-XP3A
VgdQKBDfP-fAFEolcQ,1708273790,Novus,5411,5411,-29307,-29307,980,0,0,295716,False,EK15-AB3K-8CAH-0TC2
XIDoEqxbd1AU-naANA,1708252687,Novus,5411,5411,-17295,-17295,980,0,0,325023,False,5T87-HP4K-8BXK-CTP5
eSTDsqS7pvwh2v5qZw,1708251372,Kievskaya106,5912,5912,-67910,-67910,980,0,509,342318,False,XT85-8A10-2B19-K578
6YXiSQG_2oZjXzCKrQ,1708251168,Kievskaya106,5912,5912,-65270,-65270,980,0,489,410228,False,5B37-A9H9-09AM-B5E4
OrxfVdEq3UFYsNgKag,1708176205,Novus,5411,5411,-18998,-18998,980,0,0,475498,False,A40H-9056-95AK-X2B0
kT1eNG-T8A4Xyf5BNQ,1708102013,Novus,5411,5411,-27591,-27591,980,0,0,494496,False,8K2E-EXCT-6HK3-T4BH
RBBzWxOzQtaMPqNFGQ,1708100719,MasterZoo,5995,5995,-30690,-30690,980,0,1534,522087,False,6534-8B50-E776-40X5
ZyiRL6xA0E_a090hAw,1708097846,Novapay,8999,8999,-7000,-7000,980,0,0,552777,False,XM06-BP4T-BTTK-4X02
A_mgYahxPjaWjzQVBA,1708086813,–ê–ø—Ç–µ–∫–∞ –ê–ù–¶,5912,5912,-22890,-22890,980,0,1144,559777,False,HX90-BEMA-AXHE-A53K
j0ZPfd-oSgBHSxAsZg,1708085559,–ê–ø—Ç–µ–∫–∞,5912,5912,-163330,-163330,980,0,1224,582667,False,M48A-1AMM-XB2T-889M
0JOdkFyH8oGlglIC6w,1708078429,Novapay,8999,8999,-5500,-5500,980,0,0,745997,False,8668-C3C7-1T5B-8198
DXRZiirvqihMu4Jpscg3FQ,1708041498,"FDY*RESTAURANTS,14.14.14.14.KRUGLOUNIV AVE,KYIV,UA",5814,5814,-97860,-97860,980,0,0,751497,True
CYDVWps7uwzdQ9WYUFOAp5yrL64,1708041498,–°–∫–∞—Å—É–≤–∞–Ω–Ω—è. PLANB,5814,5814,102860,102860,980,0,0,849357,False
AiravB4hRvDQ56WGLZ0P,1708041498,–°–∫–∞—Å—É–≤–∞–Ω–Ω—è. –£–∫—Ä–∑–∞–ª—ñ–∑–Ω–∏—Ü—è,4112,4112,75434,75434,980,0,0,746497,False
qRhacsKkyTmZlfg0vA,1708008003,–¢–∞–±–∞–∫–µ—Ä–∫–∞,5993,5993,-163800,-163800,980,0,0,671063,False,HEB9-154T-M820-BTHT
f_OAf3uEnBJ_V__37g,1708007865,Novus,5411,5411,-30295,-30295,980,0,0,834863,False,8KXX-AKH3-8393-707E
msr5V6Pth1ek_-l1ug,1708007104,–ê–ø—Ç–µ–∫–∞ –ê–ù–¶,5912,5912,-71850,-71850,980,0,3592,865158,False,0T40-59E5-PT49-HPC9
up2CAVf_l5w-QIbVCw,1708003420,Pethouse,5995,5995,-40600,-40600,980,0,304,937008,False,C85T-3133-X7CT-P9H0
rikqYtW6tm6DF2zb4Q,1707994351,–ö–∏—ó–≤ –¶–∏—Ñ—Ä–æ–≤–∏–π,4111,4111,-28000,-28000,980,0,0,977608,False,6P7B-6XB4-P79C-5AB0
drikUx3nGxK5FRhM_g,1707933599,–ê–ø—Ç–µ–∫–∞ ¬´–ë–∞–∂–∞—î–º–æ –∑–¥–æ—Ä–æ–≤'—è¬ª,5912,5399,-12970,-12970,980,0,97,1005608,False,982T-3X1P-X4B5-363E
SAhfhUDT2QceleMq-g,1707933202,–°—ñ–ª—å–ø–æ,5411,5411,-103082,-103082,980,0,0,1018578,False,0E3B-K1TA-K8H1-2A31
ngjmu99AoHkB-Oe0Ig,1707932074,SECHST,5912,5912,-10707,-10707,980,0,80,1121660,False,XA20-79HP-8MC5-25X3
TtYjdlR4M8ol5z_lyQ,1707931977,PLANB,5814,5814,-102860,-102860,980,0,0,1132367,False
23NS4KCbvkiSFnxFqw,1707931171,–ó–æ–æ–º–∞–≥–∞–∑–∏–Ω,5995,5995,-22000,-22000,980,0,165,1235227,False,MM1T-KHT8-1A45-CB7T
gqr_oj9KSNlXWDkqCA,1707930876,–ê–ø—Ç–µ–∫–∞ –ê–ù–¶,5912,5912,-60400,-60400,980,0,3020,1257227,False,8ATM-M2TK-2E2M-XB1T
q_m5uqMv1jalNprnqQ,1707928658,Novapay,8999,8999,-5000,-5000,980,0,0,1317627,False,88B9-H7PK-34CA-K3AK
PQrsHaaiMgNTBs5mdw,1707927013,LIQPAY*Bark  Tail zoo,5995,5995,-18000,-18000,980,0,135,1322627,False,3300-1TP7-KAC2-213X
jOpWu-LzQ11JT-Bmzw,1707924644,LIQPAY*Bark  Tail zoo,5995,5995,-31500,-31500,980,0,236,1340627,False,9TAT-4B3B-8B0C-H6C1
SdHOe3Xpo7Lw2JmpKw,1707924240,–í–µ—Ç–µ—Ä–∏–Ω–∞—Ä–Ω–∞ –∞–ø—Ç–µ–∫–∞,742,742,-189500,-189500,980,0,1421,1372127,False,1A47-38M0-BBX1-PT7A
5lzwAJuB7IeB8sG47A,1707906274,Pethouse,5995,5995,-306100,-306100,980,0,2295,1561627,False,3HHA-M3P0-559C-1EEA
PUmb8z4iSP4FL3oEnw,1707902370,FDY*Merchandise,5399,5399,-29450,-29450,980,0,0,1867727,False,TE3E-H00P-6448-B9P0
ACsH8x07Lz2AECNAxQ,1707897856,MasterZoo,5995,5995,-64079,-64079,980,0,3203,1897177,False,K0T1-XM8T-K337-8C23
731J4A3BcLsSH8dNvA,1707897817,Bestwaytocup,5814,5814,-39100,-39100,980,0,0,1961256,False,HEC2-X39C-M1HP-2B3A
2o1ekcRCb_icvXT-mw,1707860367,–ü–æ–ø–æ–≤–Ω–µ–Ω–Ω—è ¬´–ù–∞ –∫–∞–º–ø—É—Ç—î—Ä –¥–ª—è –≥—Ç–∞6¬ª,4829,4829,-6300,-6300,980,0,0,2000356,True
Uo3ZEgw29BiZHLhvOA,1707860344,–ü–æ–ø–æ–≤–Ω–µ–Ω–Ω—è ¬´–ù–∞ –¥—Ä—ñ–º –≤–∞–Ω–Ω—É¬ª,4829,4829,-10000,-10000,980,0,0,2006656,True,XCC4-P7TM-05EA-C7AK
NXpMj3S050Aq0WGJIA,1707850896,–°—ñ–ª—å–ø–æ,5411,5411,-8200,-8200,980,0,0,2016656,False,9X28-TMKT-APX1-91PP
VGxits-Xd8QGtCm8PQ,1707846935,–ê–ø—Ç–µ–∫–∞ –ê–ù–¶,5912,5912,-29450,-29450,980,0,1472,2024856,False,E2BP-KMC7-KC7X-P4HP
7COoAg26yDTF6rw6KA,1707842099,MEDICHNIY ZAKLAD HAB VET,742,742,-40000,-40000,980,0,4000,2054306,False,0A05-508M-880A-C143
0s3RDyzvk_0AGc1YFQ,1707832243,Restoran Restoran Hanh,5814,5814,-24500,-24500,980,0,0,2094306,False,5B0X-4CE3-XX31-8M9M
S5yy5fkH1ujroyuxKw,1707825233,Yaroslaviv Val 37-1,5921,5921,-10300,-10300,980,0,0,2118806,False,44HE-919X-BE89-38ET
gzdfb3urEqbLB55q6w,1707821346,"Lifecell
+380631692598",4814,4814,-26000,-26000,980,0,0,2129106,True,CE2A-C4KK-6XB9-HAB1
ucEk2xlltHA4sfAueg,1707816922,–ü–µ—Ä–µ–∫–∞–∑ –Ω–∞ –∫–∞—Ä—Ç–∫—É,4829,4829,-500000,-500000,980,0,0,2155106,True
mQygukibN0UQO2LRbA,1707816093,–íi–¥: –ü–†–ò–•–û–î–¨–ö–û –ï.–í. –§–û–ü,"–î–ª—è –ø–æ–ø–æ–≤–Ω–µ–Ω–Ω—è –∫–∞—Ä—Ç–∫–∏ 5375414101190360, –ü—Ä–∏—Ö–æ–¥—å–∫–æ –ï—Ä–Ω–µ—Å—Ç –íi–∫—Ç–æ—Ä–æ–≤–∏—á, 3487403339",4829,4829,2600000,2600000,980,0,0,2655106,True
HUxTPpNknUBwZeQDpA,1707809755,–ê–ø—Ç–µ–∫–∞ ¬´–ë–∞–∂–∞—î–º–æ –∑–¥–æ—Ä–æ–≤'—è¬ª,5912,5399,-28670,-28670,980,0,215,55106,False,47A7-X70X-7TTC-PMEM
SNMMB1WkkD15UGAzUw,1707809670,–ö–æ–ª–æ,5411,5499,-28850,-28850,980,0,0,83776,False,4KHE-3T4H-9CCX-176M
RSMJm_ICfrLJTO9ZQw,1707762306,La Fabrique,5814,5814,-2250,-2250,980,0,0,112626,False,5PC6-28T4-HCMH-HH85
_F5eAMtBolN_8c6hAg,1707761940,magazin 762597,5912,5912,-15528,-15528,980,0,116,114876,False,CK24-CXAB-18BE-B268
7OBnzaELT0bWu1xcwQ,1707761128,–í–µ—Ç–µ—Ä–∏–Ω–∞—Ä–Ω–∞ –∞–ø—Ç–µ–∫–∞,742,742,-180000,-180000,980,0,1350,130404,False,7B6T-P216-1P61-32CP
9zVmvXpAShbQ5CwziA,1707675725,BGRN,5812,5812,-336600,-336600,980,0,0,310404,True,971C-7882-M7B5-C9XE
1rrcYrCBEl05LcXMpg,1707675639,–ó –±—ñ–ª–æ—ó –∫–∞—Ä—Ç–∫–∏,4829,4829,400000,400000,980,0,0,647004,True
T4N7BONx7uptJj0Z3Q,1707668005,EVA,5977,5977,-1999,-1999,980,0,14,247004,False,0T91-T556-71MP-M7HA
vv-MC0hvKkUXTzqoFQ,1707663675,ULTRAMARKET,5411,5411,-59680,-59680,980,0,0,249003,False,H669-TBM5-52AK-XB17
1WcLOYmymEyxjXgGBA,1707657147,Novus,5411,5411,-6498,-6498,980,0,0,308683,False,MKHK-P68E-PHT9-104M
JXa5E00vvpyves6YAA,1707657032,Novus,5411,5411,-17598,-17598,980,0,0,315181,False,41A8-XT0A-CPM4-3AX7
-S9XHcGV_OHt_EWvQA,1707656381,–ê–ø—Ç–µ–∫–∞ –ê–ù–¶,5912,5912,-13100,-13100,980,0,655,332779,False,2148-7C34-823T-8A4C
h1fAOLvOerHR9LGVdg,1707654310,MasterZoo,5995,5995,-31635,-31635,980,0,1581,345879,False,8MHX-T2MM-8E99-7976
tP1h93Rr7d3nRl1_8g,1707654105,EVA,5977,5977,-4016,-4016,980,0,30,377514,False,2CH3-6BXA-6914-3E79
HlPb2Ai536m6BFQuqQ,1707653872,EVA,5977,5977,-3449,-3449,980,0,25,381530,False,28X2-E096-6643-BB2X
vg_mK3Utw43bREfFfQ,1707653661,Novus,5411,5411,-49200,-49200,980,0,0,384979,False,56PE-PPBC-9A85-722B
ytRZuAOHdfkP7N2mZw,1707641831,–ö–æ–ª–æ,5411,5499,-2100,-2100,980,0,0,434179,False,K395-BA1A-3ECP-7KAC
_U8-6IulqaFlpVdYIA,1707640217,–°—ñ–ª—å–ø–æ,5411,5411,-65700,-65700,980,0,0,436279,False,T7BX-1PHE-XCX9-HE19
9z8mV7mmR5CArxDqDQ,1707593736,Bolt,4121,4121,-21300,-21300,980,0,0,501979,False,E1PK-516A-C8CC-858K
KzuMhtRlGSRWDb3cVw,1707504089,Yaroslaviv Val 37-1,5921,5921,-6300,-6300,980,0,0,523279,False,3794-2ME5-959C-6P69
mfnto1m7CiEEsD-MDA,1707503327,Kafekonditerska,5814,5814,-6750,-6750,980,0,0,529579,False,TA3H-9A6P-CT58-CXA6
xJ7wdvd2Q3JPw1Xl4w,1707502829,Kievskaya106,5912,5912,-65270,-65270,980,0,489,536329,False,CB2H-7814-M67K-M5XT
QExzyD99zlXsXh4MBQ,1707501201,Seizo,7230,7230,-45000,-45000,980,0,337,601599,False,A897-H75X-9X9A-47MH
kDDpEdoxreAXc1fH4Q,1707487866,APTEKA 13,5912,5912,-12395,-12395,980,0,92,646599,False,HEHB-APBC-9XHX-517B
mXoGJVlgQDiyIoG8ng,1707487791,APTEKA 13,5912,5912,-56095,-56095,980,0,420,658994,False,3X60-CKP1-33C0-EM70
qG91qqZgOGbpOfCLGQ,1707487161,–ê–ø—Ç–µ–∫–∞ ‚Ññ7,5912,5912,-27680,-27680,980,0,207,715089,False,KTXT-3MM1-2B45-BT87
YTqum9CNyb6s2Z_8Rw,1707486446,OK Wine,5411,5411,-29940,-29940,980,0,0,742769,False,151X-BPT9-CK63-KMHE
1JAi-hT_C2chJtvpRw,1707472745,–ó –±—ñ–ª–æ—ó –∫–∞—Ä—Ç–∫–∏,4829,4829,500000,500000,980,0,0,772709,True
9R9k8enpt7qnXVh-Mw,1707462576,Bestwaytocup,5814,5814,-15000,-15000,980,0,0,272709,False,5X08-P2K5-844M-1H7M
mwYsH-5ozxkHmzpBew,1707412606,FOPMuzichukBogdanGennadiy,742,742,-420000,-420000,980,0,3150,287709,False,BBKK-KA2M-1T8P-CEEM
2edunpJQnZQXnfSGsA,1707401045,–ö–∏—ó–≤–ø–∞—Å—Ç—Ä–∞–Ω—Å,4111,4111,-800,-800,980,0,0,707709,False,667P-C1TC-8XT9-T2E4
B7Adm-pw06oR4QO1XQ,1707378799,–°—ñ–ª—å–ø–æ,5411,5411,-63284,-63284,980,0,0,708509,False,P74T-MK3E-3HT4-CX6T
xhagd87__V0DRkW0Ow,1707377193,–°—ñ–ª—å–ø–æ,5411,5411,-84700,-84700,980,0,0,771793,False,X076-6151-9BAB-P8B6
vSZ0At6drc1OdVh2Ag,1707376517,magazin 726008,5912,5912,-12104,-12104,980,0,90,856493,False,X0K7-AKC2-39AT-7K6K
7My837qISzvTLum9Rw,1707308254,Ukrkhalial,5499,5499,-43348,-43348,980,0,0,868597,False,BHXK-05E5-C2KX-876E
nWPFE1D4RtN_A70htg,1707307919,–°—ñ–ª—å–ø–æ,5411,5411,-42744,-42744,980,0,0,911945,False,02PM-3K4A-6BBC-ETM5
CGaXYjUCp9IKDSI1sA,1707302763,EasyPay,5411,5411,-260150,-260150,980,0,0,954689,False,BK61-86BH-3X20-7997
vKzBxnnGmGNKh_GCqg,1707300933,–¢–∞–±–∞–∫–µ—Ä–∫–∞,5993,5993,-163800,-163800,980,0,0,1214839,False,20KP-TM3A-4810-45XT
UdAt3C4DW95qMReUWQ,1707300851,Novus,5411,5411,-28092,-28092,980,0,0,1378639,False,CP69-T5T1-456T-9KCA
pkH5DocPNRkh0E4Vbw,1707292912,–£–∫—Ä–∑–∞–ª—ñ–∑–Ω–∏—Ü—è,4112,4112,-87434,-87434,980,0,0,1406731,False
zFxGC69XTBWtGL6iJw,1707292211,Pethouse,5995,5995,-306100,-306100,980,0,2295,1494165,False,CM95-540H-EA17-X818
ZfJ-tst2XY-o6TvpGQ,1707292092,FDY*Merchandise,5399,5399,-63350,-63350,980,0,0,1800265,False,CA9C-M50B-7K9P-KHT1
59P_P2pFiLiUrEWsdw,1707247273,"Apteka""TOVANRIGRUP""",5912,5912,-17000,-17000,980,0,127,1863615,False,043H-ACAH-E3HH-4B9A
DUnlA5UvWs_8KFq1tA,1707246785,–ó–æ–æ–º–∞–≥–∞–∑–∏–Ω,5995,5995,-77400,-77400,980,0,580,1880615,False,A3XT-59AB-T12E-96C1
nKdps2uEjj605EtfVQ,1707220406,Novapay,8999,8999,-7000,-7000,980,0,0,1958015,False,KM2M-PEXB-0CC5-26EM
ekyi3sboPn6bXEuPIQ,1707210849,–ö–∏—ó–≤ –¶–∏—Ñ—Ä–æ–≤–∏–π,4111,4111,-3500,-3500,980,0,0,1965015,False,KBB1-MMM0-X4B5-CBA9
37dAcu-LDBsTrqnvNg,1707204259,Produkti,5499,5499,-8900,-8900,980,0,0,1968515,False,3CA7-E00C-KCAC-04BM
JbGl3MdMGOriX999QA,1707157110,–°—ñ–ª—å–ø–æ,5411,5411,-106500,-106500,980,0,0,1977415,False,6XPE-1C80-851C-B07P
UBjhbeA520YbrQaVfQ,1707145836,–ê–ø—Ç–µ–∫–∞ –ê–ù–¶,5912,5912,-202810,-202810,980,0,10140,2083915,False,B92M-CHP3-H93P-32CA
nzDDGu0RXOjzuLGHFg,1707145758,KvitkoviymagazinFlower,5992,5992,-45000,-45000,980,0,0,2286725,False,C3TK-8X70-8T7X-2KPC
U-h4UXBA7A1sIkUK-g,1707145412,Novus,5411,5411,-10400,-10400,980,0,0,2331725,False,8742-E6K3-07PK-KK49
2osbVqar-_tcGP9fgw,1707141400,Yaroslaviv Val 37-1,5921,5921,-56300,-56300,980,0,0,2342125,False,BC5A-X74B-XTB2-71PK
MAVfm5O7icAQAHk9eg,1707071386,–°—ñ–ª—å–ø–æ,5411,5411,-74700,-74700,980,0,0,2398425,False,0X7A-C9E6-M93H-9CXX
Icinj9Z4DgHX87lc2w,1706969294,La Fabrique,5814,5814,-8500,-8500,980,0,0,2473125,False,A9C9-T19B-05E0-KHP9
Utg3Qr4fEDaMerZTpg,1706969014,Novus,5411,5411,-81113,-81113,980,0,0,2481625,False,68T5-TT9C-07HT-CT25
nN330XmYnSQ1jnem8g,1706877405,Novapay,8999,8999,-5600,-5600,980,0,0,2562738,False,065B-XBP6-03C8-MP9K
xzR62U1ugtKwOZPt4w,1706868135,–ü–µ—Ä–µ–∫–∞–∑ –Ω–∞ –∫–∞—Ä—Ç–∫—É,4829,4829,-3000000,-3000000,980,0,0,2568338,True
GBmr37eR7J-YbsbinA,1706867023,–íi–¥: –ü–†–ò–•–û–î–¨–ö–û –ï.–í. –§–û–ü,"–î–ª—è –ø–æ–ø–æ–≤–Ω–µ–Ω–Ω—è –∫–∞—Ä—Ç–∫–∏ 5375414101190360, –ü—Ä–∏—Ö–æ–¥—å–∫–æ –ï—Ä–Ω–µ—Å—Ç –íi–∫—Ç–æ—Ä–æ–≤–∏—á, 3487403339",4829,4829,5500000,5500000,980,0,0,5568338,True
BdnkxzJkI1K3wze-eQ,1706788569,ANC_PLUS_30,5912,5912,-40330,-40330,980,0,0,68338,False,AT73-HKX0-5KE8-A8TT
GKCQiBXRmgsPluH8qQ,1706788266,–ó –±—ñ–ª–æ—ó –∫–∞—Ä—Ç–∫–∏,4829,4829,100000,100000,980,0,0,108668,True
UkIqxP20hNEV7j716Q,1706787901,ZOO–ª—é–∫—Å,5995,5995,-86400,-86400,980,0,0,8668,False,CMEH-80X2-PTC7-8M07
o7qga-z_yzojGa91Fg,1706772796,–¢–∞–±–∞–∫–µ—Ä–∫–∞,5993,5993,-81900,-81900,980,0,0,95068,False,98E6-3T1M-1763-2CCH
5XHYOhU20cl0wqbqgQ,1706772666,Novus,5411,5411,-7099,-7099,980,0,0,176968,False,6HHA-E4B2-8BHP-KHT8
U5CkhvelheYQyff7nw,1706772339,–ó –±—ñ–ª–æ—ó –∫–∞—Ä—Ç–∫–∏,4829,4829,150000,150000,980,0,0,184067,True
ddyjaTqiwCVfHzxtuQ,1709023942,–ì–∞–Ω–Ω–∞ –ü.,4829,4829,-157200,-157200,980,0,0,275226,True,8BH6-6B5M-3X7X-49PB
eWk6ipggbPP8vVg_WA,1708934714,Lesya,4829,4829,-200000,-200000,980,0,0,432426,True,TMCK-T60C-7K6K-6MMT
cARTJVwENyTzdU2I6g,1708877336,–ü–µ—Ä–µ–∫–∞–∑ –Ω–∞ –∫–∞—Ä—Ç–∫—É,4829,4829,-400000,-400000,980,0,0,632426,True
82Od05yCUTo5n-yqcQ,1708865400,–ü–æ–ø–æ–≤–Ω–µ–Ω–Ω—è ¬´–ù–∞ –∫–∞–º–ø—É—Ç—î—Ä –¥–ª—è –≥—Ç–∞6¬ª,4829,4829,-2800,-2800,980,0,0,1032426,True
kb6XdTxx6AyA4UY7kg,1708865375,Lesya,4829,4829,-100000,-100000,980,0,0,1035226,True,1P92-1BH6-PX9B-1P3P
5U8k7qRu3Qlw3LPwjg,1708831607,–†–µ–≥—É–ª—è—Ä–Ω–µ –ø–æ–ø–æ–≤–Ω–µ–Ω–Ω—è ¬´–§–æ–Ω–¥ –ü–æ–≤–µ—Ä–Ω–∏—Å—å –∂–∏–≤–∏–º¬ª,4829,4829,-25000,-25000,980,0,0,1135226,True,APH0-3XBP-1KKK-2X51
5MyRh05YpMgm74_Mqg,1708773088,–ü–æ–ø–æ–≤–Ω–µ–Ω–Ω—è ¬´–ù–∞ –ø—Ä–æ—Ç–µ–∑–∏ ü¶øü¶ø¬ª,4829,4829,-50000,-50000,980,0,0,1160226,True,9H1K-9AX3-KE20-TTM8
-y99I91ANu0214qX1g,1708702664,–õ—ñ–ª—ñ—è –ö.,4829,4829,-55000,-55000,980,0,0,1210226,True,128K-5X39-68HE-2EP4
TAfefvfdLPWlupjCiw,1708685043,–ü–æ–ø–æ–≤–Ω–µ–Ω–Ω—è ¬´–ñ—É—Ä–∞–≤–µ–ª—å¬ª,üõ©Ô∏è –ó –î–Ω–µ–º –ù–∞—Ä–æ–¥–∂–µ–Ω–Ω—è!,4829,4829,-500000,-500000,980,0,0,1265226,True,P14M-8430-B90K-B382
Gj3X9L8sD8jOB-SBiQ,1708684987,–ü–æ–ø–æ–≤–Ω–µ–Ω–Ω—è ¬´–ù–∞ –¥—Ä—ñ–º –≤–∞–Ω–Ω—É¬ª,4829,4829,-55500,-55500,980,0,0,1765226,True,PHBC-2A40-80EC-P6BB
19EDOiDV4pS23TPKPg,1708684948,–ü–æ–ø–æ–≤–Ω–µ–Ω–Ω—è ¬´–ù–∞ –∫–∞–º–ø—É—Ç—î—Ä –¥–ª—è –≥—Ç–∞6¬ª,4829,4829,-32400,-32400,980,0,0,1820726,True
AuR0FBgMSFtU3Gp5vA,1708684928,–ü–æ–ø–æ–≤–Ω–µ–Ω–Ω—è ¬´üêÜüêÜüêÜ¬ª,4829,4829,-10000,-10000,980,0,0,1853126,True,HM9K-E4TM-07XA-XP81
egsovvryLsBhuhT18w,1708677109,545708****3488,4829,4829,-20000,-20000,980,0,0,1863126,True,570C-8BTA-3CE5-H7CP
dTk66Q9TQoJsHW6AJQ,1708676885,–Ü–ª–ª—è –ö.,4829,4829,-18000,-18000,980,0,0,1883126,True,H535-2C4E-TK0B-C81H
tHHepeg24rn96Zy5_A,1708676543,–û–ª—å–≥–∞ –î.,4829,4829,-48500,-48500,980,0,0,1901126,True,AX8T-1840-9391-3CP2
RaCJH_ZV-vg96BIwZQ,1708622271,–ñ–∞–Ω–Ω–∞ –ñ.,4829,4829,-250000,-250000,980,0,0,1949626,True,CA7P-M8XC-3PMX-2B7C
oktZ-uAbXFi9gcrxIQ,1708514737,–ó –ø–ª–∞—Ç–∏–Ω–æ–≤–æ—ó –∫–∞—Ä—Ç–∫–∏,4829,4829,2000000,2000000,980,0,0,2199626,True
dznv-mbp_W04rV3AIg,1708231056,–†–µ–≥—É–ª—è—Ä–Ω–µ –ø–æ–ø–æ–≤–Ω–µ–Ω–Ω—è ¬´–§–æ–Ω–¥ –ü–æ–≤–µ—Ä–Ω–∏—Å—å –∂–∏–≤–∏–º¬ª,4829,4829,-25000,-25000,980,0,0,199626,True
NkmTRykyua64SUL4kw,1708002224,–ù–∞—Ç–∞–ª—ñ—è –¢.,4829,4829,-90000,-90000,980,0,0,224626,True,MT89-97CA-T7P5-16B4
LPZwviVrPz9oLNTgzA,1707821177,Lesya,4829,4829,-300000,-300000,980,0,0,314626,True,1300-BK09-9KXX-KB0M
LUNOwTMoCxeukE2QpQ,1707816923,–ó –ø–ª–∞—Ç–∏–Ω–æ–≤–æ—ó –∫–∞—Ä—Ç–∫–∏,4829,4829,500000,500000,980,0,0,614626,True
J6nrPuLwlLjNuX2OUw,1707675639,–ü–µ—Ä–µ–∫–∞–∑ –Ω–∞ –∫–∞—Ä—Ç–∫—É,4829,4829,-400000,-400000,980,0,0,114626,True
28KnNeopsvjNDhDCXw,1707622001,–†–µ–≥—É–ª—è—Ä–Ω–µ –ø–æ–ø–æ–≤–Ω–µ–Ω–Ω—è ¬´–§–æ–Ω–¥ –ü–æ–≤–µ—Ä–Ω–∏—Å—å –∂–∏–≤–∏–º¬ª,4829,4829,-25000,-25000,980,0,0,514626,True
peZEm1XuOgPmtgWmJQ,1707579771,Lesya,4829,4829,-300000,-300000,980,0,0,539626,True,BH32-P48H-HMC2-K148
516ITAZC4sntHROUug,1707498357,–ñ–∞–Ω–Ω–∞ –ñ.,4829,4829,-250000,-250000,980,0,0,839626,True,1M0H-63CC-285A-XTKA
hKNpZunG9w3cjy5uKQ,1707472745,–ü–µ—Ä–µ–∫–∞–∑ –Ω–∞ –∫–∞—Ä—Ç–∫—É,4829,4829,-500000,-500000,980,0,0,1089626,True
5z30A_dj5jFkxKux2w,1707398324,Lesya,4829,4829,-300000,-300000,980,0,0,1589626,True,C2AK-TXM0-38BM-PHE6
4HHUCAXQIJkJh2UGQg,1707291142,–°–æ—Ñ—ñ—è –¢.,4829,4829,-865000,-865000,980,0,0,1889626,True,TP60-2B3P-CM7E-BBC7
PJFKWzQIyTDf99biyg,1707206906,–ü–æ–ø–æ–≤–Ω–µ–Ω–Ω—è ¬´–ù–∞ –¥—Ä—ñ–º –≤–∞–Ω–Ω—É¬ª,4829,4829,-50000,-50000,980,0,0,2754626,True,P26C-60PB-22CT-4E41
_vuyjtGqqDtlQtvEdg,1707206801,–ü–æ–ø–æ–≤–Ω–µ–Ω–Ω—è ¬´–ù–∞ –∫–∞–º–ø—É—Ç—î—Ä –¥–ª—è –≥—Ç–∞6¬ª,4829,4829,-7300,-7300,980,0,0,2804626,True
1RMjWTQD7kbacpUrlQ,1707017214,–†–µ–≥—É–ª—è—Ä–Ω–µ –ø–æ–ø–æ–≤–Ω–µ–Ω–Ω—è ¬´–§–æ–Ω–¥ –ü–æ–≤–µ—Ä–Ω–∏—Å—å –∂–∏–≤–∏–º¬ª,4829,4829,-25000,-25000,980,0,0,2811926,True
Bs0wUOETX-rMyUoBkg,1706910237,–ù–∞—Ç–∞–ª—è –ú.,"–°—ñ—Ä–∫–æ, —Ç—Ä–∏–º–∞–π—Å—è üò∫",4829,4829,-80000,-80000,980,0,0,2836926,True,C78T-5641-BBEB-MXK3
4TXKlZVsJrVT60OYwA,1706888492,–ü–æ–ø–æ–≤–Ω–µ–Ω–Ω—è ¬´–ù–∞ 10 FPV –¥—Ä–æ–Ω—ñ–≤¬ª,4829,4829,-100000,-100000,980,0,0,2916926,True,292X-36TE-HPB4-TC13
xDddUbC7hkPTBbXxtg,1706868136,–ó –ø–ª–∞—Ç–∏–Ω–æ–≤–æ—ó –∫–∞—Ä—Ç–∫–∏,4829,4829,3000000,3000000,980,0,0,3016926,True
4wsm8ZX31eZ5hDW9VQ,1706824944,–ü–æ–ø–æ–≤–Ω–µ–Ω–Ω—è ¬´–ó–ë–Ü–† –ù–ê 50 –§–ü–í¬ª,4829,4829,-10000,-10000,980,0,0,16926,True,36E1-HB8C-P4E5-39TP
2iI0Mkw5FjFf5SU5yw,1706788266,–ü–µ—Ä–µ–∫–∞–∑ –Ω–∞ –∫–∞—Ä—Ç–∫—É,4829,4829,-100000,-100000,980,0,0,26926,True
MdI-o92rhuKpvD4scA,1706772338,–ü–µ—Ä–µ–∫–∞–∑ –Ω–∞ –∫–∞—Ä—Ç–∫—É,4829,4829,-150000,-150000,980,0,0,126926,True
_EUc9c4EOr3XsUVK9Q,1711810599,–ö–æ–ª–æ,5411,5499,-22800,-22800,980,0,0,75974,False,X3B0-0TT7-MK14-08AK
aP_XaTHs1rROKqn68Q,1711803350,Bestwaytocup,5814,5814,-9000,-9000,980,0,0,98774,False,8T29-12K6-K5ET-K2TK
60OA088cQhaCgmg7bA,1711799746,PHotosalonMAN,7221,7221,-6000,-6000,980,0,0,107774,False,BA72-0126-TK41-9P64
z56I1Gtx6nJteuGygw,1711799033,Novus,5411,5411,-8398,-8398,980,0,0,113774,False,B8KC-AEPA-TEH9-5223
p0dZvSS5rshNCSbkwQ,1711797293,Fotovramci,5946,5946,-100000,-100000,980,0,0,122172,False,4M94-X553-E2M0-K8T8
NDgqRgR_6LMn_LU0Aw,1711796389,Zoosad,5995,5995,-29500,-29500,980,0,0,222172,False,B6EA-KM0M-K6T5-ATHP
07kfYFB81JB3pBtvpA,1711786971,No Name Espresso Bar,5812,5812,-12000,-12000,980,0,0,251672,False,BPTT-3BA4-AB50-TXKA
W5wkwwIKLqsAp6Op5Q,1711786219,CEH,7216,7216,-51900,-51900,980,0,0,263672,False,953A-APH1-7XM0-1P9H
ignhfXI03CjknV5U3w,1711750136,–í—ñ–¥: –í–ª–∞–¥–∏—Å–ª–∞–≤ –ß–æ—Ä–Ω–∏–π,split,4829,4829,33400,33400,980,0,0,315572,False
yZwRQNfI1PN4sLDw1g,1711730355,Konteiner,5814,5814,-61200,-61200,980,0,119,282172,False,EHT6-KK6B-613T-P102
q2KB44lyoP9HtQhffQ,1711730054,OK Wine,5411,5411,-19900,-19900,980,0,0,343372,False,02M1-C2P4-HM0P-XHHC
QSX9slngoOETdJZabg,1711729743,–ê–ø—Ç–µ–∫–∞ ¬´–ë–∞–∂–∞—î–º–æ –∑–¥–æ—Ä–æ–≤'—è¬ª,5912,5399,-113394,-113394,980,0,0,363272,False,9HKB-TAE9-P3AC-6H6P
GzHrNCylE3a6W-3FIA,1711720806,–ö–£–ó–Ø,4900,4900,-35000,-35000,980,0,0,476666,False,B893-XH5M-803E-4BX9
PuVtO5-4jPc4uSpFjg,1711710626,–°—ñ–º–µ–π–Ω–∞ –ü–µ–∫–∞—Ä–Ω—è,5814,5814,-26900,-26900,980,0,201,511666,False,739M-4022-TM48-27KX
OuZ_PGmZ5lJRh01VJA,1711705371,OKKO,5541,5541,-244062,-244062,980,0,0,538566,False,EC40-HEH9-A89E-P5TM
j2bjjRl9MooA9Im_nQ,1711705348,OKKO,5541,5541,-4000,-4000,980,0,0,782628,False,8M0X-E866-H3XC-4X38
-cT01qu5qYwHy8rsJg,1711697877,Bestwaytocup,5814,5814,-59600,-59600,980,0,447,786628,False,6707-BH77-01PE-1C0X
pgX8ECvElZybRXhyng,1711697673,–¢–∞–±–∞–∫–µ—Ä–∫–∞,5993,5993,-36000,-36000,980,0,0,846228,False,EHP0-8PB0-TB9K-0ACK
LUU1fkuX-aCbK95O-A,1711638986,–ü–∏—Ä—ñ–∂–∫–æ–≤–∞ ¬´–¢—ñ—Ç–∫–∞ –ö–ª–∞—Ä–∞¬ª,5814,5814,-26600,-26600,980,0,199,882228,False,8HBH-ATCC-TKA3-MC1A
05yjuYqaOv9RT3VfBg,1711638769,Bolt,4121,4121,-12821,-12821,980,0,0,908828,False,KXHC-329X-X9KP-4KM6
fS339maNcjzTUHOrrw,1711638766,–°–∫–∞—Å—É–≤–∞–Ω–Ω—è. Bolt Food,4215,4215,5000,5000,980,0,0,921649,False
Bn5iBrwTCBBiOggngw,1711638608,Produkti,5499,5499,-3700,-3700,980,0,0,916649,False,3B42-CE61-H9A5-4K21
RJCPh4_R3uT91MyNYw,1711638259,–ê–ø—Ç–µ–∫–∞ –ê–ù–¶,5912,5912,-38100,-38100,980,0,0,920349,False,B53M-EEAM-T091-0ME4
_bGoGHCtFEyx1RpsvA,1711638097,Novapay,8999,8999,-8200,-8200,980,0,0,958449,False,1P28-4KB9-E23M-05HK
nhQJtDQickUl_2L6ng,1711637846,–ê–ø—Ç–µ–∫–∞ 911,5912,5912,-15640,-15640,980,0,0,966649,False,0T54-3TXX-BM3H-282A
XWFALot99r8HpGblig,1711637566,APTEKA1,5912,5912,-15670,-15670,980,0,0,982289,False,3BP2-XKE4-6K62-228T
In79PeKvibVHIiZ_vA,1711637347,Kievskaya106,5912,5912,-30420,-30420,980,0,0,997959,False,BPC6-12C1-7BC3-4BTT
gnOczgOv78FLMYN7NA,1711636875,Bolt Food,4215,4215,-5000,-5000,980,0,0,1028379,False
jOn1lCYAPOgpKKkS9Q,1711632394,ZOOLYUKS,5995,5995,-826410,-826410,980,0,0,1033379,False,7A0B-17TA-9HC8-2HH1
P8q45JcDv3YQbf0h-g,1711612531,–°—ñ–ª—å–ø–æ,5411,5411,-9500,-9500,980,0,0,1859789,False,7CMT-2614-27CP-C38B
2mEoGlzt8g9UfwGDig,1711612444,–°—ñ–ª—å–ø–æ,5411,5411,-39375,-39375,980,0,0,1869289,False,3C44-1T14-BK1K-30HE
26FF2hfjxLJz4qdLYQ,1711546360,Novus,5411,5411,-19695,-19695,980,0,0,1908664,False,BA61-H4B7-BCC8-K5H6
TapXRXW_o3Nj2sJGXQ,1711546200,Novus,5411,5411,-28795,-28795,980,0,0,1928359,False,0TB5-3X52-KCXT-A005
axCuGSxW7kHps1xrRA,1711538956,REBORN,5399,5399,-115000,-115000,980,0,0,1957154,False,AX5X-E7ET-X68A-CXAX
RhhrjS6wkF82ouB21Q,1711533214,–¢–û–í –ú–µ–¥–∏—Ü–∏–Ω—Å–∫–∏–π –º–∞–≥–∞–∑–∏–Ω,5912,5976,-191300,-191300,980,0,0,2072154,False,23EH-5AT3-E9MM-67TM
a26yVdAlEDI3q8W18g,1711530022,–ê–ø—Ç–µ–∫–∞ –ê–ù–¶,5912,5912,-3470,-3470,980,0,0,2263454,False,EP63-3CP6-3KA7-P6A5
KKeamSRT89ttnRtzWA,1711528703,–ú—ñ—Å—å–∫–∞ –á–¥–∞–ª—å–Ω—è,5814,5814,-20500,-20500,980,0,410,2266924,False,P9P8-MCM1-KK4T-H518
L8T0kh78JOpRAIxTcg,1711519945,–ê–ø—Ç–µ–∫–∞ ¬´–ë–∞–∂–∞—î–º–æ –∑–¥–æ—Ä–æ–≤'—è¬ª,5912,5399,-2790,-2790,980,0,0,2287424,False,73XH-H6X0-274M-PCP1
NiYUpw0XBWyz7JS6kg,1711519886,–ê–ø—Ç–µ–∫–∞ ¬´–ë–∞–∂–∞—î–º–æ –∑–¥–æ—Ä–æ–≤'—è¬ª,5912,5399,-4756,-4756,980,0,0,2290214,False,2CPC-2C9H-T1PX-A3PH
97OGoFTM46H3zrweQw,1711519571,–ê–ø—Ç–µ–∫–∞ ‚Ññ7,5912,5912,-8300,-8300,980,0,0,2294970,False,MEPA-B387-X7EK-2HA5
W0p6hAV2MH_OlIt5UQ,1711479210,–ö–æ–ª–æ,5411,5499,-24400,-24400,980,0,0,2303270,False,P35T-29MC-65A7-8798
OXZYQpFHEnoM4MMJTg,1711479090,–ê–ø—Ç–µ–∫–∞ ¬´–ë–∞–∂–∞—î–º–æ –∑–¥–æ—Ä–æ–≤'—è¬ª,5912,5399,-46166,-46166,980,0,0,2327670,False,3MM2-8B85-1818-9HA9
DEgKiVstdTkTj91pRQ,1711477582,–ó–æ–æ–º–∞–≥–∞–∑–∏–Ω,742,742,-105130,-105130,980,0,0,2373836,False,EC3T-TP0P-XHP7-KHK1
_3RpetyZRBmizDlWJA,1711476330,–ó–æ–æ–º–∞–≥–∞–∑–∏–Ω,742,742,-521410,-521410,980,0,0,2478966,False,TB8C-1T0B-1150-P7EK
vd3pagxnSv6RE0LTbA,1711472020,–ù–æ–≤–∞ –ø–æ—à—Ç–∞,7399,7399,-10500,-10500,980,0,0,3000376,False,0C78-PBPH-1M08-E03B
yoh7JiwNXLkM2HcS1w,1711470862,FDY*Merchandise,5399,5399,-87480,-87480,980,0,0,3010876,False,8BXP-62TK-EC75-1624
PAlzzbllWhX3caUSMQ,1711469204,Novapay,8999,8999,-10800,-10800,980,0,0,3098356,False,2K20-KHB9-7CCB-6T0H
hgrEMvwcXNxUDuJ4pA,1711462009,Bestwaytocup,5814,5814,-14000,-14000,980,0,280,3109156,False,EP35-81XM-E07A-0E9M
PFQgkqOsraLVEJHHOw,1711389456,Novus,5411,5411,-22897,-22897,980,0,0,3123156,False,5M0A-X8M5-8075-6MT2
X9l66qZ7vPBe6GTLOg,1711384982,ZOOLYUKS,5995,5995,-19800,-19800,980,0,0,3146053,False,E63K-XCH0-8439-42H7
kMFEBJZfZ23wdhJLrg,1711384911,ZOOLYUKS,5995,5995,-600000,-600000,980,0,0,3165853,False,MTA8-56KX-A37H-C6M8
4PLnUiF_roni8M2lYw,1711362794,–íi–¥: –ü–†–ò–•–û–î–¨–ö–û –ï.–í. –§–û–ü,"–î–ª—è –ø–æ–ø–æ–≤–Ω–µ–Ω–Ω—è –∫–∞—Ä—Ç–∫–∏ 5375414101190360, –ü—Ä–∏—Ö–æ–¥—å–∫–æ –ï—Ä–Ω–µ—Å—Ç –íi–∫—Ç–æ—Ä–æ–≤–∏—á, 3487403339",4829,4829,3600000,3600000,980,0,0,3765853,False
sjLfmT33f9t_jKP8cg,1711352242,Novus,5411,5411,-31413,-31413,980,0,0,165853,False,PK90-3727-E93C-AK36
u_Avr2Mq2lXv9tITvg,1711302847,Promn,5651,5651,-52000,-52000,980,0,0,197266,False,2XAT-C6M5-T1E1-B2ME
s7vZyRAfoUMjyCmGaA,1711283049,LOKO,5411,5411,-34100,-34100,980,0,0,249266,False,C6C3-3X4X-6ET8-7K6E
fwJ7Z0OjkAIkBLmqBQ,1711282241,Bestwaytocup,5814,5814,-37500,-37500,980,0,281,283366,False,PK4M-BHB8-6989-6159
eBFDmi9bSYoQAqnSLw,1711278996,Novapay,8999,8999,-10000,-10000,980,0,0,320866,False,1T13-7C10-7PH9-H518
Rl1F1RI_CwCNzsUFvQ,1711278972,Novapay,8999,8999,-11300,-11300,980,0,0,330866,False,E77X-M32A-C4AM-HHE2
uevEkKN2Raab-yzsXQ,1711276984,–°—ñ–ª—å–ø–æ,5411,5411,-34198,-34198,980,0,0,342166,False,CX97-EC5K-X31C-12X8
HUuqo2SfCowhPmX5fw,1711275192,–°—ñ–ª—å–ø–æ,5411,5411,-18700,-18700,980,0,0,376364,False,2XXC-H231-B7TP-ETT0
I4qge4ttVc9J9Bjm7Q,1711275036,–°—ñ–ª—å–ø–æ,5411,5411,-1500,-1500,980,0,0,395064,False,TTPM-6TMT-CTXB-CX8E
tO1z4GOHBMqlzWhnMQ,1711274193,Astra,5812,5812,-90800,-90800,980,0,681,396564,False,9536-27P3-HM5C-KX36
dN1hsQe6ifaz6INJUw,1711214645,OK Wine,5411,5411,-56900,-56900,980,0,0,487364,False,75H5-674A-44K4-HB0X
RC6YhsJCgQ4dCStJ-A,1711212733,ZOOLYUKS,5995,5995,-1145000,-1145000,980,0,0,544264,False,HCB7-04A0-X1A7-X085
2k9au9JHnZ6MrKSUrw,1711206314,–ú—ñ—Å—å–∫–∞ –á–¥–∞–ª—å–Ω—è,5814,5814,-4500,-4500,980,0,33,1689264,False,1P6P-0CXK-562C-1H76
JMxH9Voymm4D0h8ukA,1711206203,–û—Ñ—ñ—Å-—á–∞–π,5812,5812,-17100,-17100,980,0,128,1693764,False,BX9X-0P49-H4EA-PBH8
k_oHyYnmUX-5-64kaA,1711205641,–ü–∏—Ä—ñ–∂–∫–æ–≤–∞ ¬´–¢—ñ—Ç–∫–∞ –ö–ª–∞—Ä–∞¬ª,5814,5814,-16300,-16300,980,0,122,1710864,False,9X42-4T5X-M4BC-MT03
Ur8OQEpMM2Rfoahb2g,1711204943,–£–∫—Ä–ø–æ—à—Ç–∞,9402,9402,-1000,-1000,980,0,0,1727164,False,76CB-PBXT-HMEH-28XB
YP1Hm8opJkQeEpaqUg,1711185237,Apteka K185,5912,5912,-47460,-47460,980,0,0,1728164,False,B710-AMXA-1817-5100
u2v2USLA4EWHsYcdWQ,1711184932,–ó–æ–æ–º–∞–≥–∞–∑–∏–Ω,742,742,-292310,-292310,980,0,0,1775624,False,73B4-C98P-3HBE-6M6B
gbuKw2LHlW16BXq0Mw,1711131446,Konteiner,5814,5814,-43300,-43300,980,0,866,2067934,False,XE08-A1E3-P57T-THBE
4L0BaBYg-UD4sF1YfA,1711130840,–ü–∏—Ä—ñ–∂–∫–æ–≤–∞ ¬´–¢—ñ—Ç–∫–∞ –ö–ª–∞—Ä–∞¬ª,5814,5814,-8600,-8600,980,0,172,2111234,False,3C83-1M63-7799-X735
z9XjxzFx9RFpXAd_bQ,1711124742,ZOOLYUKS,5995,5995,-108000,-108000,980,0,0,2119834,False,4AAT-A109-MC1B-7T6P
HmBSpJH_bSvp9ukDsA,1711123028,CEH,7216,7216,-3000,-3000,980,0,0,2227834,False,P5E9-3HCB-5X15-PT40
FnkrNJh-8UNF1sXwhA,1711104409,–ö–∏—ó–≤–ø–∞—Å—Ç—Ä–∞–Ω—Å,4111,4111,-800,-800,980,0,0,2230834,False,M899-T24P-8C70-TH62
LeZBSt4b8hn17x0XWA,1711103035,–ü–µ—Ä–µ–∫–∞–∑ –Ω–∞ –∫–∞—Ä—Ç–∫—É,4829,4829,-1200000,-1200000,980,0,0,2231634,False
GRmN8GCEsRBdPRuwJQ,1711102412,–ü–æ–ø–æ–≤–Ω–µ–Ω–Ω—è ¬´–ù–∞ –∫—É–ø–æ–ª—å–Ω–∏–π –†–ï–ë¬ª,4829,4829,-300000,-300000,980,0,0,3431634,False,7PEE-96PK-M6E1-851X
JaE9EepusdK-bEhGvQ,1711102335,–íi–¥: –ü–†–ò–•–û–î–¨–ö–û –ï.–í. –§–û–ü,"–î–ª—è –ø–æ–ø–æ–≤–Ω–µ–Ω–Ω—è –∫–∞—Ä—Ç–∫–∏ 5375414101190360, –ü—Ä–∏—Ö–æ–¥—å–∫–æ –ï—Ä–Ω–µ—Å—Ç –íi–∫—Ç–æ—Ä–æ–≤–∏—á, 3487403339",4829,4829,3000000,3000000,980,0,0,3731634,False
4kDFcEHT9s5nz0qKGQ,1711098620,–ê–ø—Ç–µ–∫–∞ ‚Ññ7,5912,5912,-32860,-32860,980,0,0,731634,False,M7A4-BTK1-BKKE-7XB5
ubkMXr4mYEhAqh7Zng,1711098071,TOBAKKO-SERVIS,5499,5499,-36000,-36000,980,0,0,764494,False,1TA7-TK5M-30XK-XE59
jcnEJH0RqIIh7XLIGA,1711046131,FIT_STRETCH HUB,7997,7997,-40000,-40000,980,0,0,800494,False,X4K8-K828-15M2-1EC5
mUYYXoG50E0Ma9YW6w,1711040515,EasyPay,5411,5411,-255086,-255086,980,0,0,840494,False,PP3C-80EE-21BP-A2TX
lowRkzgreQ1PW1K2Iw,1711039641,–°—ñ–ª—å–ø–æ,5411,5411,-75700,-75700,980,0,0,1095580,False,4M1T-TTAA-3P8T-XB4C
0wHUL8xbUeZNGoXfnw,1710959874,Novapay,8999,8999,-27400,-27400,980,0,0,1171280,False,M342-4AK1-8TPA-4EB8
wmKwIy0aArRCYbaylw,1710951544,–ö–∏—ó–≤–ø–∞—Å—Ç—Ä–∞–Ω—Å,4111,4111,-800,-800,980,0,0,1198680,False,P337-XT33-EAEA-3TP1
0MG6mED7gUKvKQ6zWA,1710930550,Bestwaytocup,5814,5814,-20500,-20500,980,0,153,1199480,False,3H98-8CPK-AB4K-MTEM
-vxJePgJQqqakmcm3Q,1710930322,La Fabrique,5814,5814,-17000,-17000,980,0,127,1219980,False,A7A4-AA61-P9T5-71TK
BvkxbOknEVdMxE9yFA,1710930196,magazin 762597,5912,5912,-45446,-45446,980,0,0,1236980,False,95E8-P8HH-C9C7-5EM3
eKH1fLxKOw4WHP784w,1710919557,Pethouse,5995,5995,-385900,-385900,980,0,0,1282426,False,H3PE-51AK-TXXK-88AM
dBZDZcsy_khJjIQ7Xw,1710917633,Bestwaytocup,5814,5814,-17500,-17500,980,0,131,1668326,False,XM6K-0B3P-8KCP-4386
pV9Q0vO719izjr2sgw,1710883946,easyJet,3245,3245,-514582,-12051,978,0,0,1685826,False,4B2H-X5XE-9K58-K753
vB1NC_rnHAejQWrwDA,1710883862,–ü–µ—Ä–µ–∫–∞–∑ –Ω–∞ –∫–∞—Ä—Ç–∫—É,4829,4829,-700000,-700000,980,0,0,2200408,True
ZkFSaUvwXFfaLh5Pzw,1710875813,–°—ñ–ª—å–ø–æ,5411,5411,-49196,-49196,980,0,0,2900408,False,1MPX-8M43-6CC7-EKC8
BsF0gu6SkWIAQJrWrg,1710866653,Beer Market,5921,5921,-15798,-15798,980,0,0,2949604,False,X4AE-KTBA-6KHM-TT75
4y41nkGvRG2XPsshwQ,1710866636,TOBAKKO-SERVIS,5499,5499,-36600,-36600,980,0,0,2965402,False,H3PX-4PB2-AT72-6219
bhiYiCeNcYXC1WVPXA,1710863900,–¢–µ—Ç—è–Ω–∞ –ë.,4829,4829,-22400,-22400,980,0,0,3002002,True,XP4A-86H0-60HT-MAC9
XyYNJcdd4aSvJlvxWQ,1710850616,Novus,5411,5411,-2699,-2699,980,0,0,3024402,False,MEC5-T7M7-0KM1-1PEH
aNMPv8OQg_uFMnwemA,1710846101,Bestwaytocup,5814,5814,-10000,-10000,980,0,200,3027101,False,5858-6BM3-72BC-793C
PF6Ryyrfoi84ygQX6Q,1710837571,FOPKarasOksanaOlegivna,742,742,-250000,-250000,980,0,0,3037101,False,T50T-7E83-T87X-9KP7
QVoy20T--Z6IAGXDzQ,1710830588,Bestwaytocup,5814,5814,-17500,-17500,980,0,350,3287101,False,1XPP-T8HK-K54P-MHT0
Qs3UXTZt0GviBsBk_Q,1710787370,OkvajnSichovih,5921,5921,-20100,-20100,980,0,0,3304601,False,PT2H-95C3-9B2A-208X
SVqODg2lbHjQnO_ytg,1710785539,FDY*Food,5499,5499,-100275,-100275,980,0,0,3324701,False,HX61-0018-6658-MBPP
cawunHFst2aed_AQcA,1710779116,Novapay,8999,8999,-7400,-7400,980,0,0,3424976,False,2ETA-1CKT-T5H2-PH92
7Bar3E_gR7NFulBViQ,1710776759,Novapay,8999,8999,-5300,-5300,980,0,0,3432376,False,405T-M718-44PA-0BT1
csVfMpW8eR9FmA4T3A,1710762042,–°—ñ–ª—å–ø–æ,5411,5411,-16400,-16400,980,0,0,3437676,False,X9H7-3M64-23ME-XTPA
V3fyzJFOAJgI8W8qJA,1710761884,YumzyMalevicha,5995,5995,-28100,-28100,980,0,0,3454076,False,C61M-8MXX-2M0K-E27X
w-KILZYszil345PHvg,1710761641,NovaPay_PNFP10670,7399,7399,-12000,-12000,980,0,0,3482176,False,P925-BMTP-8P3B-A8EK
FUoBUbwpj-u5MkijuA,1710749533,Libd,5814,5814,-8000,-8000,980,0,160,3494176,False,991M-7T0A-PAMT-86A9
R0Cx-fV6eZ6gtQqh3Q,1710681752,MasterZoo,5995,5995,-44000,-44000,980,0,0,3502176,False,AP7E-45M6-010P-2KPM
FPjCuDwElI_62OUZWw,1710677182,BlueCup,5812,5812,-28600,-28600,980,0,572,3546176,True,0257-TKCC-5A5B-297M
J-kh5x2BjRSNSRcM2Q,1710677064,–ù–æ–≤–∞ –ø–æ—à—Ç–∞,7399,7399,-2500,-2500,980,0,0,3574776,False,972K-E11X-MC09-6BT7
tgFC7hah5WN1BAx3DQ,1710676826,–¢–∞–±–∞–∫–µ—Ä–∫–∞,5993,5993,-17600,-17600,980,0,0,3577276,False,31E2-2284-B4AH-AXC0
bV7vVLZ9DCvyP7UeZg,1710676704,Novus,5411,5411,-19494,-19494,980,0,0,3594876,False,C3E7-E99E-0T22-84H5
N_acgf2O42XdjrCD5A,1710676248,Beerplace,5814,5814,-11000,-11000,980,0,220,3614370,False,CP1A-TKA3-MTH2-E659
-yj6fwruxPOXBIoseQ,1710674530,Knygosklad,5942,5942,-79600,-79600,980,0,0,3625370,False,696P-94T6-X7C6-X442
Yv48WqvIW9ZXCKiyjA,1710673928,–ù–æ–≤–∞ –ø–æ—à—Ç–∞,7399,7399,-7000,-7000,980,0,0,3704970,False,26M1-B31E-41HM-6T5T
6q6k0G1ACT3i6446dA,1710592597,Beerplace,5814,5814,-36400,-36400,980,0,728,3711970,False,C2E5-028H-M96T-78T7
IREf9MwgQ9R4uolJHA,1710590328,–ö–∏—ó–≤–ø–∞—Å—Ç—Ä–∞–Ω—Å,4111,4111,-800,-800,980,0,0,3748370,False,45E1-BT44-AA95-3PBH
aDZmK8PugqWF5shyhg,1710590323,–ö–∏—ó–≤–ø–∞—Å—Ç—Ä–∞–Ω—Å,4111,4111,-800,-800,980,0,0,3749170,False,913A-C021-TXPC-KB06
_5KAmq3zxhdUdTztHQ,1710587212,–ö–æ–ª–æ,5411,5499,-25500,-25500,980,0,0,3749970,False,39MK-368M-0755-2XHB
rzPlyyQpWMz2YdLKnw,1710586637,–§–ö –ï–í–û,5399,5399,-58900,-58900,980,0,0,3775470,False,3MC1-P20C-42PP-2PP4
jidyAUNp_7IGUu1j9Q,1710585992,–ê–ø—Ç–µ–∫–∞ –ê–ù–¶,5912,5912,-67120,-67120,980,0,0,3834370,False,2K0E-PH3E-58K4-35E1
RKDTW9to3FxqsXzyGA,1710585936,–ê–ø—Ç–µ–∫–∞ –ê–ù–¶,5912,5912,-107200,-107200,980,0,0,3901490,False,91KB-MH97-10MH-XAH3
beVBvrmyXRlgZbFSnQ,1710574669,Novus,5411,5411,-16197,-16197,980,0,0,4008690,False,1AEM-5BEX-AEH7-1AE1
shm51k6XEn0xsKCF9A,1710528381,WFP.CLOTHIING,5651,5651,-84000,-84000,980,0,0,4024887,False,8TA0-T41C-BEA3-7PB3
f-1HwlqkpqVhBSGrVg,1710526771,–ü–æ–ø–æ–≤–Ω–µ–Ω–Ω—è ¬´–ù–∞ –∫–∞–º–ø—É—Ç—î—Ä –¥–ª—è –≥—Ç–∞6¬ª,4829,4829,-43783,-43783,980,0,0,4108887,True
gqnybeDODRfr2-NXSg,1710526750,–ü–æ–ø–æ–≤–Ω–µ–Ω–Ω—è ¬´–ù–∞ –¥—Ä—ñ–º –≤–∞–Ω–Ω—É¬ª,4829,4829,-500000,-500000,980,0,0,4152670,True,8C05-A5X3-K80E-KX11
GSiV2XkXikLlr9_gYQ,1710517476,Novapay,8999,8999,-7000,-7000,980,0,0,4652670,False,2A6K-ECP6-636A-CBP1
2P9r51MpG_tIc1Z7DQ,1710506388,prom.ua,6538,6538,-8400,-8400,980,0,0,4659670,False,949M-BK6E-8KEP-4BT1
w4LbDVd2hedq8dqZGA,1710503784,–ï–∫–æ-–õ–∞–≤–∫–∞,5411,5499,-25800,-25800,980,0,0,4668070,False,PA5M-2ECA-PE70-BX5X
oZG99PB4RmbzDshXxw,1710502973,MagazinBookua,5942,5942,-29900,-29900,980,0,0,4693870,False,XE4K-M7H0-7PTE-5BE0
FGnhW5GrreQtRWaI0A,1710498652,–íi–¥: –ü–†–ò–•–û–î–¨–ö–û –ï.–í. –§–û–ü,"–î–ª—è –ø–æ–ø–æ–≤–Ω–µ–Ω–Ω—è –∫–∞—Ä—Ç–∫–∏ 5375414101190360, –ü—Ä–∏—Ö–æ–¥—å–∫–æ –ï—Ä–Ω–µ—Å—Ç –íi–∫—Ç–æ—Ä–æ–≤–∏—á, 3487403339",4829,4829,4400000,4400000,980,0,0,4723770,True
Qunq7_iW8qrPMB87OA,1710492200,Bestwaytocup,5814,5814,-14000,-14000,980,0,105,323770,False,CX6K-E9A1-75CX-AM2B
VJTHhpNBp9JTIvXQ3w,1710491439,JArmarka,5499,5499,-8000,-8000,980,0,0,337770,False,BP12-4E5X-KHK2-4X54
Jc9tURfiIXR5h7kjBw,1710440838,FIT_STRETCH HUB,7997,7997,-40000,-40000,980,0,0,345770,True,H2AA-27XB-486E-XT08
rhLmc8ZrL0zieIm-nw,1710419900,–¢–∞–±–∞–∫–µ—Ä–∫–∞,5993,5993,-57900,-57900,980,0,0,385770,False,T6TX-8K1B-P5EC-6PBT
cuZ4HaNBEpCzRhB-KA,1710419597,Novus,5411,5411,-33944,-33944,980,0,0,443670,False,B03A-3C2H-0116-B95T
ABZvBfKovddTNroFzg,1710402534,Bestwaytocup,5814,5814,-39500,-39500,980,0,296,477614,False,76B0-ETBA-1PX6-E2C8
wxLjROhXkNRnVhsN5g,1710398673,Bestwaytocup,5814,5814,-35700,-35700,980,0,267,517114,False,97BC-K50B-M32E-0KK2
sMcZc_EWHx-oPYoFzA,1710367765,Pethouse,5995,5995,-318400,-318400,980,0,0,552814,False,19K5-PM7B-K059-B57K
d-4tKehGkVOOf9mB6Q,1710354677,LIQPAY*Shibuya Yarosla,5812,5812,-48195,-48195,980,0,361,871214,False,A833-HK5T-521K-116C
0QfZvnT2j-EYZZ2c8A,1710352997,Novapay,8999,8999,-5000,-5000,980,0,0,919409,False,482A-8H38-BTCX-05K4
nnnQSQzmkqy73pwBPg,1710352961,Novapay,8999,8999,-7500,-7500,980,0,0,924409,False,7P1K-1HAC-EAKC-2B1K
uiaICkybofQvr3IgJQ,1710351943,magazin 762597,5912,5912,-66920,-66920,980,0,0,931909,False,1M5P-TEAM-4MTK-37E9
reR2cnWk2WPii3u6tA,1710351066,OK Wine,5411,5411,-10000,-10000,980,0,0,998829,False,TH6P-A963-MAMT-KXEH
E-uDENSA_Oh3hKUVtg,1710336663,–ê–ø—Ç–µ–∫–∞ ¬´–ë–∞–∂–∞—î–º–æ –∑–¥–æ—Ä–æ–≤'—è¬ª,5912,5399,-72960,-72960,980,0,0,1008829,False,14P3-X0XT-2K9E-B2TT
Aq5HygOlk0DaSJaVWA,1710336285,–ö–æ–ª–æ,5411,5499,-4400,-4400,980,0,0,1081789,False,KCM0-7KBC-22K3-H996
QGvC0LwsnvIJSiHlOQ,1710335854,Simona,5812,5812,-33400,-33400,980,0,250,1086189,True,8EK5-07H1-45TC-6C0T
yrYo1NacOByLhElsbA,1710331803,EasyPay,5411,5411,-256286,-256286,980,0,0,1119589,False,20X8-7963-59A9-K6PP
_sF-3uul5PtQZhIbqw,1710317981,–°—ñ–ª—å–ø–æ,5411,5411,-97500,-97500,980,0,0,1375875,False,2CP8-T63M-TT31-BTK0
JU4CuKu01Q0SfdWUSw,1710317399,Libd,5814,5814,-15000,-15000,980,0,112,1473375,False,H48X-8X2H-CET2-H8H2
ZVLfPkXRhTramZ4U-w,1710314520,–ö–æ–ª–æ,5411,5499,-9650,-9650,980,0,0,1488375,False,6AH4-05B4-HH8P-X47A
NJyDvaN9e2RYX0RMnQ,1710273356,FDY*Merchandise,5399,5399,-102320,-102320,980,0,0,1498025,False,KT8X-963T-138C-M5CB
oBmTwQT9OiQFcKmDZg,1710266495,–°—ñ–ª—å–ø–æ,5411,5411,-16900,-16900,980,0,0,1600345,False,751A-3CTT-AXA7-ACK0
t0ejGcEpDSpa3UOwCw,1710256203,Bolt Food,4215,4215,-74900,-74900,980,0,0,1617245,False,37B7-1X4M-9HEH-P44T
lCgczNaqpyyvDLFeoA,1710230507,–°—ñ–ª—å–ø–æ,5411,5411,-20800,-20800,980,0,0,1692145,False,AAHE-CM54-CE3K-TH3K
ybHKQyBC5jSjRUfoUA,1710228307,–£–∫—Ä–ø–æ—à—Ç–∞,9402,9402,-400,-400,980,0,0,1712945,False,ET3E-303H-BK63-X2H0
Nu4I2tpemajTQ8WKvw,1710177798,Novapay,8999,8999,-10000,-10000,980,0,0,1713345,False,XK4T-9X22-2B0M-X5K5
lrdwIYHKW36O0Q-HWA,1710174949,30880,5912,5912,-43277,-43277,980,0,0,1723345,False,C1CX-X8C6-6XB6-5T49
TXq2yFui50VsKSS3fg,1710173782,Konteiner,5814,5814,-62800,-62800,980,0,471,1766622,False,6PMB-E1BA-2TTC-TM0B
N5Sgl6oX_eJuhZiQKg,1710173496,PLANB,5814,5814,-96705,-96705,980,0,725,1829422,False,H715-218M-5KA7-A0XP
1gvU4xBZXqMg2B-OVA,1710150509,FOP Trenin MS,5814,5814,-12900,-12900,980,0,96,1926127,False,22B2-07CX-BH02-P4KE
ljb1ZoyaRRrt5O6sbg,1710147130,"Lifecell
+380631692598",4814,4814,-25000,-25000,980,0,0,1939027,True,HMCX-AHTX-7H2H-CCME
ZdSWnbQm6op0aTl5NA,1710087202,–°—ñ–ª—å–ø–æ,5411,5411,-87141,-87141,980,0,0,1964027,False,4B1C-EA06-13BP-K06C
b51MbvNuZJge2zzPWA,1710086995,AVANGARDEN,5812,5812,-93500,-93500,980,0,1870,2051168,True,AX0B-AK57-E90X-7KHE
kk2c8OZzvFnCvOzaGg,1710086582,–°–∫–∞—Å—É–≤–∞–Ω–Ω—è. Bolt,4121,4121,9800,9800,980,0,0,2144668,False
qo_Yajgu-XFGIYtQoA,1710086529,Bolt,4121,4121,-12800,-12800,980,0,0,2134868,False,308M-63E1-86HB-4BKA
r2cSmFt5NhaAQUmRgA,1710086437,–ü–µ—Ä–µ–∫–∞–∑ –Ω–∞ –∫–∞—Ä—Ç–∫—É,4829,4829,-700000,-700000,980,0,0,2147668,True
AalA9Rru74RGj-LH-w,1710085181,Bolt,4121,4121,-9800,-9800,980,0,0,2847668,False
swU6IQUZczrXBW32vQ,1710082744,AVANGARDEN,5812,5812,-500000,-500000,980,0,10000,2857468,True,3CC9-11AM-BH01-1X9C
NriwQ4dhjlkitxHzWQ,1710082418,AVANGARDEN,5812,5812,-504900,-504900,980,0,10098,3357468,True,P121-E849-2C5M-TA9P
_KwqDVELimiZlZn5fA,1710079936,Bolt,4121,4121,-9400,-9400,980,0,0,3862368,False,89TX-3C2E-C4BM-31M1
FRec9WSy07QoKss2_g,1710058856,–í–µ—Ç–µ—Ä–∏–Ω–∞—Ä–Ω–∞ –∞–ø—Ç–µ–∫–∞,742,742,-322500,-322500,980,0,0,3871768,False,5441-4KXP-C7XX-47B5
QlLU02MFA42PqPm1hA,1710055136,Lesya,4829,4829,-200000,-200000,980,0,0,4194268,True,08K2-P9C3-3C77-2H6H
38sZlajaxmIHHInRXw,1710019143,–ü–æ–ø–æ–≤–Ω–µ–Ω–Ω—è ¬´–ó–ê–•–ò–°–ù–Ü –ö–£–ü–û–õ–ò¬ª,4829,4829,-222200,-222200,980,0,0,4394268,True,AHE1-58B5-HPH8-XHB3
z3lmRnYMHGlH1muV_g,1709998305,"–ü–æ–ø–æ–≤–Ω–µ–Ω–Ω—è ¬´Teplak, mavic ,auto¬ª",4829,4829,-4000,-4000,980,0,0,4616468,True,8807-7K8C-7043-9AEX
_aSFC1togH8Z6y-G9A,1709989986,Bestwaytocup,5814,5814,-30500,-30500,980,0,610,4620468,False,X9CA-7474-7MCT-2243
tQnrRKeO3LOMH5hz4A,1709988294,Novapay,8999,8999,-5000,-5000,980,0,0,4650968,False,623K-21H9-BB0K-0733
fH5IB4rpOFanxHLgWQ,1709979763,–¢–∞–±–∞–∫–µ—Ä–∫–∞,5993,5993,-81900,-81900,980,0,0,4655968,False,9H49-9KM1-4A11-E5H1
7SnMwPdYuvobMn41NQ,1709978853,Mates,5812,5812,-114500,-114500,980,0,2290,4737868,True,8276-AB0M-85A8-8C8X
NykF23x4vBuzxJLhKw,1709894571,–û—Ñ—ñ—Å-—á–∞–π,5812,5812,-21000,-21000,980,0,420,4852368,True,679B-59HC-9755-KP40
ZJpcH4zOSYfjIms1IA,1709894396,Beerplace,5814,5814,-26000,-26000,980,0,520,4873368,False,HECC-6HHH-XCTP-K94K
SNpAlYc2xdgvHztuyA,1709894248,–ê–ø—Ç–µ–∫–∞ –ê–ù–¶,5912,5912,-151750,-151750,980,0,0,4899368,False,2K16-1B9C-K250-T3XC
eKqpr4lM8dn4h7uHww,1709894014,PetStoriesZootovari,5995,5995,-44640,-44640,980,0,0,5051118,False,EC51-2TB3-EK8K-9762
lfncv_lh9vdf9PWa5g,1709891293,Bestwaytocup,5814,5814,-17500,-17500,980,0,350,5095758,False,3C3P-5A61-X8K7-6TX7
ZFZgm7eC3FD03vdKTw,1709889846,–ü–æ–ø–æ–≤–Ω–µ–Ω–Ω—è ¬´—Å–∏–ª—å–Ω—ñ¬ª,4829,4829,-50000,-50000,980,0,0,5113258,True,TXAT-K96B-H4P3-0MH9
L39SNldiPAFJxj7WiA,1709837393,OK Wine,5411,5411,-22200,-22200,980,0,0,5163258,False,3AB6-0KC4-BEC0-KA6E
GcWk_Zx1rcIbJ4kSLA,1709818792,Novapay,8999,8999,-41400,-41400,980,0,0,5185458,False,66P1-TAP8-C30H-94C8
CT21bxbisLSeYc_kvg,1709803285,kaviarnia the coffee L,5812,5812,-8500,-8500,980,0,170,5226858,False,X1XH-3TC4-E848-CEE2
8sDYGTrROL-FGjS1NQ,1709802215,–ù–æ–≤–∞ –ø–æ—à—Ç–∞,7399,7399,-3000,-3000,980,0,0,5235358,False,44K9-BE1K-4M5C-E051
23AsSbvYVfh5rRw2Kw,1709794115,La Fabrique,5814,5814,-7000,-7000,980,0,140,5238358,False,859E-666B-5MME-3XBK
06PuX9ChQgZdSHa-rw,1709747392,FOPKrivoruchenkoNV,7230,7230,-283000,-283000,980,0,0,5245358,False,T3E3-P43A-143M-9PA6
spiHsygAdgk2eV3-Hw,1709729941,–°—ñ–ª—å–ø–æ,5411,5411,-34700,-34700,980,0,0,5528358,False,KX09-828A-M4TB-84XX
imeqwuPqtQO1UXjeOg,1709715927,FOP Trenin MS,5814,5814,-5900,-5900,980,0,118,5563058,False,8XB7-T07P-BX89-PCH0
j35146UVkz-lEraQiA,1709666903,ROZM TRANSP VIDVIDUV,7523,7523,-9000,-9000,980,0,0,5568958,False,094M-8261-6H9E-TH88
z-dxPwL-FybWh6St9w,1709666149,–°–ø–∏—Å–∞–Ω–Ω—è iPay.ua,6012,6012,-16000,-16000,980,0,0,5577958,False,AK2C-7522-APPA-CX3A
hOYD3vXbfPk3xF3svw,1709666116,Gulliver –ë–æ—É–ª–∏–Ω–≥,7933,5812,-114500,-114500,980,0,0,5593958,False,HP9B-T5X8-MMB4-7E6E
b2OWwzGN2Kk4G-e-1Q,1709666091,RESTORAN BOWLING GULLI,5812,5812,-54500,-54500,980,0,1090,5708458,False,10CT-0445-447A-A814
7j2PsgCTnAfhU1apDQ,1709625333,FDY*Merchandise,5399,5399,-42320,-42320,980,0,0,5762958,False,B0CX-EXB6-8MXX-6C4E
L1hVvZi1Gsj3rKIvLg,1709621256,Bestwaytocup,5814,5814,-17500,-17500,980,0,350,5805278,False,29C6-35CH-1XA7-XHCX
ETDYDb8jMAmzMxV1Ig,1709579774,Naushi | –ë–æ—Ä–∏—Å–∞ –ì—Ä—ñ–Ω—á–µ–Ω–∫–∞,5812,5812,-124500,-124500,980,0,2490,5822778,True,0PT7-63MX-C2TP-K945
DlketiY50DNsarhECg,1709547849,–ü–æ–ø–æ–≤–Ω–µ–Ω–Ω—è ¬´–ù–∞ –∫–∞–º–ø—É—Ç—î—Ä –¥–ª—è –≥—Ç–∞6¬ª,4829,4829,-7485,-7485,980,0,0,5947278,True
bWRhzcAkFGI0C5ew6g,1709547786,–ü–æ–ø–æ–≤–Ω–µ–Ω–Ω—è ¬´–ù–∞ –∫–∞–º–ø—É—Ç—î—Ä –¥–ª—è –≥—Ç–∞6¬ª,4829,4829,-26300,-26300,980,0,0,5954763,True
iyWsBNk44Nkij6aLLw,1709547717,–ü–æ–ø–æ–≤–Ω–µ–Ω–Ω—è ¬´–ù–∞ –¥—Ä—ñ–º –≤–∞–Ω–Ω—É¬ª,4829,4829,-75000,-75000,980,0,0,5981063,True,40AM-0P81-K2A1-475H
9JrDUMSuncHAqCwfPQ,1709547563,–ü–æ–ø–æ–≤–Ω–µ–Ω–Ω—è ¬´–ó–ê–•–ò–°–ù–Ü –ö–£–ü–û–õ–ò¬ª,4829,4829,-50000,-50000,980,0,0,6056063,True,33MM-XMKE-6TK2-MP91
jqeSJ_DgKsQtn7PvVQ,1709547248,SHIBUYA | –Ø—Ä–æ—Å–ª–∞–≤—ñ–≤ –í–∞–ª,5812,5812,-375520,-375520,980,0,7510,6106063,True,P54M-74CA-124E-07P4
OhhrxOSJ8qBVYRYcKA,1709546907,–ü–æ–ø–æ–≤–Ω–µ–Ω–Ω—è ¬´–ù–∞ –ø–æ–∑–∞—à–ª—è—Ö–æ–≤–∏–∫¬ª,4829,4829,-150000,-150000,980,0,0,6481583,True,09CB-KA32-KX47-59H8
AWLyo_I02ypwXLludg,1709545923,–íi–¥: –ü–†–ò–•–û–î–¨–ö–û –ï.–í. –§–û–ü,"–î–ª—è –ø–æ–ø–æ–≤–Ω–µ–Ω–Ω—è –∫–∞—Ä—Ç–∫–∏ 5375414101190360, –ü—Ä–∏—Ö–æ–¥—å–∫–æ –ï—Ä–Ω–µ—Å—Ç –íi–∫—Ç–æ—Ä–æ–≤–∏—á, 3487403339",4829,4829,6500000,6500000,980,0,0,6631583,True
eGmdthsTQDk944G-tw,1709545226,Bestwaytocup,5814,5814,-7500,-7500,980,0,56,131583,False,2499-8957-2TM6-BA6K
e1eOI-lT-4wtww2amA,1709545076,magazin 762597,5912,5912,-54270,-54270,980,0,0,139083,False,871T-BHC8-5MH8-E36P
FKdTf5LQqWbgipvkbQ,1709479661,–ö–æ–ª–æ,5411,5499,-3700,-3700,980,0,0,193353,False,70BH-9329-PCH2-P68E
WTKxPxRPaW9WJwmupg,1709469823,Magazin Azur Zol,5399,5399,-1500,-1500,980,0,0,197053,False,KH73-32A3-B979-9A3C
EyVCNNapQj28zMuTIA,1709458988,Bestwaytocup,5814,5814,-48600,-48600,980,0,364,198553,False,ME42-E6MH-8BC5-ABX9
fLVIw3N99FNDifprHw,1709458750,–¢–∞–±–∞–∫–µ—Ä–∫–∞,5993,5993,-81900,-81900,980,0,0,247153,False,KEH8-64X7-0515-4P02
f5Nub7bHXGffxi9ekA,1709458406,StudijaKvitivtadekoruS,5992,5992,-305500,-305500,980,0,2291,329053,False,1EB7-4HBK-M373-T9XT
apDm10j4rKTqfyaHnw,1709452058,–ê–ø—Ç–µ–∫–∞ ¬´–ë–∞–∂–∞—î–º–æ –∑–¥–æ—Ä–æ–≤'—è¬ª,5912,5399,-81436,-81436,980,0,0,634553,False,26PB-T3E3-M517-0A85
hcokZFlSxmmRKRH4lA,1709451575,magazin 762597,5912,5912,-15946,-15946,980,0,0,715989,False,X350-K3AK-P4CB-3AC9
vZ4KJJgH3vkPqINEkA,1709451344,Novus,5411,5411,-33795,-33795,980,0,0,731935,False,MMET-E70M-PH1M-MA4K
70yaiSP0MGwjRj-xKg,1709449734,Novapay,8999,8999,-5300,-5300,980,0,0,765730,False,X8AE-6KH7-A4HX-6295
I4VbfzmFRA9ErrXsTg,1709449691,Novapay,8999,8999,-5500,-5500,980,0,0,771030,False,12BM-BHT5-6968-MHE4
z5hmTor019lr7yCdYA,1709396879,Prostor,5977,5977,-12100,-12100,980,0,0,776530,False,PA6P-859P-P57K-081H
f0TI_1kAFuZMdXFxFw,1709384833,–°—ñ–ª—å–ø–æ,5411,5411,-98762,-98762,980,0,0,788630,False,5B78-XTM0-86MA-P6C3
WvgVfPB25xm0xfAtpw,1709382175,WineTime,5921,5921,-55550,-55550,980,0,0,887392,False,2066-X167-EET6-CT18
Tcbt-IQFRCT-3XaT4g,1709381336,–°—ñ–ª—å–ø–æ,5411,5411,-32000,-32000,980,0,0,942942,False,HX9K-X025-021X-CT99
rBJ40Hnr7FElRwOIGQ,1709380878,–ó–æ–æ–º–∞–≥–∞–∑–∏–Ω –õ—é–±–∏–º—ã–π,5995,5995,-28000,-28000,980,0,0,974942,False,XT09-4324-XTTX-994B
BqTa3rn8N3L9t39lBA,1709380835,–ó–æ–æ–º–∞–≥–∞–∑–∏–Ω –õ—é–±–∏–º—ã–π,5995,5995,-72700,-72700,980,0,0,1002942,False,XH4T-M96H-6M06-12A0
i8P5wJ1zYycSfgvY6Q,1709376385,EasyPay,5411,5411,-359123,-359123,980,0,0,1075642,False,B6TA-EEH2-77K2-CB31
qNNBdlgFLfuIsPXElg,1709283218,Uklon,4121,4121,-10800,-10800,980,0,0,1434765,False,CPTA-T0BA-CXX9-26C2
1iqfjDejraUcGfF1iQ,1709278499,Novapay,8999,8999,-379500,-379500,980,0,0,1445565,False,HM7B-0XX5-9XCA-AMBB
bNfqWaDRwRKEqXjExw,1709274741,Uklon,4121,4121,-13500,-13500,980,0,0,1825065,False,P92T-TEM0-A48H-2C4K
xXxLTDsRfd4t6BTvTQ,1711623858,Lesya,4829,4829,-400000,-400000,980,0,0,6461,False,PK7T-867P-K9M5-PXPE
bKonY_ADlFEWPfUKSg,1711556365,Lesya,4829,4829,-200000,-200000,980,0,0,406461,False,XMBA-07C6-K426-M643
aFkBRDPQ2yyCFldLSw,1711396858,–ü–æ–ø–æ–≤–Ω–µ–Ω–Ω—è ¬´–Ω–∞ –¥—Ä—ñ–º –≤–∞–Ω–Ω—É¬ª,4829,4829,-10000,-10000,980,0,0,606461,False,A2KK-X089-3K9C-499H
fBxZxn3poweatfyahQ,1711362859,–ü–æ–ø–æ–≤–Ω–µ–Ω–Ω—è ¬´–ù–∞ –∫–∞–º–ø—É—Ç—î—Ä –¥–ª—è –≥—Ç–∞6¬ª,4829,4829,-14738,-14738,980,0,0,616461,False
jb4BoRRJQY7j3RbloQ,1711362838,–ü–æ–ø–æ–≤–Ω–µ–Ω–Ω—è ¬´–ù–∞ –¥—Ä—ñ–º –≤–∞–Ω–Ω—É¬ª,4829,4829,-50000,-50000,980,0,0,631199,False,PA7H-5B9X-PCBA-H20A
EC_zYqyPF_s7-39vAg,1711293067,–ñ–∞–Ω–Ω–∞ –ñ.,4829,4829,-250000,-250000,980,0,0,681199,False,31PB-C5E2-43C1-P3E1
HwZlGBkBFWoxUdCX7Q,1711250739,–†–µ–≥—É–ª—è—Ä–Ω–µ –ø–æ–ø–æ–≤–Ω–µ–Ω–Ω—è ¬´–§–æ–Ω–¥ –ü–æ–≤–µ—Ä–Ω–∏—Å—å –∂–∏–≤–∏–º¬ª,4829,4829,-25000,-25000,980,0,0,931199,False,P566-TK4T-T39M-434A
7OvxXgtKWtJGN9cq4w,1711198270,–ü–æ–ø–æ–≤–Ω–µ–Ω–Ω—è ¬´–ù–∞ –∫–∞–º–ø—É—Ç—î—Ä –¥–ª—è –≥—Ç–∞6¬ª,4829,4829,-61427,-61427,980,0,0,956199,False
d8EDSSURajwEPMN1zA,1711198250,–ü–æ–ø–æ–≤–Ω–µ–Ω–Ω—è ¬´–ù–∞ –¥—Ä—ñ–º –≤–∞–Ω–Ω—É¬ª,4829,4829,-100000,-100000,980,0,0,1017626,False,CT5E-K19E-9HBC-669H
cDCS2FLhZjW1FKQPxQ,1711196428,Lesya,4829,4829,-200000,-200000,980,0,0,1117626,False,4X4K-B1X2-MXH4-KTHM
3DY5OqLkmRVLiEkR-g,1711103035,–ó —á–æ—Ä–Ω–æ—ó –∫–∞—Ä—Ç–∫–∏,4829,4829,1200000,1200000,980,0,0,1317626,False
4jOnr_tUrzcBcmR65Q,1711034038,Lesya,4829,4829,-300000,-300000,980,0,0,117626,False,35PM-6TH9-5B9C-8XH6
6o_K2V91YOCgvLl6cg,1711014573,–ü–æ–ø–æ–≤–Ω–µ–Ω–Ω—è ¬´–æ–±–ª–∞–¥–Ω–∞–Ω–Ω—è –≤ –ß–∞—Å—ñ–≤–Ø—Ä¬ª,4829,4829,-150000,-150000,980,0,0,417626,False,KPEC-B8EM-1C80-33P4
kQ1IXxT9orhpSAk8NA,1711009484,–ü–æ–ø–æ–≤–Ω–µ–Ω–Ω—è ¬´–ù–∞ —Å—É–∫–Ω—é –≤–∏—à–∏–≤–∞–Ω–∫—É¬ª,üéâüéâüéâ,4829,4829,-200000,-200000,980,0,0,567626,False,M1T9-8XB4-21M2-065E
DFV_KV7Yff1htevgEQ,1711009373,–û–ª–µ—Å—è –°.,4829,4829,-200000,-200000,980,0,0,767626,False,T2AT-45XX-P7CH-8B54
3Vz1nsuuJx4BXAA_5w,1710883862,–ó —á–æ—Ä–Ω–æ—ó –∫–∞—Ä—Ç–∫–∏,4829,4829,700000,700000,980,0,0,967626,True
SZdvCSzZ56aColmtqQ,1710645920,–†–µ–≥—É–ª—è—Ä–Ω–µ –ø–æ–ø–æ–≤–Ω–µ–Ω–Ω—è ¬´–§–æ–Ω–¥ –ü–æ–≤–µ—Ä–Ω–∏—Å—å –∂–∏–≤–∏–º¬ª,4829,4829,-25000,-25000,980,0,0,267626,True,08T7-7T1H-7M01-THX9
O9JOQ-GA_n5IZJqQ_Q,1710490481,–ü–æ–ø–æ–≤–Ω–µ–Ω–Ω—è ¬´–ù–∞ –º—ñ–Ω–æ–º–µ—Ç–Ω–∏–π –ø—Ä–∏—Ü—ñ–ª¬ª,4829,4829,-100000,-100000,980,0,0,292626,True,B548-TE37-M1KE-HH41
pqMN3XgViMjaD7BerQ,1710432428,–ñ–∞–Ω–Ω–∞ –ñ.,4829,4829,-250000,-250000,980,0,0,392626,True,38T9-P2X5-0259-P34H
6mPRQYKkaO9MYGpvHw,1710279770,–ü–æ–ø–æ–≤–Ω–µ–Ω–Ω—è ¬´–í–∏—à–∏–≤–∞–Ω–∫–∞ –∑–∞ –¥–æ–Ω–∞—Ç¬ª,4829,4829,-50000,-50000,980,0,0,642626,True,TP45-6A5K-P10C-K635
FdqX8nzsifX9OcxKAw,1710228154,Lesya,4829,4829,-100000,-100000,980,0,0,692626,True,H9B8-X9PE-3EPC-M95E
bKUfKyc19-b59pCccg,1710086438,–ó —á–æ—Ä–Ω–æ—ó –∫–∞—Ä—Ç–∫–∏,4829,4829,700000,700000,980,0,0,792626,True
G2cDxncEumqZNuXReg,1710041387,–†–µ–≥—É–ª—è—Ä–Ω–µ –ø–æ–ø–æ–≤–Ω–µ–Ω–Ω—è ¬´–§–æ–Ω–¥ –ü–æ–≤–µ—Ä–Ω–∏—Å—å –∂–∏–≤–∏–º¬ª,4829,4829,-25000,-25000,980,0,0,92626,True,8471-A3XM-25TE-4BKT
tWd36m7_7mM-3-XuXg,1709496679,–ü–æ–ø–æ–≤–Ω–µ–Ω–Ω—è ¬´–ó–ê–•–ò–°–ù–Ü –ö–£–ü–û–õ–ò¬ª,4829,4829,-200,-200,980,0,0,117626,True,0512-7M27-B4PC-9KA7
LQPmVoS34p9JCixctA,1709436376,–†–µ–≥—É–ª—è—Ä–Ω–µ –ø–æ–ø–æ–≤–Ω–µ–Ω–Ω—è ¬´–§–æ–Ω–¥ –ü–æ–≤–µ—Ä–Ω–∏—Å—å –∂–∏–≤–∏–º¬ª,4829,4829,-25000,-25000,980,0,0,117826,True,3XK9-4MM9-76EB-0003
zkgTCeeawCT8KUIkWw,1709370766,414960****6982,4829,4829,-27000,-27000,980,0,0,142826,True,27X6-668E-T5TM-22XM
i0JNeJazZf49CuW7LQ,1709279350,545708****3488,4829,4829,-25000,-25000,980,0,0,169826,True,1HH8-6T5P-KBB9-8K37
QY-VfZeF9S2xPW6cSQ,1709278830,–ö–∞—Ç–µ—Ä–∏–Ω–∞ –ë.,4829,4829,-35400,-35400,980,0,0,194826,True,81K0-BC2T-08H8-9MCP
ZzUSSGBmYa6Xozewog,1709276446,–í—ñ–¥: –û–ª–µ—Å—è –°–∞—á–µ–Ω–∫–æ,4829,4829,150000,150000,980,0,0,230226,True
esnA_JpBZlAk2NId8A,1714410998,–°—ñ–ª—å–ø–æ,5411,5411,-34200,-34200,980,0,0,1618677,False,7E96-H688-CBX3-78K6
uJiYNgZ94ZZxfdGr_g,1714391920,LIQPAY*HitTrejd,5993,5993,-380000,-380000,980,0,0,1652877,False,HP96-EH11-2MAC-K4B7
kHQWVPGTpe7kr7RtIA,1714381812,Pethouse,5995,5995,-636900,-636900,980,0,0,2032877,False,E6P3-8875-H2C9-PH2C
BKgDFIk8mFjWFsiukg,1714378974,–ü–æ–ø–æ–≤–Ω–µ–Ω–Ω—è ¬´–ù–∞ –∫–∞–º–ø—É—Ç—î—Ä –¥–ª—è –≥—Ç–∞6¬ª,4829,4829,-21793,-21793,980,0,0,2669777,False
V275mv00NzmvN085cQ,1714378956,–ü–æ–ø–æ–≤–Ω–µ–Ω–Ω—è ¬´–Ω–∞ –¥—Ä—ñ–º –≤–∞–Ω–Ω—É¬ª,4829,4829,-50000,-50000,980,0,0,2691570,False,P0X2-4KC4-9999-X4H9
Qw6kvc-CC9RQ12QWMw,1714378943,–ü–æ–ø–æ–≤–Ω–µ–Ω–Ω—è ¬´–°—Ç–∞–Ω—Ü—ñ—é –¥–ª—è 110 –û–ú–ë–†¬ª,4829,4829,-50000,-50000,980,0,0,2741570,False,PX5P-5729-H42C-EB7H
lYPn6rOPN2rOJJfcHg,1714378928,–ü–µ—Ä–µ–∫–∞–∑ –Ω–∞ –∫–∞—Ä—Ç–∫—É,4829,4829,-400000,-400000,980,0,0,2791570,False
aufiBmWz8givK3lVpw,1714378910,–°–ø–∏—Å–∞–Ω–Ω—è FDY*Merchandise,5399,5399,-101700,-101700,980,0,0,3191570,False,4CP3-P68H-0MCK-AEM6
xynp6PCdOgUF1zudoQ,1714377277,–íi–¥: –ü–†–ò–•–û–î–¨–ö–û –ï.–í. –§–û–ü,"–î–ª—è –ø–æ–ø–æ–≤–Ω–µ–Ω–Ω—è –∫–∞—Ä—Ç–∫–∏ 5375414101190360, –ü—Ä–∏—Ö–æ–¥—å–∫–æ –ï—Ä–Ω–µ—Å—Ç –íi–∫—Ç–æ—Ä–æ–≤–∏—á, 3487403339",4829,4829,3100000,3100000,980,0,0,3293270,False
lPXMGavyI7IlKrAqwg,1714368843,–°—ñ–ª—å–ø–æ,5411,5411,-95300,-95300,980,0,0,193270,False,KHC3-127H-996K-454M
DwqPXJ_jyRawAgyEIw,1714321494,Konteiner,5814,5814,-37000,-37000,980,0,0,288570,False,3MC6-3172-0978-K288
etXkjVDCdCMhrfsVwg,1714313818,–£–∫—Ä–∞—ó–Ω—Å—å–∫–∏–π –¥—ñ–º,7399,7399,-20000,-20000,980,0,0,325570,False,X778-6T89-XHXC-H3AT
bUZnHdzUZLo45zJJYA,1714312385,–ö–∏—ó–≤–ø–∞—Å—Ç—Ä–∞–Ω—Å,4111,4111,-800,-800,980,0,0,345570,False,8TE4-T6K3-964P-BCKB
lxzAiYbtHTzeL5egBA,1714310366,–ü–∏—Ä—ñ–∂–∫–æ–≤–∞ ¬´–¢—ñ—Ç–∫–∞ –ö–ª–∞—Ä–∞¬ª,5814,5814,-28200,-28200,980,0,0,346370,False,PM3K-TM77-074K-M3A7
DquXau-95psbtT2A4w,1714310238,–ó –±—ñ–ª–æ—ó –∫–∞—Ä—Ç–∫–∏,4829,4829,300000,300000,980,0,0,374570,False
h4374aMNOvoVMUGuTA,1714310215,–ö–æ–ª–æ,5411,5499,-23400,-23400,980,0,0,74570,False,2AC2-ACTT-8ECX-MP9T
e01wbQPyNXFWq8HmrQ,1714307711,AS377KahovskaGO,5912,5912,-33312,-33312,980,0,0,97970,False,TT31-M573-7EB8-E5P4
iJ2P7vUF4HumA9fEBg,1714306639,Apteka,5912,5912,-88500,-88500,980,0,0,131282,False,KPB9-TTM7-944A-1CP1
EpEcx28mrnmAfP8V8A,1714305964,"–ê–ø—Ç–µ–∫–∞ 36,6",5912,5912,-8019,-8019,980,0,0,219782,False,M867-P3AC-55A6-M5KB
zNSt-gW5JzSftq399w,1714304797,–ù–æ–≤–∞ –ø–æ—à—Ç–∞,4214,4214,-8500,-8500,980,0,0,227801,False,T2KT-HB35-8X7K-07AM
9TNBKnES-XXvlaygQQ,1714304672,–ê–ø—Ç–µ–∫–∞ ‚Ññ1,5912,5912,-20890,-20890,980,0,0,236301,False,01A9-60BM-3X3E-HTE9
Kx9v9vWvJZ8h_YKIVw,1714303895,Kyivska173,5912,5912,-8450,-8450,980,0,0,257191,False,8CA0-3598-C105-6C9B
tQKD2ojbTGWd6LE_oA,1714303088,–ë—É–¥–µ–º–æ –ó–¥–æ—Ä–æ–≤—ñ –†–∞–∑–æ–º,5912,5912,-15837,-15837,980,0,0,265641,False,6214-PK56-00AP-52MT
WdgUZHIKwbGCMoG8vw,1714302077,A1923,5912,5912,-16191,-16191,980,0,485,281478,False,8HAP-2M02-2TP9-8MA4
nSWybMr_y9yNLUDpXQ,1714301104,APTEKA 2 ZAKREV,5912,5912,-32112,-32112,980,0,0,297669,False,K1HE-T833-T121-95CK
V-l05KN7DZxJle1wQg,1714300476,–ê–ü–¢–ï–ö–ê –ë–ê–ú,5912,5912,-8212,-8212,980,0,0,329781,False,HAT5-EBKA-MEBB-59K1
FsV82vM3_siIGI8Pww,1714299870,TOV LANPUS APTEKA N8,5912,5912,-16402,-16402,980,0,0,337993,False,9K8E-MC20-90CP-2010
MyN4Bbecn-lwnlom2w,1714299423,–ê–ø—Ç–µ–∫–∞ –ë–∞–º,5912,5912,-24275,-24275,980,0,0,354395,False,CHPC-TBTC-07AT-AP93
A9ySXUZXX_C7neiofQ,1714298582,magazin780196,5912,5912,-9610,-9610,980,0,0,378670,False,A938-8PX2-KCKE-H5XT
QMBW04m1iQnPPC1Ulg,1714298552,magazin780196,5912,5912,-8209,-8209,980,0,0,388280,False,KAX6-2A99-H1EH-MM1P
ZPIXQJDv6NHlqdWPog,1714297892,Apteka Optovykh Tsin,5912,5912,-16430,-16430,980,0,0,396489,False,A02H-A4BX-B6M1-M165
--WtEx9kekkAXEnAoQ,1714297142,Kiev 20,5912,5912,-17120,-17120,980,0,0,412919,False,7XH8-1MMA-633X-K220
pD96qBqcV61eTYucTw,1714293865,MAKEUP,5977,5977,-213128,-211900,980,0,0,430039,False,E64P-TM1M-M5T4-3070
c_ZAsjk9TsJh2UzzWw,1714289011,Novus,5411,5411,-20378,-20378,980,0,0,643167,False,1C27-C1P6-7TKT-X06B
NzoROE-UeYtjGyHg1g,1714288556,Bestwaytocup,5814,5814,-15000,-15000,980,0,0,663545,False,EHX4-05PH-027T-0162
IzntdTpaEXYIc_SW7AtL,1714259096,Bolt Food,4215,4215,-2431,-2431,980,0,0,678545,True
27gnizfUTghOf1BBqFBubxHy9lA,1714259096,–°–∫–∞—Å—É–≤–∞–Ω–Ω—è. Bolt Food,4215,4215,5000,5000,980,0,0,680976,False
KCSVuPVA8NvVXh60qA,1714228721,–ü–∞—Ä–∫–æ–≤–∫–∞,7523,7523,-8000,-8000,980,0,0,675976,False,PMK7-4EX7-P12B-8324
LxrL_Pi59oRNQSsGdQ,1714221529,OK Wine,5411,5411,-14550,-14550,980,0,0,683976,False,HXTK-5C12-78H5-5376
IwpNpPen0sLHOJRURw,1714221341,magazin 762597,5912,5912,-196140,-196140,980,0,0,698526,False,AH72-9T83-4153-1527
3i-fhuYK1D_YfCNBKA,1714220853,–ê–ø—Ç–µ–∫–∞ ¬´–ë–∞–∂–∞—î–º–æ –∑–¥–æ—Ä–æ–≤'—è¬ª,5912,5399,-59060,-59060,980,0,0,894666,False,49HE-0370-TT0M-852K
YwNqsR-RiTKrrGLdfw,1714210696,FDY*RESTAURANTS,5814,5814,-82950,-82950,980,0,0,953726,False,7HT2-E8HT-ECE1-KHE2
j4VssNUaFLgbjuaC_w,1714210127,–†—ñ–¥–Ω–∞ –∞–ø—Ç–µ–∫–∞,5912,5912,-16943,-16943,980,0,0,1036676,False,K0C9-3018-15M9-63E8
95Del2ufZgzy50n_OA,1714209038,"–ê–ø—Ç–µ–∫–∞ 36,6",5912,5912,-8288,-8288,980,0,0,1053619,False,8X9H-7H04-EM97-T43E
61rL68xsDN9VJ1l8Tw,1714208977,"–ê–ø—Ç–µ–∫–∞ 36,6",5912,5912,-12100,-12100,980,0,0,1061907,False,401B-83B0-24AK-9K57
DcQU1BdwU5jPruD4WA,1714207478,APTEKA 37,5912,5912,-8388,-8388,980,0,0,1074007,False,ET7B-EX8K-PBC2-2974
EbWhzd50iRZIk-XW_A,1714207223,–ó–æ–æ–ª–æ–≥—ñ—è,5995,5995,-30000,-30000,980,0,0,1082395,False,3CXB-3M5H-K2BB-87TC
4pcoPpGZOeNjmRXxog,1714207177,PORIKA,5912,5912,-9526,-9526,980,0,0,1112395,False,HX2A-4H67-7T7C-C5CP
DIPzN3qRdgr5zJ5fiA,1714206566,–ê–ø—Ç–µ–∫–∞,5912,5912,-7955,-7955,980,0,0,1121921,False,0642-1A72-C5BX-6PHX
Sjx2xme6iOH4m6VoWA,1714206133,MS K 072,5912,5912,-26780,-26780,980,0,0,1129876,False,M2TB-7CAH-7P1A-EE55
wANTDf-ZVnknbErEgQ,1714198696,Bestwaytocup,5814,5814,-8000,-8000,980,0,0,1156656,False,M29C-M095-86X2-H47K
zEcTyzdKMC8hI3kTiQ,1714154517,Beerplace,5814,5814,-52000,-52000,980,0,0,1164656,False,0T46-1M9M-47XM-17X0
HgGEF10Jd-Hx7KVe_Q,1714152743,NUNU | –Ø—Ä–æ—Å–ª–∞–≤—ñ–≤ –í–∞–ª,5812,5812,-74300,-74300,980,0,0,1216656,False,AE01-CMX0-13ET-H517
GrMmYZsNpXMtgoIGgw,1714152314,Bolt Food,4215,4215,-5000,-5000,980,0,0,1290956,False
KGI5McTO216dm38iAA,1714149737,magazin 762597,5912,5912,-2451,-2451,980,0,0,1295956,False,766B-X08X-5XHX-3B9P
gPefdbLsNxJE08xReA,1714149626,–ù–æ–≤–∞ –ø–æ—à—Ç–∞,7399,7399,-7000,-7000,980,0,0,1298407,False,TM73-M1PC-P7B3-75X1
qNvX2nM6nblhaWUvtg,1714146862,Aptechniypunkt1Apteki1,5912,5912,-3819,-3819,980,0,0,1305407,False,TMT4-P09A-A3CK-2EM6
gC-S34A97nA2EaxXMg,1714126690,–ö–£–ó–Ø,4900,4900,-35000,-35000,980,0,0,1309226,False,CXHK-X250-0977-4AX8
Qqopci_2H8TAlgHXwQ,1714120189,–ö–∏—ó–≤–ø–∞—Å—Ç—Ä–∞–Ω—Å,4111,4111,-800,-800,980,0,0,1344226,False,8755-K11E-H766-5018
qvqxtLctt49TJzjZmQ,1714068899,–°—ñ–ª—å–ø–æ,5411,5411,-87100,-87100,980,0,0,1345026,False,4H8C-316K-3BCE-T6C5
jBndhznh8BnV5jZbcg,1714047858,–°—ñ–ª—å–ø–æ,5411,5411,-85200,-85200,980,0,0,1432126,False,7C78-EPTX-K2X6-K495
5XXqwgIn_3G3o5Hb1w,1714033344,magazin 762597,5912,5912,-15800,-15800,980,0,0,1517326,False,H5B5-K820-906H-CT80
23KkxCglpTqWGRfFTw,1714033274,Prostor,5977,5977,-10610,-10610,980,0,0,1533126,False,KK2H-31AE-0E7T-M211
uEZ81LhG1v2qLKtLhA,1714031883,Magazin CafeBoutique,5399,5399,-7500,-7500,980,0,0,1543736,False,E2P2-13KM-76CM-BA93
G6rEQv6HrSdNLrNE2w,1714023800,–£–∫—Ä–∑–∞–ª—ñ–∑–Ω–∏—Ü—è,4112,4112,-194671,-194671,980,0,0,1551236,False,0B8H-3M55-X0KX-E46M
R1CKNbOG1psA9DmLuw,1713978679,–°—ñ–ª—å–ø–æ,5411,5411,-18816,-18816,980,0,0,1745907,False,T52K-5H00-CBB3-546A
C6iZKERjdcbbJviUaw,1713978333,–°—ñ–ª—å–ø–æ,5411,5411,-64100,-64100,980,0,0,1764723,False,0T9M-6P22-27MA-6EBT
m80-48RHvKv5ZtL-vw,1713953646,GORK176,5912,5912,-53496,-53496,980,0,0,1828823,False,3T4B-9733-XXHH-HKTM
6RWqyODX85EwB2yk6A,1713892121,–°—ñ–ª—å–ø–æ,5411,5411,-50100,-50100,980,0,0,1882319,False,HHP2-81M0-K3H4-HKE7
wVKdgsziEuF_oXWW1Q,1713872759,–ü–∏—Ä—ñ–∂–∫–æ–≤–∞ ¬´–¢—ñ—Ç–∫–∞ –ö–ª–∞—Ä–∞¬ª,5814,5814,-55700,-55700,980,0,0,1932419,False,XBT4-79PM-PKP1-X5B9
y8IDQnV0fOxiWzr-Yw,1713872116,OK Wine,5921,5921,-4900,-4900,980,0,0,1988119,False,61K7-KT82-MEPE-83M0
RltOLwebQBYqe5COZw,1713858982,Novapay,8999,8999,-5700,-5700,980,0,0,1993019,False,E8EM-47X2-5BBM-E7H1
yv-GAQNbMgo8in3f8g,1713805756,Novapay,8999,8999,-9300,-9300,980,0,0,1998719,False,P3HK-A9BP-23CA-06BX
nYFAVjbNHzncIdUOjg,1713803426,Aptechniypunkt1Apteki1,5912,5912,-7665,-7665,980,0,0,2008019,False,1BAM-7936-8826-T96X
ykrrfnB557RhtkDkeg,1713799019,–ê–ø—Ç–µ–∫–∞ ¬´–ë–∞–∂–∞—î–º–æ –∑–¥–æ—Ä–æ–≤'—è¬ª,5912,5399,-74066,-74066,980,0,0,2015684,False,CMA6-A7HP-6BCE-7017
SwXgz1JxPt4K6ieAKw,1713798929,–ö–æ–ª–æ,5411,5499,-19000,-19000,980,0,0,2089750,False,7HH1-1CTC-6P70-A2AC
eREbq9oqlDwGCZOCyQ,1713798385,–ü–µ—Ä–µ–∫–∞–∑ –Ω–∞ –∫–∞—Ä—Ç–∫—É,4829,4829,-400000,-400000,980,0,0,2108750,False
wc_9EZE8biKzEzwDZA,1713788529,–ü–æ–ø–æ–≤–Ω–µ–Ω–Ω—è ¬´–ù–∞ –∫–∞–º–ø—É—Ç—î—Ä –¥–ª—è –≥—Ç–∞6¬ª,4829,4829,-37896,-37896,980,0,0,2508750,False
iw8KqkClGUoKndSuOQ,1713788515,–ü–æ–ø–æ–≤–Ω–µ–Ω–Ω—è ¬´–Ω–∞ –¥—Ä—ñ–º –≤–∞–Ω–Ω—É¬ª,4829,4829,-12500,-12500,980,0,0,2546646,False,KK62-2TC7-7EKP-C8T8
w_teKHHresS32UrbdQ,1713788507,–§–û–ü –ë—Ä–æ–≤—ñ–Ω—Å—å–∫–∏–π –í–æ–ª–æ–¥–∏–º–∏—Ä –ì—Ä–∏–≥–æ—Ä–æ–≤–∏—á,4829,4829,-765000,-765000,980,0,0,2559146,False,KEXK-BMM6-1B2B-9M5A
Cr38tR1uEARotXdO7Q,1713776750,–°—ñ–ª—å–ø–æ,5411,5411,-27100,-27100,980,0,0,3324146,False,615A-3E93-8M48-P8K9
U8SvTTu1dMzdqW_vhQ,1713776202,–íi–¥: –ü–†–ò–•–û–î–¨–ö–û –ï.–í. –§–û–ü,"–î–ª—è –ø–æ–ø–æ–≤–Ω–µ–Ω–Ω—è –∫–∞—Ä—Ç–∫–∏ 5375414101190360, –ü—Ä–∏—Ö–æ–¥—å–∫–æ –ï—Ä–Ω–µ—Å—Ç –íi–∫—Ç–æ—Ä–æ–≤–∏—á, 3487403339",4829,4829,3000000,3000000,980,0,0,3351246,False
mSAUyIxMmVPKFTBq9yHN,1713740197,Bolt Food,4215,4215,-2097,-2097,980,0,0,351246,True
1FyDltRWlUs84fr7T0uTEZlCgtE,1713740197,–°–∫–∞—Å—É–≤–∞–Ω–Ω—è. Bolt Food,4215,4215,5000,5000,980,0,0,353343,False
5yKL_ejDswxufW2Kyw,1713728354,Pethouse,5995,5995,-618900,-618900,980,0,0,348343,False,TT4H-P0HC-5X2C-6753
SVLWKIXGdtLAhPEwAw,1713719850,–ó –±—ñ–ª–æ—ó –∫–∞—Ä—Ç–∫–∏,4829,4829,400000,400000,980,0,0,967243,False
Pj2HEH5a4fFlxotT5Q,1713706766,–ú—ñ—Å—å–∫–∞ –á–¥–∞–ª—å–Ω—è,5814,5814,-8000,-8000,980,0,0,567243,False,MEA1-EEEK-51AB-0B2A
7ch2qrb7Gfq6F58Sbg,1713693187,–°—ñ–ª—å–ø–æ,5411,5411,-30700,-30700,980,0,0,575243,False,CHXX-76MM-9TEC-PHX3
fRu1AMcvd-d6oQWWYA,1713683548,–ö–æ–ª–æ,5411,5499,-39050,-39050,980,0,0,605943,False,B8A1-TBT1-C7K6-H46T
_JFyMUwYNggKLHlemXj1,1713654981,Bolt Food,4215,4215,-4255,-4255,980,0,0,644993,True
P6WOUKC5tB52rr8Z7Zz-,1713654981,Bolt Food,4215,4215,-4259,-4259,980,0,0,649248,True
yH18AsRkczCq6KWE7K-eS8494-M,1713654981,–°–∫–∞—Å—É–≤–∞–Ω–Ω—è. Bolt Food,4215,4215,5000,5000,980,0,0,653507,False
nHyrfYCh9ZI-l8QA2kzGeOUax2M,1713654981,–°–∫–∞—Å—É–≤–∞–Ω–Ω—è. Bolt Food,4215,4215,6516,6516,980,0,0,648507,False
JDeX9NfR2u42bczHlg,1713624778,Novus,5411,5411,-36597,-36597,980,0,0,641991,False,C2C0-62C8-EK37-E0M6
SduUwt3IMhqGjx4tCQ,1713610544,Beerplace,5814,5814,-65500,-65500,980,0,0,678588,False,7HK4-5BTB-56B0-BCPA
Zb2hajlVoE9l0gV0PA,1713557123,Bolt Food,4215,4215,-5000,-5000,980,0,0,744088,False
wWIHGhqMrcPr-n260A,1713554835,Varvar Bar | –ö–∏—ó–≤,5812,5812,-37200,-37200,980,0,0,749088,False,9C4K-8KTT-22MM-501T
wgVJxPdpx2sEBA84aQ,1713543417,Bolt Food,4215,4215,-5000,-5000,980,0,0,786288,False
xxToxCNg9pGKKhEZLA,1713539549,Bolt Food,4215,4215,-6516,-6516,980,0,0,791288,False
A6ot4mDWtRA4YpJSGw,1713537662,KOKAbubbletea,5814,5814,-17000,-17000,980,0,0,797804,False,4EMK-8H07-P4B2-8BP6
GtJulHEFJH3BnF4G6g,1713533564,Bolt Food,4215,4215,-5000,-5000,980,0,0,814804,False,HE18-K6E0-45K1-B13E
-5mcsi6Pgap2YOjjpQ,1713527585,magazin 726008,5912,5912,-55106,-55106,980,0,0,819804,False,0KC9-78HB-TX61-P12P
azc-PDNCy_FXKN_N-Q,1713527531,magazin 726008,5912,5912,-116693,-116693,980,0,0,874910,False,2KEP-60BP-H69A-M390
yWy2zlYk12_OVTKFlw,1713510204,Bestwaytocup,5814,5814,-46500,-46500,980,0,0,991603,False,4EM2-B38X-095P-946E
cYmgiWmr8Ix_Y-sM4w,1713509358,FOP Shevchenko,5499,5499,-18000,-18000,980,0,0,1038103,False,PTAM-EKE4-07H4-P881
GBRHT9suLggd0aVxrg,1713457006,Novapay,8999,8999,-7000,-7000,980,0,0,1056103,False,80T8-K34C-A9CX-P4C1
Q6Cch3ty6aF85dIJ5w,1713446497,–ö–æ–ª–æ,5411,5499,-28500,-28500,980,0,0,1063103,False,3668-3K71-971K-2A3K
dFBUmcPV_VXvvFfUdQ,1713441722,Right coffee bar,5814,5814,-39000,-39000,980,0,0,1091603,False,884B-19ET-PC6P-P3PC
PLp2LVuPj4jGNNPYqg,1713441628,–ü–∏—Ä—ñ–∂–∫–æ–≤–∞ ¬´–¢—ñ—Ç–∫–∞ –ö–ª–∞—Ä–∞¬ª,5814,5814,-25000,-25000,980,0,0,1130603,False,PC80-ACE4-5AB9-HTB9
1ZiqyJLM8Fjz4251BQ,1713440329,Aptechniypunkt1Apteki1,5912,5912,-17985,-17985,980,0,0,1155603,False,M4K5-69CB-H6XC-114B
Ls_m0AuqC__2I3E2hQ,1713431377,Novapay,8999,8999,-7000,-7000,980,0,0,1173588,False,7P3M-P995-8CXA-99KX
DL7Tcyn30k-rWa859A,1713371223,–¢–∞–±–∞–∫–µ—Ä–∫–∞,5993,5993,-9500,-9500,980,0,0,1180588,False,3HT1-3A2C-5XCX-KEBC
4Q35za-2vTdygivFHQ,1713371174,Novus,5411,5411,-6499,-6499,980,0,0,1190088,False,4263-P5AC-4KPA-P0ET
9WlEEU0SHwohMIPGhw,1713349227,–°–ø–∏—Å–∞–Ω–Ω—è FDY*Merchandise,5399,5399,-61520,-61520,980,0,0,1196587,False,XX73-HB7E-PTP3-18B4
fQzkz07sz_aqx-P_mw,1713284697,Konteiner,5814,5814,-54000,-54000,980,0,0,1258107,False,7685-1MX4-09P8-T6P4
V6oPWhsjLAn_QBU9zg,1713283330,FDY*Food,5499,5499,-89980,-89980,980,0,0,1312107,False,PA08-5C30-6APE-2AP2
bbCT23PbOydV-hKQNA,1713260238,–ö–æ–ª–æ,5411,5499,-18000,-18000,980,0,0,1402087,False,64EP-KC40-74EM-5B9M
e46OlbLqCrtojGyavA,1713260146,–ê–ø—Ç–µ–∫–∞ ¬´–ë–∞–∂–∞—î–º–æ –∑–¥–æ—Ä–æ–≤'—è¬ª,5912,5399,-21095,-21095,980,0,0,1420087,False,2HC2-3TP6-HK1B-671X
vCNOOQeJu77CR70Hrw,1713257568,–í–µ—Ç–µ—Ä–∏–Ω–∞—Ä–Ω–∞ –∞–ø—Ç–µ–∫–∞,742,742,-330000,-330000,980,0,0,1441182,False,K02P-H535-TP56-4XB5
Ae8HfyX5IKJKgrVT9w,1713247667,La Fabrique,5814,5814,-7000,-7000,980,0,0,1771182,False,4PHP-TBB2-C3C1-1264
h7m0kVBr2XQ2PO9oMA,1713204409,Novapay,8999,8999,-5500,-5500,980,0,0,1778182,False,X4E0-CMAM-6XEX-31C2
7R74aUkT6NrChd3ZdQ,1713200264,–ê–ø—Ç–µ–∫–∞ ¬´–ë–∞–∂–∞—î–º–æ –∑–¥–æ—Ä–æ–≤'—è¬ª,5912,5399,-77286,-77286,980,0,0,1783682,False,7000-TAKA-M1P3-4ACM
H0tDWmhpkk9blaw0ig,1713199484,Novus,5411,5411,-2698,-2698,980,0,0,1860968,False,HXB9-E083-H799-CA7H
0El-pI_ugmhaodpyqw,1713199267,Novus,5411,5411,-5498,-5498,980,0,0,1863666,False,05E4-6H41-0MHE-3469
up2CAV_6mZgwQojVCA,1713198822,CEH,7216,7216,-154500,-154500,980,0,0,1869164,False,HPT8-42H7-6P6B-97HA
bD3UupONiGRUeP7S3A,1713178126,–°—ñ–ª—å–ø–æ,5411,5411,-35700,-35700,980,0,0,2023664,False,9TA9-6C05-CXHT-XXC4
U9jfPi0u3ubVxmKOwA,1713171814,Novapay,8999,8999,-5700,-5700,980,0,0,2059364,False,6H3M-86B3-2P45-8KBE
VJ_4qz3VbR-Iq3FcsQ,1713166497,LIQPAY*HitTrejd,5993,5993,-285000,-285000,980,0,0,2065064,False,BH16-7BX8-1KK9-CPXC
ryLwcEPOuCEJQItr4A,1713165331,Libd,5814,5814,-5000,-5000,980,0,0,2350064,False,6PBC-78HK-5T2C-4T9P
m32kQce6mU4EMArTlg,1713163493,Mates,5812,5812,-7900,-7900,980,0,0,2355064,False,E989-7H8H-15MX-9E3A
ptf09G5HaNOwHT5LLA,1713095834,–ê–≤—Ç–æ–º–∞–≥–∞–∑–∏–Ω,7542,7542,-80000,-80000,980,0,0,2362964,False,CAM7-HK28-HM80-955A
Hztkj1y2Ab8IvNNjQg,1713095598,Novus,5411,5411,-7699,-7699,980,0,0,2442964,False,10PK-HC64-6963-A8A1
UTotEoS0dtGxwZVm1g,1713094968,PIEDDEPOULE,7230,7230,-60000,-60000,980,0,0,2450663,False,6TET-701C-HP7H-4AT3
enmqQK6ztmNBu3vAXQ,1713090216,–ü–µ—Ä–µ–∫–∞–∑ –Ω–∞ –∫–∞—Ä—Ç–∫—É,4829,4829,-700000,-700000,980,0,0,2510663,False
dKdJmnwLd35PDGacBQ,1713090194,–ü–æ–ø–æ–≤–Ω–µ–Ω–Ω—è ¬´–Ω–∞ –¥—Ä—ñ–º –≤–∞–Ω–Ω—É¬ª,4829,4829,-50000,-50000,980,0,0,3210663,False,0XK6-B2BT-KKM1-853H
RiWV9NPXxmPpqLhBVQ,1713090180,–ü–æ–ø–æ–≤–Ω–µ–Ω–Ω—è ¬´–ù–∞ –∫–∞–º–ø—É—Ç—î—Ä –¥–ª—è –≥—Ç–∞6¬ª,4829,4829,-23291,-23291,980,0,0,3260663,False
DNLH6W1Be3vDuWGP2_Pw,1713048607,Bolt Food,4215,4215,-4073,-4073,980,0,0,3283954,True
mfqBm0PW6buu1-09XTeCze4h-pA,1713048607,–°–∫–∞—Å—É–≤–∞–Ω–Ω—è. Bolt Food,4215,4215,5000,5000,980,0,0,3288027,False
Y_d7i2FZWi9TtvYavQ,1713030701,Food Spot,5812,5812,-85700,-85700,980,0,0,3283027,False,CC5X-9T05-2A88-2H3K
W7Q6MNXazzlolxPlAA,1713026065,Apteka 14,5912,5912,-17200,-17200,980,0,0,3368727,False,172H-T958-998M-45EH
Ox-V-kFHe2HO1p7vrg,1713017857,5045Kavjarnja,5814,5814,-7000,-7000,980,0,0,3385927,False,TH9A-25T9-3M11-TCC3
gulRncwqC2RqAGjT_g,1713005593,La Fabrique,5814,5814,-8500,-8500,980,0,0,3392927,False,31EE-0HXC-M1X1-XX39
C5OyBxeyINU2nwkszw,1713005465,–¢–∞–±–∞–∫–µ—Ä–∫–∞,5993,5993,-27600,-27600,980,0,0,3401427,False,TP54-ATC8-2H40-XC5M
fyDcdea0d98Cy6ygig,1713005350,Novus,5411,5411,-61842,-61842,980,0,0,3429027,False,X767-B0PT-86PB-1XPT
SjmQBm5LX-ab5zf6yA,1713003418,–ê—Ä–Ω—ñ–∫–∞,5912,5912,-27490,-27490,980,0,0,3490869,False,A8E6-A432-3791-2A47
4W8HxAPPWmBuKnZBLQ,1713003149,APTEKA,5912,5912,-7980,-7980,980,0,0,3518359,False,KH44-4024-74X5-0E73
JbB7fIdPSrbjPzEPug,1713002118,Apteka AGP 76,5912,5912,-24570,-24570,980,0,0,3526339,False,X3E7-0AX3-1TH7-4MPX
IflLbrxNY2cuRNesQw,1712998023,–°–∫–∞—Å—É–≤–∞–Ω–Ω—è. WOG,5541,5541,5799,5799,980,0,0,3550909,False
_bCtcbs-iJ52c3dWbA,1712997904,WOG,5541,5541,-243558,-243558,980,0,0,3545110,False
Hwxk5o1mhBcndLFQOA,1712996866,APTEKA 45,5912,5912,-22470,-22470,980,0,0,3788668,False,090T-HX4K-6A49-HE55
9lHdseFd2MdVEx0t6w,1712992811,–ö–∞—Ñ–µ –ú–∞—Ä—ñ—è,5812,5812,-49000,-49000,980,0,0,3811138,False,EX2C-HH9T-9XAA-BXA9
l2MgVEy9_iSUNNbxZA,1712989655,Bolt Food,4215,4215,-16150,-16150,980,0,0,3860138,False,9EE6-X32A-H280-CB41
ApJg2MB3-uDQa0q6qA,1712950755,Varvar Bar | –ö–∏—ó–≤,5812,5812,-402400,-402400,980,0,0,3876288,False,CMT6-398B-P0E1-HB8M
HtF57LHotm48wZjLDw,1712938212,Bolt Food,4215,4215,-5000,-5000,980,0,0,4278688,False
1wvTCuPJ0dS9fJscUg,1712937404,–ö–æ–ª–æ,5411,5499,-9500,-9500,980,0,0,4283688,False,9M4H-648K-69EP-P291
BvASiqWkBVxWeCE5Lg,1712937108,–°—ñ–ª—å–ø–æ,5411,5411,-9600,-9600,980,0,0,4293188,False,E140-2X55-7E80-KHXP
tqmNPFJkh6wBXSqR6A,1712923977,Pethouse,5995,5995,-398100,-398100,980,0,0,4302788,False,B609-675K-48TH-27EB
D8aIkx9fvEvPROEw9A,1712909853,Bestwaytocup,5814,5814,-19500,-19500,980,0,0,4700888,False,774A-3KBP-P12C-58P6
YDknKTCxEEPXOo2rzQ,1712909307,–ê–ø—Ç–µ–∫–∞ ¬´–ë–∞–∂–∞—î–º–æ –∑–¥–æ—Ä–æ–≤'—è¬ª,5912,5399,-10330,-10330,980,0,0,4720388,False,X517-7532-3X47-2XB9
A0QDua9B16d5Ol4CHfcE,1712876323,Bolt Food,4215,4215,-2336,-2336,980,0,0,4730718,True
b4Ds0sFIJ0ZSZekWL16eor24tqk,1712876323,–°–∫–∞—Å—É–≤–∞–Ω–Ω—è. Bolt Food,4215,4215,5000,5000,980,0,0,4733054,False
F0wKNO0n9-xL_uwZow,1712836356,Konteiner,5814,5814,-23500,-23500,980,0,0,4728054,False,E6KA-3HPP-7T66-26EE
K-7-JxJ8k8YZUNrO_w,1712836111,–ö–æ–ª–æ,5411,5499,-32700,-32700,980,0,0,4751554,False,XAT1-4PT5-77A7-X1B1
uR1nUQsFqrZi1Q1Fcg,1712835890,–ö–ò–á–í–ì–ê–ó,5812,5812,-66000,-66000,980,0,0,4784254,False,T006-6MH1-98XE-B9CT
LMP71JuN8Ht5DljHrA,1712827311,–íi–¥: –ü–†–ò–•–û–î–¨–ö–û –ï.–í. –§–û–ü,"–î–ª—è –ø–æ–ø–æ–≤–Ω–µ–Ω–Ω—è –∫–∞—Ä—Ç–∫–∏ 5375414101190360, –ü—Ä–∏—Ö–æ–¥—å–∫–æ –ï—Ä–Ω–µ—Å—Ç –íi–∫—Ç–æ—Ä–æ–≤–∏—á, 3487403339",4829,4829,3400000,3400000,980,0,0,4850254,False
OqkbUdcsBrMjGB3H-g,1712819345,–ú—ñ—Å—å–∫–∞ –∫–∞–≤'—è—Ä–Ω—è,5812,5812,-22500,-22500,980,0,0,1450254,False,8P6K-3AMC-0KE6-BA2C
rr7qoifY8uhnz_lt9g,1712770608,Beerplace,5814,5814,-57500,-57500,980,0,0,1472754,False,C0M6-A2C2-T19C-25B7
SNapWdJr-5IUbau5Tw,1712768986,Bolt Food,4215,4215,-5000,-5000,980,0,0,1530254,False
R2-sPWHyVrBmuZWLiQ,1712768874,–ê–ø—Ç–µ–∫–∞ –ê–ù–¶,5912,5912,-26140,-26140,980,0,0,1535254,False,9037-MH2B-05HB-6807
Wx6dp48JqJeW7S37ZQ,1712758380,Apteka K185,5912,5912,-54600,-54600,980,0,0,1561394,False,01CA-AB7X-4TKE-4XB7
52oRvtr9ciyqhfPlYg,1712752625,Prostor,5977,5977,-6710,-6710,980,0,0,1615994,False,MMC8-EC0K-868X-M62T
vzRl-eM8OlVZjRtfZQ,1712739878,FDY*universum.clinic,8062,8062,-560000,-560000,980,0,0,1622704,False,89TX-73T7-7CK0-4104
sP466woIKoSygQSItQ,1712733994,FOP Trenin MS,5814,5814,-16300,-16300,980,0,0,2182704,False,0583-HB88-64P0-0CH7
Fd6j_Cbt_shnvO-i7mbr,1712703776,Bolt Food,4215,4215,-2941,-2941,980,0,0,2199004,True
1JwL8EoAcrSSqTbG1rTL,1712703776,Bolt Food,4215,4215,-2599,-2599,980,0,0,2201945,True
OEPY-rRyzT1aXL_PdlX2z4GSv24,1712703776,–°–∫–∞—Å—É–≤–∞–Ω–Ω—è. Bolt Food,4215,4215,5000,5000,980,0,0,2204544,False
3NOl0all-EK4iFgFCJUWXxxq9Uk,1712703776,–°–∫–∞—Å—É–≤–∞–Ω–Ω—è. Bolt Food,4215,4215,5000,5000,980,0,0,2199544,False
k4Ebrif6JyBbw1ZxZA,1712681975,Prostor,5977,5977,-4790,-4790,980,0,0,2194544,False,K12H-B4B4-HC26-5431
HbHozswamzMgUgsirA,1712681429,Lesya,4829,4829,-200000,-200000,980,0,0,2199334,False,XPTM-BT06-B68P-1605
UkqRa2e7s3_VmSUNGw,1712678395,Novapay,8999,8999,-10500,-10500,980,0,0,2399334,False,EBTH-0M16-5610-295E
hzoXeAQyw5d5xQ3qqg,1712678335,Fotovramci,5946,5946,-20000,-20000,980,0,0,2409834,False,KCP0-7E14-ABKK-H932
7PDBvhyOazWg8PD-mQ,1712667467,–ö–æ–ª–æ,5411,5499,-28900,-28900,980,0,0,2429834,False,M905-6EHT-7XH6-A994
scZ6Dcq8UvJSkNZgKQ,1712667239,–ü–∏—Ä—ñ–∂–∫–æ–≤–∞ ¬´–¢—ñ—Ç–∫–∞ –ö–ª–∞—Ä–∞¬ª,5814,5814,-35200,-35200,980,0,0,2458734,False,XXE0-CXP9-9AE1-59A3
_EAdPVv6rtX8-RXTuQ,1712667055,–ü–µ—Ä–µ–∫–∞–∑ –Ω–∞ –∫–∞—Ä—Ç–∫—É,4829,4829,-800000,-800000,980,0,0,2493934,False
dP19hsakKWIXlM4QPg,1712666947,REBORN,5399,5399,-140000,-140000,980,0,0,3293934,False,M5TC-CTMA-2384-BA9B
bLNUUBjvQxvFDjij8A,1712650198,–ü–æ–ø–æ–≤–Ω–µ–Ω–Ω—è ¬´–ù–∞ –ú–∞—à–∏–Ω—É(–±—É—Å)¬ª,4829,4829,-100000,-100000,980,0,0,3433934,False,E34A-M930-3TAH-9T21
Sv6L20vlyK-FdvMzzg,1712650152,–ü–æ–ø–æ–≤–Ω–µ–Ω–Ω—è ¬´–ù–∞ –†–ï–ë –¥–ª—è 138 –û–ë–¢–†–û¬ª,4829,4829,-100000,-100000,980,0,0,3533934,False,5KMB-M84B-22H5-7EM7
RMnRu4pOOvaDlKPK8w,1712642590,–ó–æ–æ–º–∞–≥–∞–∑–∏–Ω,5995,5995,-11880,-11880,980,0,0,3633934,False,98AM-H98B-60KP-71PE
qAt0B5aqoK_YuVGtiQ,1712595984,–°—ñ–ª—å–ø–æ,5411,5411,-17300,-17300,980,0,0,3645814,False,EK3X-270K-1EXH-9BM3
Nki6EGvBnZannuPUfA,1712595679,–ó–æ–æ–º–∞–≥–∞–∑–∏–Ω –õ—é–±–∏–º—ã–π,5995,5995,-28000,-28000,980,0,0,3663114,False,19K5-1M16-C49M-X73A
mM7NJn1UAfNckDFbjQ,1712589104,–ü–æ–ø–æ–≤–Ω–µ–Ω–Ω—è ¬´–Ω–∞ –¥—Ä—ñ–º –≤–∞–Ω–Ω—É¬ª,4829,4829,-25000,-25000,980,0,0,3691114,False,47B4-BPXC-MBA6-CA6A
MLNiVnKPo03vR8UWfg,1712589073,–ü–æ–ø–æ–≤–Ω–µ–Ω–Ω—è ¬´–ù–∞ –∫–∞–º–ø—É—Ç—î—Ä –¥–ª—è –≥—Ç–∞6¬ª,4829,4829,-12345,-12345,980,0,0,3716114,False
mHOcBaJCACKyWj4zgA,1712585133,–ö–æ–ª–æ,5411,5499,-2700,-2700,980,0,0,3728459,False,HXHH-CC04-453C-XXHX
BXsmaf0oZ49Osy_vjQ,1712584963,–ö–ò–á–í–ì–ê–ó,5812,5812,-31900,-31900,980,0,0,3731159,False,2355-1012-3B87-T627
KvsAQcCCtcrry-VPfQ,1712573304,–ö–æ–ª–æ,5411,5499,-2700,-2700,980,0,0,3763059,False,4XE3-M2KK-18EE-3311
VRssng-0M5443iC3vg,1712573151,–ö–ò–á–í–ì–ê–ó,5812,5812,-38000,-38000,980,0,0,3765759,False,0CXH-25HB-8C9P-5303
ljI4m3gjUxjpukKc1w,1712571609,–íi–¥: –ü–†–ò–•–û–î–¨–ö–û –ï.–í. –§–û–ü,"–î–ª—è –ø–æ–ø–æ–≤–Ω–µ–Ω–Ω—è –∫–∞—Ä—Ç–∫–∏ 5375414101190360, –ü—Ä–∏—Ö–æ–¥—å–∫–æ –ï—Ä–Ω–µ—Å—Ç –íi–∫—Ç–æ—Ä–æ–≤–∏—á, 3487403339",4829,4829,3600000,3600000,980,0,0,3803759,False
a8krXcHzsYKFAApQEA,1712570387,"Lifecell
+380631692598",4814,4814,-26000,-26000,980,0,0,203759,False,4P7E-KMEB-2994-C0KP
gTVaPNkajHUYoe8q6w,1712564482,Bolt Food,4215,4215,-5000,-5000,980,0,0,229759,False
jmRstCGD9HFK47j_Og,1712564107,Apteka K185,5912,5912,-27870,-27870,980,0,0,234759,False,PE57-T1C1-EM30-6238
JT190ki16rU0stdLYg,1712563766,Bolt Food,4215,4215,-5000,-5000,980,0,0,262629,False
njCLF40ONNTUcvTLHA,1712563690,–ö–æ–ª–æ,5411,5499,-19000,-19000,980,0,0,267629,False,752M-2TEP-3558-CMTP
mB4E13HkX2Gw1_sVXA,1712563611,–ê–ø—Ç–µ–∫–∞ ¬´–ë–∞–∂–∞—î–º–æ –∑–¥–æ—Ä–æ–≤'—è¬ª,5912,5399,-74231,-74231,980,0,0,286629,False,BH1C-THBM-M2C6-75EX
8kv1R8TBDURsJ5djJg,1712563589,–ü—Ä–∏–≤–∞—Ç24: Ernest Prykhodko,6536,6536,250000,250000,980,0,0,360860,False
P1adfDXdi2PCrPw46g,1712563552,–ê–ø—Ç–µ–∫–∞ ¬´–ë–∞–∂–∞—î–º–æ –∑–¥–æ—Ä–æ–≤'—è¬ª,5912,5399,-91711,-91711,980,0,0,110860,False,93K9-C43P-9PM7-HMP6
-YnOHu2dSzEhzeTCWg,1712557660,La Fabrique,5814,5814,-16000,-16000,980,0,0,202571,False,660A-K460-MPMM-44EH
byfsoETGe7iMtWd0og,1712557516,Bestwaytocup,5814,5814,-45600,-45600,980,0,0,218571,False,6751-7KE3-8HP4-030T
VFbKwSpJ5BYfss75SA,1712495409,–ï–ø—ñ—Ü–µ–Ω—Ç—Ä,5200,5200,-152812,-152812,980,0,0,264171,False,HC91-B257-2P2P-3578
61YnnT4F9U20RuvsRA,1712491925,magazin776848,5912,5912,-14088,-14088,980,0,0,416983,False,0EK8-83MT-7563-M3X5
5Rhw40zm-0s6Fksy-g,1712491886,magazin776848,5912,5912,-22453,-22453,980,0,0,431071,False,5A28-BB9C-AEX5-7TP4
xI35GdTpOjOsPMUV6A,1712484078,–û—Ñ—ñ—Å-—á–∞–π,5812,5812,-33600,-33600,980,0,0,453524,False,6KPA-KET7-02HB-271B
M5qzSRh2FL7B2ZrAYA,1712415363,–ö–æ–ª–æ,5411,5499,-23300,-23300,980,0,0,487124,False,MPHA-1BCM-183T-46TP
5gRMfEfZe4uJmWq8qA,1712414063,–ê–ø—Ç–µ–∫–∞ –ê–ù–¶,5912,5912,-2670,-2670,980,0,0,510424,False,4676-BX02-P7H8-XTM5
HoAs7AUvT5LuQXWy_g,1712408332,Goodwine,5411,5411,-154300,-154300,980,0,0,513094,False,0PB7-0595-P78H-H0X4
sGAn45cLaBqRjsawgg,1712395187,FK KONTRAKTOVYI DIM,7538,7538,-313600,-313600,980,0,0,667394,False,35P9-EM0E-EH6P-TMB4
Twjjgiaritfyx4XxAQ,1712390933,–ê–¢–ë,5411,5411,-6070,-6070,980,0,0,980994,False,M29X-EB9A-9HA0-0287
uS58kPysTJqfQHUrBw,1712388611,ZOOLIUKS,5995,5995,-15000,-15000,980,0,0,987064,False,230H-6208-E495-1C54
EigPAVrxlLySQGYLEQ,1712388449,–ó–æ–æ–º–∞–≥–∞–∑–∏–Ω,5995,5995,-11880,-11880,980,0,0,1002064,False,A0TB-99BA-AK58-E5PH
GBXaWaNs7rn2RV9V2g,1712347638,LIQPAY*ZL Vet,742,742,-80000,-80000,980,0,0,1013944,False,8MT9-6PE0-17T6-BX36
dqwnuJS5YiohJ-qqEQ,1712340073,–ó–æ–æ–º–∞–≥–∞–∑–∏–Ω,5995,5995,-10200,-10200,980,0,0,1093944,False,9K11-5T74-CHA2-87P1
bDJIS2WFLhG9dvbZNA,1712333111,–§–ö –ï–í–û,5399,5399,-26900,-26900,980,0,0,1104144,False,HH7E-6A80-0EC1-76P1
u5m7EyF23YFdfY7Z4g,1712333022,MasterZoo,5995,5995,-19800,-19800,980,0,0,1131044,False,X57T-PET4-CX5C-86T5
HXzCv2qsaeNRKZ22oA,1712309379,GERC UA APAY UTIL,4900,4900,-1034664,-1034664,980,0,0,1150844,False,M44C-800K-P69H-28AH
cgpcK4uZ7BiQ5ZM9Jw,1712300805,–ú—ñ—Å—å–∫–∞ –á–¥–∞–ª—å–Ω—è,5814,5814,-16000,-16000,980,0,0,2185508,False,24A4-0E08-6TX9-BPTK
Elul67jX4SiPt4d_2A,1712300783,–ú—ñ—Å—å–∫–∞ –∫–∞–≤'—è—Ä–Ω—è,5814,5814,-6500,-6500,980,0,0,2201508,False,TX11-2H0B-KA59-2ME8
D2qdHuBOMzJ_AqO54w,1712300772,–ú—ñ—Å—å–∫–∞ –á–¥–∞–ª—å–Ω—è,5814,5814,-19000,-19000,980,0,0,2208008,False,XC0K-1P34-M8TA-2P79
44V9A3Bj2YVdLduEEA,1712299242,Bestwaytocup,5814,5814,-7500,-7500,980,0,0,2227008,False,XCH7-E918-KTPC-179X
lHpcdQZ0aHx9dB_U5A,1712264872,FDY*Merchandise,5399,5399,-59420,-59420,980,0,0,2234508,False,T72A-XE51-C98P-21TT
-euXLrwsERzF2o7Rew,1712254125,–ü–æ–ø–æ–≤–Ω–µ–Ω–Ω—è ¬´–Ω–∞ –¥—Ä—ñ–º –≤–∞–Ω–Ω—É¬ª,4829,4829,-100000,-100000,980,0,0,2293928,False,TK82-EC6H-P2XT-AMA2
-2Ltnw5deYnroDxl5g,1712251311,–°—ñ–ª—å–ø–æ,5411,5411,-85800,-85800,980,0,0,2393928,False,4M09-A74A-0C4A-M648
Qm0P6bRqSyBKXVKQWA,1712239490,–ü–æ–ø–æ–≤–Ω–µ–Ω–Ω—è ¬´–ù–∞ –∫–∞–º–ø—É—Ç—î—Ä –¥–ª—è –≥—Ç–∞6¬ª,4829,4829,-7455,-7455,980,0,0,2479728,False
Jw9bHaidT0FA4trl-w,1712235521,–ö–æ–ª–æ,5411,5499,-19050,-19050,980,0,0,2487183,False,CKA4-HHAT-3BM5-796H
xR0G7155psIGjGDqCA,1712235273,–ü–∏—Ä—ñ–∂–∫–æ–≤–∞ ¬´–¢—ñ—Ç–∫–∞ –ö–ª–∞—Ä–∞¬ª,5814,5814,-20700,-20700,980,0,0,2506233,False,5C5T-K6B4-1T9B-B62T
deLEgrqk9z2Klfk2Kw,1712216795,–íi–¥: –ü–†–ò–•–û–î–¨–ö–û –ï.–í. –§–û–ü,"–î–ª—è –ø–æ–ø–æ–≤–Ω–µ–Ω–Ω—è –∫–∞—Ä—Ç–∫–∏ 5375414101190360, –ü—Ä–∏—Ö–æ–¥—å–∫–æ –ï—Ä–Ω–µ—Å—Ç –íi–∫—Ç–æ—Ä–æ–≤–∏—á, 3487403339",4829,4829,2300000,2300000,980,0,0,2526933,False
_dq_34WTjCLgLS8PmA,1712211593,–ö–æ–ª–æ,5411,5499,-26500,-26500,980,0,0,226933,False,A002-310C-X5B7-7C84
aWJMgVP_fkeguPP3sg,1712165137,TOBAKKO-SERVIS,5499,5499,-28200,-28200,980,0,0,253433,False,0T9B-P0X4-BBTB-548B
1AV2-nEZdQMYVucgpA,1712160840,Kafe,5814,5814,-25295,-25295,980,0,0,281633,False,XA8B-CT22-M02E-4B0C
rafFt1VG0qVWhHCIKg,1712160415,–ü–µ—á–µ–Ω–∞ –∫–∞—Ä—Ç–æ–ø–ª—è,5814,5814,-21300,-21300,980,0,0,306928,False,0C5B-HMTE-7255-M7M0
rtFdtwfbz5w87KIffw,1712135471,ZooLux,742,742,-2100000,-2100000,980,0,10898,328228,False,8340-MB50-TP0C-T458
su3WOEefuM71AvUcTg,1712134049,Konteyner,5814,5814,-65500,-65500,980,0,0,2428228,False,BCAE-925P-K5E5-X2MA
LQj9zISEffLrDpz3og,1712131400,KavyarnyaPARAISO,5814,5814,-6500,-6500,980,0,0,2493728,False,X082-1B0E-8A53-M25E
mnxOA7_IEYbGC7AFMg,1712081093,–°—ñ–ª—å–ø–æ,5411,5411,-43000,-43000,980,0,0,2500228,False,4X24-7P1A-076B-2X56
6Dga4FfFpQF27G7Vww,1712045465,Bestwaytocup,5814,5814,-19500,-19500,980,0,0,2543228,False,1CXC-X5T9-C0T6-459K
-XOx56rEzL3cYcdxOA,1712045112,–ü—Ä–æ–¥—É–∫—Ç–∏,5499,5499,-19000,-19000,980,0,0,2562728,False,EA7M-94P2-AB4H-PC3P
IC6PCd4eue_66G0wLg,1711988845,–ê–ø—Ç–µ–∫–∞ –ê–ù–¶,5912,5912,-83600,-83600,980,0,1672,2581728,False,TPB2-XM4B-127C-4AM9
4g8abiHNo9RO7RHm6w,1711988714,Beerplace,5814,5814,-77000,-77000,980,0,0,2665328,False,X3B6-AMC0-X722-330H
NayKo3WPB9LNOT9O-g,1711987615,–ü–æ–ø–æ–≤–Ω–µ–Ω–Ω—è ¬´–ù–∞ –∫–∞–º–ø—É—Ç—î—Ä –¥–ª—è –≥—Ç–∞6¬ª,4829,4829,-31700,-31700,980,0,0,2742328,False
N85xERu8bbmZAF2uVQ,1711987595,–ü–æ–ø–æ–≤–Ω–µ–Ω–Ω—è ¬´–Ω–∞ –¥—Ä—ñ–º –≤–∞–Ω–Ω—É¬ª,4829,4829,-10100,-10100,980,0,0,2774028,False,2CM1-3P5M-821C-P2X5
y5kMLEb6R-z_3XWMlQ,1711987559,Lesya,4829,4829,-500000,-500000,980,0,0,2784128,False,X5EA-6182-A01C-PPTA
o0othlBtC2JdE2B3BQ,1711986808,FDY*RESTAURANTS,5814,5814,-112300,-112300,980,0,0,3284128,False,8TX5-3BTK-4M9K-5K5B
WsWmyqVRPQj66RdKYA,1711982678,–ü–æ–ø–æ–≤–Ω–µ–Ω–Ω—è FIT_STRETCH HUB,7997,7997,40000,40000,980,0,0,3396428,False
Rdx7i7mZSI3u3nGu-g,1711972565,–°–∫–∞—Å—É–≤–∞–Ω–Ω—è. Pethouse,5995,5995,374300,374300,980,0,-12570,3356428,False
uG-TbMXL87NrkPV_yQ,1711971809,Pethouse,5995,5995,-374300,-374300,980,0,12570,2982128,False
ddA-7PNQaUEg_Tknrw,1711971728,Pethouse,5995,5995,-374300,-374300,980,0,37430,3356428,False,T9H8-KTXC-CHBT-1T4P
UkIqx_O8jtES7zzy5Q,1711962769,–íi–¥: –ü–†–ò–•–û–î–¨–ö–û –ï.–í. –§–û–ü,"–î–ª—è –ø–æ–ø–æ–≤–Ω–µ–Ω–Ω—è –∫–∞—Ä—Ç–∫–∏ 5375414101190360, –ü—Ä–∏—Ö–æ–¥—å–∫–æ –ï—Ä–Ω–µ—Å—Ç –íi–∫—Ç–æ—Ä–æ–≤–∏—á, 3487403339",4829,4829,3700000,3700000,980,0,0,3730728,False
NkCVvtey-BI7P3kZQQ,1714378929,–ó —á–æ—Ä–Ω–æ—ó –∫–∞—Ä—Ç–∫–∏,4829,4829,400000,400000,980,0,0,906942,False
GHhh8MFS31bHDu2C2w,1714310238,–ü–µ—Ä–µ–∫–∞–∑ –Ω–∞ –∫–∞—Ä—Ç–∫—É,4829,4829,-300000,-300000,980,0,0,506942,False
lHpcdQl3Z3R3dR3d5Q,1714271134,–†–µ–≥—É–ª—è—Ä–Ω–µ –ø–æ–ø–æ–≤–Ω–µ–Ω–Ω—è ¬´–§–æ–Ω–¥ –ü–æ–≤–µ—Ä–Ω–∏—Å—å –∂–∏–≤–∏–º¬ª,4829,4829,-25000,-25000,980,0,0,806942,False,56P2-68PA-AK1C-7K5H
DtuhSBh90HvHZjkLXQ,1713881205,–ü–æ–ø–æ–≤–Ω–µ–Ω–Ω—è ¬´–ù–∞ –∫–∞–º–ø—É—Ç—î—Ä –¥–ª—è –≥—Ç–∞6¬ª,4829,4829,-7600,-7600,980,0,0,831942,False
jswzxPMBhZPAWN1bNw,1713881184,–ü–æ–ø–æ–≤–Ω–µ–Ω–Ω—è ¬´–Ω–∞ –¥—Ä—ñ–º –≤–∞–Ω–Ω—É¬ª,4829,4829,-10000,-10000,980,0,0,839542,False,HMBH-HCKP-E0E4-B8T1
SAXHGY3xfzV94XukrQ,1713798386,–ó —á–æ—Ä–Ω–æ—ó –∫–∞—Ä—Ç–∫–∏,4829,4829,400000,400000,980,0,0,849542,False
u4FnBeoOmp6HMOaLfg,1713719850,–ü–µ—Ä–µ–∫–∞–∑ –Ω–∞ –∫–∞—Ä—Ç–∫—É,4829,4829,-400000,-400000,980,0,0,449542,False
nNZtb7pJPHpT3nk9jA,1713666332,–†–µ–≥—É–ª—è—Ä–Ω–µ –ø–æ–ø–æ–≤–Ω–µ–Ω–Ω—è ¬´–§–æ–Ω–¥ –ü–æ–≤–µ—Ä–Ω–∏—Å—å –∂–∏–≤–∏–º¬ª,4829,4829,-25000,-25000,980,0,0,849542,False,PH0A-5M7E-08PE-7E73
xDlOAVg3xeFZirCHvQ,1713519859,–ü–æ–ø–æ–≤–Ω–µ–Ω–Ω—è ¬´–ù–∞ –∫–∞–º–ø—É—Ç—î—Ä –¥–ª—è –≥—Ç–∞6¬ª,4829,4829,-37519,-37519,980,0,0,874542,False
H5PI2aOfsxycHUBFbQ,1713519839,–ü–æ–ø–æ–≤–Ω–µ–Ω–Ω—è ¬´–Ω–∞ –¥—Ä—ñ–º –≤–∞–Ω–Ω—É¬ª,4829,4829,-50000,-50000,980,0,0,912061,False,B5K3-C2XA-T269-P4ET
pL943yyKx0nhsCRS1Q,1713519765,–ü–æ–ø–æ–≤–Ω–µ–Ω–Ω—è ¬´–°—Ç–∞–Ω—Ü—ñ—é –¥–ª—è 110 –û–ú–ë–†¬ª,4829,4829,-50000,-50000,980,0,0,962061,False,6M83-634T-2A7E-PP60
X0aB4rUrTemSiWZP5A,1713173228,Lesya,4829,4829,-300000,-300000,980,0,0,1012061,False,XPK8-45TM-X0T4-9AB7
S2gbQc3d8lv6m7HVDw,1713090216,–ó —á–æ—Ä–Ω–æ—ó –∫–∞—Ä—Ç–∫–∏,4829,4829,700000,700000,980,0,0,1312061,False
vT0PGpA4w4fVvVBKqg,1713061547,–†–µ–≥—É–ª—è—Ä–Ω–µ –ø–æ–ø–æ–≤–Ω–µ–Ω–Ω—è ¬´–§–æ–Ω–¥ –ü–æ–≤–µ—Ä–Ω–∏—Å—å –∂–∏–≤–∏–º¬ª,4829,4829,-25000,-25000,980,0,0,612061,False,9AE7-551T-43B0-KCKA
Kou4VZASMsGgrOjs-Q,1713012965,–í—ñ–¥: –û–ª–µ–∫—Å—ñ–π –•–∞–ª—è–≤–∫–∞,4829,4829,92000,92000,980,0,0,637061,False
l5cehiKkxTxCJjRbUw,1713002025,–í—ñ–¥: –ü–µ—Ç—Ä–æ –ú–µ–ª—å–Ω–∏–∫–æ–≤,4829,4829,92500,92500,980,0,0,545061,False
oT-UDVJ7EoRDQCifbQ,1712993631,–í—ñ–¥: –î–µ–Ω–∏—Å –ö–æ—Ç–æ–≤,4829,4829,100000,100000,980,0,0,452561,False
j9aR-Ob87ITKCpmyNg,1712769461,NUNU | –Ø—Ä–æ—Å–ª–∞–≤—ñ–≤ –í–∞–ª,5812,5812,-53900,-53900,980,0,0,352561,False,35HP-A2EC-T0KE-3511
pmN4Umh30PrFG72rCA,1712731347,Lesya,4829,4829,-400000,-400000,980,0,0,406461,False,82C9-642H-M200-0A5E
_fPjnSzujm94T3HhAQ,1712667055,–ó —á–æ—Ä–Ω–æ—ó –∫–∞—Ä—Ç–∫–∏,4829,4829,800000,800000,980,0,0,806461,False
ROsczHB2ViUS9tt56g,1717093726,–°—ñ–ª—å–ø–æ,5411,5411,-38699,-38699,980,0,290,335317,False,9781-39KT-MB24-9CBA
dhNJEBL_-7B85mHsdg,1717093545,–°—ñ–ª—å–ø–æ,5411,5411,-139200,-139200,980,0,1044,374016,False,5B60-PXK7-BMX9-0841
lCK42brm2OOdM1l98A,1717089476,Silpo,5411,5411,-38000,-38000,980,0,285,513216,False,A8MP-5X36-TECP-0721
kiTYj2FkdxP5rGVVMw,1717089038,Silpo,5411,5411,-30000,-30000,980,0,225,551216,False,00C6-7732-8B55-81TT
d0zfabO4nJ4LTMJYRg,1717088975,Silpo,5411,5411,-10000,-10000,980,0,75,581216,False,40H6-ATC1-8CE3-2CM6
4Ec2SeWBypMyd4vz3A,1717088790,Silpo,5411,5411,-12000,-12000,980,0,90,591216,False,E293-TP7M-KH9H-8KMP
lBMr_4FL3zyFOqTiVA,1717088214,Vidavnictvo,5942,5942,-119000,-119000,980,0,0,603216,False,H58C-25H4-XT8K-MA15
EfMco3vtFDLf_XpNfA,1717086261,MYSTETSK ARSENAL_MAG,7991,7991,-3000,-3000,980,0,0,722216,False,3626-MH15-K80T-H12M
UCprMuk_9sHsEHTuFw,1717084636,Bookua,5942,5942,-84700,-84700,980,0,0,725216,False,8A3T-0KMP-HE35-EATB
LbvM038e23F9Fwpyrw,1717069960,–ö–æ–ª–æ,5411,5499,-4500,-4500,980,0,33,809916,False,1B40-4C0P-2176-36M9
Q22TPlRjBSrDu0OB5g,1717069738,–ü–∏—Ä—ñ–∂–∫–æ–≤–∞ ¬´–¢—ñ—Ç–∫–∞ –ö–ª–∞—Ä–∞¬ª,5814,5814,-17500,-17500,980,0,0,814416,False,XT57-HM49-072T-95A4
4q0D6pEr9iivhek4Pw,1717054455,–°—ñ–ª—å–ø–æ,5411,5411,-318800,-318800,980,0,2391,831916,False,XXAH-K0XT-36E3-M76H
bOOedg50zoJhY9aaug,1717051440,MarketMagazinElektriki,5200,5200,-4300,-4300,980,0,0,1150716,False,P421-P2BX-KPX1-H031
szmYdO2CQlmugbX8FQ,1717051259,Uklon,4121,4121,-20000,-20000,980,0,0,1155016,False,CTB7-TH5H-P6BM-TBT8
v8qLOml9urKwbIufTA,1717049612,–°–∫–∞—Å—É–≤–∞–Ω–Ω—è. Uklon,4121,4121,15700,15700,980,0,0,1175016,False
_7bx0dUzF0yQZH1j6A,1717049532,Uklon,4121,4121,-15700,-15700,980,0,0,1159316,False
KjM1FJkq3CyoXHzgXw,1717009449,–Ñ–≤–≥–µ–Ω –ü.,4829,4829,-83200,-83200,980,3200,0,1175016,False,16CX-HH1H-45XM-P80M
0T67XfKFnvxqSdfyvw,1717007147,–°—ñ–ª—å–ø–æ,5411,5411,-3900,-3900,980,0,29,1258216,False,KMA3-045C-T0XA-3K0A
TxlLISgLq66eX3vMlg,1717004172,Prostor,5977,5977,-23700,-23700,980,0,177,1262116,False,ATT8-671X-X9C2-2854
bKonYvYDkFEXOfUPRg,1717001119,–ú—ñ—Å—å–∫–∞ –∫–∞–≤'—è—Ä–Ω—è,5812,5812,-6000,-6000,980,0,0,1285816,False,83PM-E98K-P5T5-666T
D-wgSHzQsIv50bOX8w,1717000541,–û—Ñ—ñ—Å-—á–∞–π,5812,5812,-30000,-30000,980,0,0,1291816,False,X89X-EKT3-4697-63AM
JpK90BjC8gbj0qwVTw,1717000114,–ú—ñ—Å—å–∫–∞ –á–¥–∞–ª—å–Ω—è,5814,5814,-34000,-34000,980,0,0,1321816,False,A476-879X-KA20-752T
fBKDEMi9SGC6CUyl2Q,1716973008,LIQPAY*Simona Ristoran,5812,5812,-18500,-18500,980,0,0,1355816,False,26EH-HX41-2253-EX8K
8qkYBT_RDN75JJEzWg,1716966952,–ù–æ–≤–∞ –ø–æ—à—Ç–∞,7399,7399,-16500,-16500,980,0,0,1374316,False,X7TM-X181-HB43-6PX2
K6eDUd2LWa65t68taA,1716964291,Novapay,8999,8999,-10500,-10500,980,0,0,1390816,False,HCE8-46X8-M614-XEH6
SHI4paEIpuAQ8IeHNA,1716964276,Novapay,8999,8999,-8000,-8000,980,0,0,1401316,False,M0A6-5466-EB4P-E8XX
BiMVX7nu7aizjSgf3w,1716964244,Novapay,8999,8999,-5000,-5000,980,0,0,1409316,False,72AB-48BK-TMBX-686P
ylj-NlkQpBU62WL_WQ,1716915569,20/2,5812,5812,-80500,-80500,980,0,0,1414316,False,4C70-632C-18CX-PB5A
xaROpYZVFjIkBH28Mw,1716904710,–ö–£–ó–Ø,4900,4900,-35000,-35000,980,0,0,1494816,False,9A72-9B70-A8XC-MXX1
G1_TGLVgN8u-LQwvDw,1716902471,Pethouse,5995,5995,-122300,-122300,980,0,0,1529816,False,T7CC-0TEB-K4KA-86B7
WrAjioRAfnpRQ48pLA,1716900499,LIQPAY*TOV Muzeo Tiket,7922,7922,-31500,-31500,980,0,0,1652116,False,8K90-X8B5-331P-C147
g6WQkpDmjnPibiAiHQ,1716896665,Georgian food,5814,5814,-28000,-28000,980,0,0,1683616,False,8849-K8A4-2A6C-TM4E
U32Qg3XGX9-c_Ffpxg,1716885884,REBORN,5399,5399,-147500,-147500,980,0,1106,1711616,False,E1B7-B5B3-TM79-4A21
lMnljdCtIUpYiBHz3g,1716877444,Urbanisty cafe,5812,5812,-20900,-20900,980,0,0,1859116,False,KEH2-XEX3-7E76-4X62
d38fq_04uakXLi2Sbw,1716877216,–°—ñ–ª—å–ø–æ,5411,5411,-68900,-68900,980,0,516,1880016,False,5M39-8923-9HMX-3ABB
q0Lkr6XIhNwv5WjXmQ,1716827216,Kafe Kaviarnia humans,5814,5814,-11000,-11000,980,0,0,1948916,False,C072-H007-K58B-ME8K
deH4uAQmp1orERRQIw,1716827028,Kafe Kaviarnia humans,5814,5814,-40000,-40000,980,0,0,1959916,False,X4P9-PKK4-M2XC-8KK6
h2OcVajk3OiOk9hxpQ,1716804741,–ö–æ–ª–æ,5411,5499,-6650,-6650,980,0,66,1999916,False,88B7-2A2H-P1M3-551P
8ULYkbaMWc7yzSg7kA,1716804333,Georgian food,5814,5814,-19000,-19000,980,0,0,2006566,False,K2P6-6HEA-3077-MXTC
BdMIZtSVHUADOTwQKg,1716800132,–ü–æ–ø–æ–≤–Ω–µ–Ω–Ω—è ¬´–Ω–∞ –¥—Ä—ñ–º –≤–∞–Ω–Ω—É¬ª,4829,4829,-10000,-10000,980,0,0,2025566,False,C6X7-H545-C1KH-1ET2
0uLDDvkTgKd-PYnVxw,1716800121,–ü–æ–ø–æ–≤–Ω–µ–Ω–Ω—è ¬´–ù–∞ –∫–∞–º–ø—É—Ç—î—Ä –¥–ª—è –≥—Ç–∞6¬ª,4829,4829,-10000,-10000,980,0,0,2035566,False
WpXhRIGuppXKnZTdBw,1716800102,–ü–µ—Ä–µ–∫–∞–∑ –Ω–∞ –∫–∞—Ä—Ç–∫—É,4829,4829,-150000,-150000,980,0,0,2045566,False
5zWOtYhny7B9PEJJrQ,1716796518,–íi–¥: –ü–†–ò–•–û–î–¨–ö–û –ï.–í. –§–û–ü,"–î–ª—è –ø–æ–ø–æ–≤–Ω–µ–Ω–Ω—è –∫–∞—Ä—Ç–∫–∏ 5375414101190360, –ü—Ä–∏—Ö–æ–¥—å–∫–æ –ï—Ä–Ω–µ—Å—Ç –íi–∫—Ç–æ—Ä–æ–≤–∏—á, 3487403339",4829,4829,1900000,1900000,980,0,0,2195566,False
FCEV78ZUCbawIoezhw,1716791454,Bestwaytocup,5814,5814,-21500,-21500,980,0,0,295566,False,T1HH-A6HA-M087-EHAT
iI65DmwbQGNo_q7PGjU,1716765462,Bolt,4121,4121,-5791,-5791,980,0,0,317066,True
eC_mjXzWXV7noaBdhyhUl4wZA-o,1716765462,–°–∫–∞—Å—É–≤–∞–Ω–Ω—è. Bolt,4121,4121,5000,5000,980,0,0,322857,False
b3IGZalQEvlVT1nelQ,1716721357,TOV AVANTA,5499,5499,-16936,-16936,980,0,127,317857,False,C5M3-7AE5-X53K-79CX
phLyf1cV6mWbma9bTA,1716718779,KHachapury ta vyno FOP,5812,5812,-9500,-9500,980,0,0,334793,False,33E2-EX4E-8M8M-T7P1
zelfHLScfcT6RMgMjQ,1716717547,WOG,5541,5541,-100000,-100000,980,0,0,344293,False,E6KC-6A8C-65X7-ABA3
cuisu6dgPh6nLGMEXg,1716710763,Novus,5411,5411,-11795,-11795,980,0,88,444293,False,51CT-57P8-KA21-66C0
Lw9TFKVPISt-iqLO3w,1716710423,–ù–æ–≤–∞ –ø–æ—à—Ç–∞,7399,7399,-13000,-13000,980,0,0,456088,False,2P0K-P39B-0P0X-C9H7
AAy89GU0HthIrnwfkg,1716709908,–ê–ø—Ç–µ–∫–∞ ¬´–ë–∞–∂–∞—î–º–æ –∑–¥–æ—Ä–æ–≤'—è¬ª,5912,5399,-58630,-58630,980,0,439,469088,False,H2M0-BEM2-0C2T-CHKB
FwZPq_hYsM1OsyNtdQ,1716660942,Novus,5411,5411,-1399,-1399,980,0,10,527718,False,1HBK-15PX-0762-CBXM
HGwJaX9RxoqpIv1mGA,1716660511,Bestwaytocup,5814,5814,-8000,-8000,980,0,0,529117,False,T41C-PC62-CB09-C1C3
THsZnAFPk7BMV6-jjA,1716659634,–°–∫–∞—Å—É–≤–∞–Ω–Ω—è. Bolt,4121,4121,745,5000,980,0,0,537117,False
BphOhljr145fH8JZcA,1716658960,Bolt,4121,4121,-5000,-5000,980,0,0,536372,False
iddNMR3DKxknGwQqJg,1716656839,–°—ñ–ª—å–ø–æ,5411,5411,-23996,-23996,980,0,179,541372,False,C180-3PKK-THTX-9MM6
tpgyGb2FddcyfWHwYw,1716656259,BurgerFarm,5814,5814,-12500,-12500,980,0,0,565368,False,CMPM-K2X2-3E1X-CE06
uabjG6Tp2uqNKOtM6Q,1716655091,Seizo,7230,7230,-110000,-110000,980,0,825,577868,False,8MHA-AT08-AKXH-4E11
qMRP2WueX1HyTh9BBw,1716654398,BurgerFarm,5814,5814,-9000,-9000,980,0,0,687868,False,C0KB-PB61-7A81-P079
aoc1VKJmzOA6oloGkA,1716653291,BurgerFarm,5814,5814,-7800,-7800,980,0,0,696868,False,898X-93E9-P54B-1A51
ALGoS3Z6RLl3bCNzzQ,1716651831,BurgerFarm,5814,5814,-42900,-42900,980,0,0,704668,False,70H5-89H3-PCT2-KC75
1gU42hjj2-b4KKi7Gg,1716650949,BurgerFarm,5814,5814,-5700,-5700,980,0,0,747568,False,330X-P38X-1KCP-HEEC
3aOJjOHLITwFJJGavw,1716649137,BurgerFarm,5814,5814,-6000,-6000,980,0,0,753268,False,51H1-11T7-8086-6CP5
4xFxqW7qmHbpE1pPfg,1716648310,Bolt,4121,4121,-5000,-5000,980,0,0,759268,False
fpS3tz3FZ6DnK_tagw,1716639911,Oberig,8099,8099,-98000,-98000,980,0,735,764268,False,XE63-PKC5-MPP6-72ME
x8Zdyw1eSijxdRbx5g,1716632379,–°–ü√â–õ–¨–¢–ê,5812,5812,-51300,-51300,980,0,0,862268,False,M1P8-0H9B-8HE4-3C7X
uMfclaTCqaocn5HE5Q,1716622679,Magazin Azur Zol,5399,5399,-7700,-7700,980,0,57,913568,False,0898-T3XE-M7M4-69HP
HrsVqth06xovt3lqjA,1716620405,Bestwaytocup,5814,5814,-8000,-8000,980,0,0,921268,False,1PMC-6HP2-KKM5-X8PT
nVDcZsNrwPrZzhWQKQ,1716574121,–°—ñ–ª—å–ø–æ,5411,5411,-35700,-35700,980,0,267,929268,False,36M7-7941-K08H-TEEP
APF2uNI2LxxhOU8VrQ,1716572996,–ö—ñ–Ω–æ–º–∞—Ä–∫–µ—Ç –ü–ª–∞–Ω–µ—Ç–∞ –ö—ñ–Ω–æ,7832,5411,-4000,-4000,980,0,0,964968,False,A65E-5ME9-X26H-40KE
yyfqk6-Koxtxb4tI3g,1716566236,–ö—ñ–Ω–æ–º–∞—Ä–∫–µ—Ç –ü–ª–∞–Ω–µ—Ç–∞ –ö—ñ–Ω–æ,7832,5411,-15900,-15900,980,0,0,968968,False,T47B-9A0H-3TB9-E1AH
ILxEyFNQdWpgfhSwyw,1716489638,–°—ñ–ª—å–ø–æ,5411,5411,-32400,-32400,980,0,243,984868,False,PHE8-22PA-53EP-MM9B
X9l666FxtPRf6WTMPQ,1716487242,Kafe ART KLER,5814,5814,-41001,-41001,980,0,0,1017268,False,PA8X-19T8-EB13-A5E0
sZ-g-M0cJ_K5se9MQA,1716487102,–ö–∞—Ñ–µ –£–º–∫–∞,5814,5814,-70000,-70000,980,0,0,1058269,False,80C3-9330-EA42-73X5
UKEJetpNQc9Fk2jgsg,1716445343,–°—ñ–ª—å–ø–æ,5411,5411,-66500,-66500,980,0,498,1128269,False,E3C8-13PB-MX6E-43B3
4h5OZ_ZFqFs0PLZuSw,1716397902,–ì–∞–≤—Ä–∏–∫,5995,5995,-100000,-100000,980,0,0,1194769,False,86X2-3244-A7A3-C109
n-g-29sLzuiWSKEJvQ,1716394060,–°—ñ–ª—å–ø–æ,5411,5411,-7100,-7100,980,0,53,1294769,False,1T00-C08C-P68A-8EPP
MLjAI7b5H832y1RDLw,1716393445,Kyiv Verhoglada 9a,5499,5499,-14100,-14100,980,0,105,1301869,False,028M-T752-T1TX-ATK8
SJIopKTwJQX93cdOjA,1716367834,WFP.GROCERY1,5499,5499,-56650,-56650,980,0,424,1315969,False,390E-008K-8KE9-8980
0593S3Z29j2QMUGHLQ,1716361572,Bestwaytocup,5814,5814,-24000,-24000,980,0,0,1372619,False,PB6B-1801-1M5E-31TC
hOgk0D4BqImq76h0sbolwA,1716334291,"–°–∫–∞—Å—É–≤–∞–Ω–Ω—è. LIQPAY*Pethouse,SIMYi KULZhENKA, 35,KIYiV,UA",5995,5995,285067,285067,980,0,0,1343159,True
RCkJHqpc3n3Bo2vegB8UDg,1716334291,"–°–∫–∞—Å—É–≤–∞–Ω–Ω—è. LIQPAY*Pethouse,SIMYi KULZhENKA, 35,KIYiV,UA",5995,5995,53460,53460,980,0,0,1396619,True
OOX278DQOMek_xUMfQ,1716222241,Ponchyk Boy | –û–ª–µ—Å—è –ì–æ–Ω—á–∞—Ä–∞,5812,5812,-28800,-28800,980,0,0,1058092,False,2C53-8CBT-BE2H-9B7T
bDqeWRVYWf-mDDDBjw,1716221660,WineTime,5921,5921,-14200,-14200,980,0,106,1086892,False,8H5A-P1CT-0412-4P7K
rRn05ye0g0yZhf0BOw,1716141284,–°—ñ–ª—å–ø–æ,5411,5411,-35300,-35300,980,0,264,1101092,False,AB7X-XPAK-2551-A864
Llx00NybBsNehBygnw,1716128567,Beerplace,5814,5814,-14000,-14000,980,0,0,1136392,False,3C74-H62K-PBXK-MABP
k9oIyy2Iai2mauLxag,1716128060,La Fabrique,5814,5814,-7000,-7000,980,0,0,1150392,False,E4AK-T99H-8K87-68MH
wCuNnGHfun9HMNht2g,1716125891,Bestwaytocup,5814,5814,-10000,-10000,980,0,0,1157392,False,893X-H66P-AE96-AK6B
Qn9b_7_8kOZhCCp2Ew,1716124645,–ö–ò–á–í–ì–ê–ó,5812,5812,-87500,-87500,980,0,0,1167392,False,E256-KK4P-3M68-KC53
aPneEd21rMNpNybDLA,1716109854,ULTRAMARKET,5411,5411,-101238,-101238,980,0,759,1254892,False,B3H0-1B21-2KC0-PKMM
lm9JakmxbqmCuqwgoQ,1716107838,OKKO,5541,5541,-19900,-19900,980,0,0,1356130,False,K4C5-223M-T94C-1APC
np2aO7pGAUqtZQA2Vg,1716105850,NUANCECOFFEE,5814,5814,-11500,-11500,980,0,0,1376030,False,841A-4B74-C0C6-ATHH
ksoB1QVMA3l4H4KtSw,1716103510,Pancakes,5814,5814,-49600,-49600,980,0,0,1387530,False,3MH1-4653-7X82-AM3K
EzR0v_WRj362K3Q86g,1716051162,KFC,5814,5812,-16000,-16000,980,0,0,1437130,False,48AM-40AC-0156-CH42
k7aOgnrHEX3MpyOJRA,1716031150,Novus,5411,5411,-22000,-22000,980,0,165,1453130,False,1405-5MCK-M29E-MMCX
eNJS9Ti87ucQ3788SA,1716030763,magazin 762597,5912,5912,-41060,-41060,980,0,307,1475130,False,PX0X-XP8X-35EA-C6P8
HgiTNniko1BH-ORrdw,1716030654,Prostor,5977,5977,-29410,-29410,980,0,220,1516190,False,1MMC-CK4A-MP4M-CE6E
tkc2SUiCHVGA7azL1A,1716029778,Food Spot,5812,5812,-99400,-99400,980,0,0,1545600,False,H60E-4ET7-6947-PTAC
DUIdDgWKSs-aj_Ef2A,1716025502,SENS NA KHRESHCHATYKU,5942,5942,-51000,-51000,980,0,0,1645000,False,8P5T-73T6-AE3B-T30X
lVlWz81Y4LdYLmr7NQ,1716023651,–°–µ–Ω—Å | –•—Ä–µ—â–∞—Ç–∏–∫,5812,5812,-22500,-22500,980,0,0,1696000,False,X9B2-5B69-32B0-E4C1
8woTMybaZHzulIpB4g,1715970955,Ori Bar,5812,5812,-52300,-52300,980,0,0,1718500,False,EET4-M0K7-5A83-T81E
Cstkb0ChhXHkvZ8LIQ,1715966775,–ü–∞—Ä–∫–æ–≤–∫–∞,7523,7523,-3000,-3000,980,0,0,1770800,False,K8TM-89PA-16TX-76TB
KGwkGIvtFmUnREXyJQ,1715966493,–°—ñ–ª—å–ø–æ,5411,5411,-67600,-67600,980,0,507,1773800,False,P70B-ETXC-4X3H-896X
ET8pKJ6_03_1B4FlXA,1715962260,–ü–ª–∞—Ç—ñ–∂ –ê–õ–õ–û,4829,4829,-1633300,-1633300,980,0,0,1841400,False
9vx1CREdVbMH5aFPgg,1715962088,–í—ñ–¥: –û–ª–µ—Å—è –°–∞—á–µ–Ω–∫–æ,–Ω–∞ –º–æ–±—ñ–ª—É,4829,4829,1500000,1500000,980,0,0,3474700,False
o8OViaNT9CmSfv2A5g,1715959549,Fotovramci,5946,5946,-20000,-20000,980,0,0,1974700,False,60XB-KKK7-E120-TEP6
nBymJLPwA4HyxD-Fxw,1715949931,–ü–∞—Ä–∫–æ–≤–∫–∞,7523,7523,-16000,-16000,980,0,0,1994700,False,22T2-75TP-EE56-KH7T
RboqpYbSJ-rdTPgmzA,1715948957,–ú–ê–ú–ê –ú–ê–ù–ê–ù–ê | –ü–†–û–†–Ü–ó–ù–ê,5812,5812,-102750,-102750,980,0,0,2010700,False,BTA0-T2P3-3309-AXTH
SoBUWFumhko0lBYNHw,1715945937,SALON KRASY BACKSTAGE,7230,7230,-10000,-10000,980,0,200,2113450,False,13C1-72A9-XEX4-A8E0
T3zcHpVIwFXiRGaafQ,1715945905,SALON KRASY BACKSTAGE,7230,7230,-80000,-80000,980,0,1600,2123450,False,XH05-B1B8-XPTH-24BP
le4IDShrG9meUbCLIA,1715939580,–ü–µ—Ä–µ–∫–∞–∑ –Ω–∞ –∫–∞—Ä—Ç–∫—É,4829,4829,-1200000,-1200000,980,0,0,2203450,False
ZbSpyidqGcTdXxOqCw,1715939529,–ü–æ–ø–æ–≤–Ω–µ–Ω–Ω—è ¬´–Ω–∞ –¥—Ä—ñ–º –≤–∞–Ω–Ω—É¬ª,4829,4829,-50000,-50000,980,0,0,3403450,False,4E15-3951-4073-0K3K
gJrTRAu9YFS3YbZsqw,1715939512,–ü–æ–ø–æ–≤–Ω–µ–Ω–Ω—è ¬´–ù–∞ –∫–∞–º–ø—É—Ç—î—Ä –¥–ª—è –≥—Ç–∞6¬ª,4829,4829,-48300,-48300,980,0,0,3453450,False
DIYKHZF5EpG6ZaKnFA,1715939181,–íi–¥: –ü–†–ò–•–û–î–¨–ö–û –ï.–í. –§–û–ü,"–î–ª—è –ø–æ–ø–æ–≤–Ω–µ–Ω–Ω—è –∫–∞—Ä—Ç–∫–∏ 5375414101190360, –ü—Ä–∏—Ö–æ–¥—å–∫–æ –ï—Ä–Ω–µ—Å—Ç –íi–∫—Ç–æ—Ä–æ–≤–∏—á, 3487403339",4829,4829,2700000,2700000,980,0,0,3501750,False
mgfV09wJD5xUK0Iw5Q,1715935818,–ü—É–±–ª—ñ—Ü–∏—Å—Ç,5812,5812,-67700,-67700,980,0,0,801750,False,0K3E-TA48-7BMC-KH5M
3nBC80Ts7gUsCtNIWA,1715879281,OK Wine,5411,5411,-12500,-12500,980,0,93,869450,False,PX01-9BHH-868B-5TK0
jOiffh_WcY614zvnrw,1715879230,OK Wine,5411,5411,-54800,-54800,980,0,411,881950,False,53X5-K353-M67P-PMHM
0BREbQOmumA3z5Ew8Q,1715876914,Restoran Chchko,5814,5814,-24000,-24000,980,0,0,936750,False,0M35-67H1-2PT8-E5X2
dBCW-kJOQq8ykKkJnA,1715876893,Restoran Chchko,5814,5814,-148000,-148000,980,0,0,960750,False,AEH4-3CCC-2697-5H99
fJ5WyLR8V32u5dwwsQ,1715872614,Magazin Azur Zol,5399,5399,-3700,-3700,980,0,27,1108750,False,2662-MHC8-742C-2823
mnGhia4P6lCfLfuRpg,1715857891,5045Kavjarnja,5814,5814,-12500,-12500,980,0,0,1112450,False,6KCC-XE19-8C9M-T6MM
1pzq5kUPhJJZ43pl2g,1715802534,GUDFOOD –í–¥–æ–º–∞,5812,5812,-352900,-352900,980,0,0,1124950,False,E5XT-9E2T-6B37-8CEB
ldOs7Er1CQXerJw9dQ,1715788256,V REBRO,5812,5812,-71000,-71000,980,0,0,1477850,False,21E0-B74X-BB08-7240
31GJlgeOSBXTDNB9Sw,1715788249,FOP AFANASIEV,5499,5499,-14500,-14500,980,0,108,1548850,False,XA9M-41EC-T8XC-TH49
3oBMdkiMdyQeVKL_Qg,1715781622,Post5_v2,7538,7538,-5000,-5000,980,0,0,1563350,False,7XMM-97M6-3T0X-P667
3ExsEHSGSZ6vYTp9jw,1715778362,OKKO,5541,5541,-39600,-39600,980,0,0,1568350,False,3TPA-ETT6-50A3-T5KM
XcJQrXi7UZShy6eVwg,1715777631,WOG,5541,5541,-27100,-27100,980,0,0,1607950,False,H9K6-5164-H6H6-33H2
7x6_uZqZdicNVkFWmQ,1715767550,Bestwaytocup,5814,5814,-17000,-17000,980,0,0,1635050,False,PKTX-5HTE-72P6-6X97
URctyyeASA1BmFZfrQ,1715676202,5045Kavjarnja,5814,5814,-5500,-5500,980,0,0,1652050,False,ETA6-73P8-22KE-KP5P
B7RHm4NKctSHQg4mUA,1715674460,–°—ñ–ª—å–ø–æ,5411,5411,-113045,-113045,980,0,847,1657550,False,X4TP-MP2E-E29T-80TT
JazBk_F1TZZdcUiN9w,1715660872,KIOSK RUCH S.A. 701977,5994,5994,-5559,-549,985,0,0,1770595,False,E50C-X072-3EP1-7M77
ytcIDav_EeSphm3ygw,1715660667,Rossmann,5977,5977,-30153,-2986,985,0,226,1776154,False,HK5B-HCHT-4C83-2H4K
ls0uVnAlcjRixQieDQ,1715660217,Goraco Polecam,5462,5462,-57066,-5653,985,0,427,1806307,False,AK45-1A05-8AXE-53AK
myxQKuvPIDO9B76Wdg,1715659409,Bolt,4121,4121,-15756,-1562,985,0,0,1863373,False,XA37-51M5-2X2C-9C0C
UktfVPFS5o6zhQ072A,1715633276,MOTEL ONE WARSAW CHOPI,7011,7011,-20195,-2000,985,0,0,1879129,False,TC33-P0B4-8EH6-32EH
jxvOFgpLm2X8bJFsyg,1715632441,MOTEL ONE WARSAW CHOPI,7011,7011,-384708,-9620,840,0,0,1899324,False,BTB9-7MM1-40T7-X808
ZdEIKa4J1hg9nBSjGQ,1715632265,MAREK ROJEWSKI,4121,4121,-59546,-5900,985,0,0,2284032,False,KX11-B7A4-KBX1-93K3
p44qVl8NGSwzH-3p9Q,1715607339,CARREFOUR CITY,5411,5411,-4309,-100,978,0,43,2343578,False,ATCM-X392-M742-M5TE
nF7y7tvVE2R6IpCBWA,1715605793,RATP,4111,4111,-50847,-1180,978,0,0,2347887,False,7B69-592K-TXMB-7CBP
R3x7hGL0Yr6MVHBT9A,1715604164,Pret a Manger,5814,5814,-24131,-560,978,0,0,2398734,False,4275-7155-H15B-EM3C
9Yb7Mpmawf8cLsTqnA,1715603185,–ü–µ—Ä–µ–∫–∞–∑ –Ω–∞ –∫–∞—Ä—Ç–∫—É,4829,4829,-800000,-800000,980,0,0,2422865,False
HGLJ-xEjYLlyDz_-xg,1715603174,Lesya,4829,4829,-400000,-400000,980,0,0,3222865,False,HT34-0C9C-E55C-XAPT
5rfhjV69cuRtOCMxWA,1715603135,QIQITHE,5814,5814,-23700,-550,978,0,0,3622865,False,30PA-C2T3-85T7-2XET
LZcaKzaQWS9PTQmNUg,1715597301,–ü–æ–ø–æ–≤–Ω–µ–Ω–Ω—è ¬´–ù–∞ –∫–∞–º–ø—É—Ç—î—Ä –¥–ª—è –≥—Ç–∞6¬ª,4829,4829,-78900,-78900,980,0,0,3646565,False
Wvad9Pp6kjYbGtXyOg,1715597288,–ü–æ–ø–æ–≤–Ω–µ–Ω–Ω—è ¬´–Ω–∞ –¥—Ä—ñ–º –≤–∞–Ω–Ω—É¬ª,4829,4829,-123400,-123400,980,0,0,3725465,False,M9XP-82X0-TBM8-90AX
3Is-hWBDnKTUavyX3A,1715595593,–íi–¥: –ü–†–ò–•–û–î–¨–ö–û –ï.–í. –§–û–ü,"–î–ª—è –ø–æ–ø–æ–≤–Ω–µ–Ω–Ω—è –∫–∞—Ä—Ç–∫–∏ 5375414101190360, –ü—Ä–∏—Ö–æ–¥—å–∫–æ –ï—Ä–Ω–µ—Å—Ç –íi–∫—Ç–æ—Ä–æ–≤–∏—á, 3487403339",4829,4829,3500000,3500000,980,0,0,3848865,False
uBkaWOzd71-syhpisw,1715590005,Sunday*Immersion Repub,5812,5812,-96480,-2239,978,0,0,348865,False,T24T-6BK2-57K3-X32B
8mMWziqztuAgtQqsgw,1715584861,Bestwaytocup,5814,5814,-16000,-16000,980,0,0,445345,False,7BB3-XCT0-CEXK-0P72
gMsel4PX_FixIDLF5g,1715535520,BOURGEOIS EDDY,7349,7349,-25854,-600,978,0,0,461345,False,9KT0-6HP9-983A-58M8
pwQARIJ7lF-Rcrr_rg,1715532059,CHENSTEINKERQUE,5331,5331,-25854,-600,978,0,193,487199,False,887B-889P-H0ET-97X3
9H4v0UBSxn15eKSrkA,1715529051,SQ *ARAKU FRANCE,5814,5814,-28009,-650,978,0,0,513053,False,T496-1093-5X8A-1BTP
S6SoNNeZtxvxCYrf6A,1715527651,OK Wine,5411,5411,-18200,-18200,980,0,136,541062,False,2A51-A6KP-BX14-10EP
czrFSQSC6oTrUfU0KQ,1715527541,Prostor,5977,5977,-8550,-8550,980,0,64,559262,False,PT15-C6TM-15PC-5B3B
tjKFcQbOxiZazLjSgw,1715520824,CARREFOUR CITY,5411,5411,-24217,-562,978,0,181,567812,False,K4KT-HX4H-669H-H4CH
Do7g7teLMFoQ4jDl0w,1715509826,Lindt  Spruengli Franc,5499,5499,-35765,-830,978,0,268,592029,False,KK6T-06AX-8E8M-94BT
qN1jJvtJ0_7_4nZHqw,1715500383,–ó –±—ñ–ª–æ—ó –∫–∞—Ä—Ç–∫–∏,4829,4829,250000,250000,980,0,0,627794,False
bWaes1tZZL_H7Is9Tw,1715500171,Bestwaytocup,5814,5814,-8000,-8000,980,0,0,377794,False,151A-THMB-P80C-75C4
UEW3V9wiOwsLpgmN0g,1715455701,Uklon,4121,4121,-2400,-2400,980,0,0,385794,False,47PE-T7XK-07AP-XE3H
vDSlIsB5e5wo2Ifzxw,1715449994,FRANPRIX,8999,8999,-67221,-1560,978,0,0,388194,False,7744-XCE9-5P9X-X1CB
gvBzzHThh4ETL8fa-g,1715449742,CHEZ MANON,5462,5462,-17236,-400,978,0,129,455415,False,H1M3-AMT5-BKK1-8PEH
2Lpin4cCrrOwpEjtMg,1715449652,BARRESTORANPABKRAFTCIP,5812,5812,-8000,-8000,980,0,0,472651,False,4E84-1PT8-7EP2-061T
PEADnieQJF0SQtEbmw,1715442418,Uklon,4121,4121,-24500,-24500,980,0,0,480651,False,4075-E2TT-AMKA-7MKH
ij2fs6cT4baaSUpD9A,1715441945,–ü–ª–∞—Ç—ñ–∂ svit-matrasiv.com.ua,4829,4829,-335700,-335700,980,0,0,505151,False
EChgTaoNTtgTcz90PQ,1715439568,Bolt,4121,4121,-16100,-16100,980,0,0,840851,False,CCMA-5PMA-8P6E-7HPE
6VmwbBHavtb9e7XqUg,1715437460,–ó –±—ñ–ª–æ—ó –∫–∞—Ä—Ç–∫–∏,4829,4829,800000,800000,980,0,0,856951,False
3u_oRINyunmC3SmI-Q,1715430671,Beerplace,5814,5814,-45500,-45500,980,0,0,56951,False,M485-C9KB-225B-5C71
MC7-5k6iUkdX8-w-xg,1715430662,–ó –±—ñ–ª–æ—ó –∫–∞—Ä—Ç–∫–∏,4829,4829,100000,100000,980,0,0,102451,False
Gu7zhtHnMOzzfhL7-A,1715429055,Bestwaytocup,5814,5814,-8000,-8000,980,0,0,2451,False,233T-2KB4-621C-B5M9
V3fyzZRIAJ0J-2opIQ,1715428198,MUJI FORUM DES HALLES,5311,5311,-55802,-1295,978,0,418,10451,False,4E7E-871X-59T4-X8K7
C7JfapfCN-dGVm0zjQ,1715426009,SMITH AND SON,5942,5942,-128840,-2990,978,0,0,66253,False,C1B4-6E2A-4CC6-BE3P
FYkSITcysgYxd0Flrw,1715420649,–°–∫–∞—Å—É–≤–∞–Ω–Ω—è. Bolt,4121,4121,1508,5000,980,0,0,195093,False
zpMc0S-_bbrnd355YA,1715420091,Bolt,4121,4121,-5000,-5000,980,0,0,193585,False
38BG66Hk7Y0y6U06jg,1715419738,CEH,7216,7216,-60000,-60000,980,0,0,198585,False,343E-6HE6-4E52-78EH
fGl8fM1I5F0JNNNRTg,1715417539,SHAKESPEARE AND,5942,5942,-155126,-3600,978,0,0,258585,False,3TCP-7X4T-7A9H-975X
dk3Y0RzlEJ9P1nF-bw,1715413775,ZOOLIUKS,5995,5995,-410000,-410000,980,0,0,413711,False,4KK0-KB9E-93EK-08C9
9V_0SMdjLG_JyHmYCA,1715413758,–ó –±—ñ–ª–æ—ó –∫–∞—Ä—Ç–∫–∏,4829,4829,400000,400000,980,0,0,823711,False
8v0uCEZHKupMAaFRNg,1715370477,–ó–æ–æ–º–∞–≥–∞–∑–∏–Ω,5995,5995,-42500,-42500,980,0,0,423711,False,4183-A297-TT86-E2TX
iYYhqzALJXAkcd90Fg,1715366616,CARREFOUR CITY,5411,5411,-20496,-475,978,0,153,466211,False,KB23-T119-HB0P-4B95
bYLYrb5-m5UIHYsUQw,1715361429,DENGO BONAPARTE,763,763,-85868,-1990,978,0,0,486707,False,6HPK-M0T9-K8AA-X6PA
wqYDbTuUIBhXlANh6g,1715357405,FLABELUS,5200,5200,-509169,-11800,978,0,0,572575,False,5B00-CAX6-CTKA-1C3A
KUlBLtjnrnhWJtDzag,1715354949,–ó –±—ñ–ª–æ—ó –∫–∞—Ä—Ç–∫–∏,4829,4829,500000,500000,980,0,0,1081744,False
Tpn4f5168bL4w81x4A,1715354071,IVS France,5499,5499,-9061,-210,978,0,67,581744,False,XTK4-AM84-32CC-7MX9
yuX7tsMEvfU47AloMg,1715343138,SC-NOVA,5814,5814,-30205,-700,978,0,0,590805,False,8B04-9MEK-01T9-CHB1
YNz1VFjdr2rTuOhBSQ,1715342249,SC-CARREFOUR,5411,5411,-2891,-67,978,0,21,621010,False,2PPC-H1PE-29T3-870B
sPwi6xCpRHbLGpw9Sw,1715267679,CHEZ JANOU,5812,5812,-363441,-8470,978,0,0,623901,False,X1CE-893P-AP6P-C3KX
6p5W_7Wq87O29KlTxA,1715241334,MIDORE,5462,5462,-48701,-1140,978,0,365,987342,False,8139-431C-211C-TEPB
9p6ZnHQ5Dy5atusi0Q,1715197432,SNCF,4112,4112,-100794,-2360,978,0,0,1036043,False,3KA0-74PC-3EA8-2C2M
J0dlBPkqt671d_JdBw,1715186789,RATP,4111,4111,-50397,-1180,978,0,0,1136837,False,1E24-T798-BC0P-40H7
nevraTTXrBs3GklVxg,1715186683,Starbucks,5814,5814,-16016,-375,978,0,0,1187234,False,T4C5-K3EE-3229-TEKM
WZldhQcHMQh67f1xUQ,1715181349,CHIPOTLE MEXICAN GRILL,5814,5814,-48902,-1145,978,0,0,1203250,False,H8TA-T6H3-PT61-913C
TyWDO5pEXiPtfngvgw,1715180135,LIBERTE,5462,5462,-7261,-170,978,0,54,1252152,False,H4KE-MC9P-KB21-5699
Xxhp1j0O-nJM_HVvQg,1715177299,SUN TEA,7399,7399,-27761,-650,978,0,0,1259413,False,EETT-27X2-B1EC-546K
d1LDNuZujAvDdgqQTg,1715174344,CART  ORLY,8641,8641,-278039,-6510,978,0,0,1287174,False,TPB9-920K-7B62-8XMP
gh4V1h0XIWfjleJMrg,1715161649,Heinemann Duty Free/Fi,5309,5309,-8542,-200,978,0,0,1565213,False,MB4E-T3KH-X1B8-38B4
yYGeXSl-AT047fsztA,1715154997,Berlin Tourismus,5947,5947,-18792,-440,978,0,0,1573755,False,2E2X-P1XP-B620-46MH
uvVjV8imzIz6Rc6nsg,1715149546,MOTEL ONE BERLIN HAUTP,7011,7011,-72179,-1690,978,0,0,1592547,False,661B-2H30-55MK-2C0K
kzeQrhFqlJ7eWM1v4w,1715107634,EDEKA,5411,5411,-16358,-383,978,0,122,1664726,False,MKK3-P98A-TMX1-8765
nOiuGkOv4ugMaJqusg,1715105198,iimori ramen,5812,5812,-83284,-1950,978,0,0,1681084,False,4CP0-75T6-P27K-8CTT
NqHL0fSq5fWnH9RYkw,1715098647,MOTEL ONE BERLIN HAUTP,7011,7011,-510149,-12818,840,0,0,1764368,False,K73P-6247-E034-120P
qYrDEl2_AdRGEKehaw,1715071477,–ü–µ—Ä–µ–∫–∞–∑ –Ω–∞ –∫–∞—Ä—Ç–∫—É,4829,4829,-600000,-600000,980,0,0,2274517,False
EzMjTImJgI_yUlsGIw,1715071419,–ü–æ–ø–æ–≤–Ω–µ–Ω–Ω—è ¬´–ù–∞ –∫–∞–º–ø—É—Ç—î—Ä –¥–ª—è –≥—Ç–∞6¬ª,4829,4829,-44444,-44444,980,0,0,2874517,False
KL9_u0avhEV6dF5QVg,1715071398,–ü–æ–ø–æ–≤–Ω–µ–Ω–Ω—è ¬´–Ω–∞ –¥—Ä—ñ–º –≤–∞–Ω–Ω—É¬ª,4829,4829,-80000,-80000,980,0,0,2918961,False,3XCC-41P0-T8BB-3931
RcrwhSJW6CoC9MvzqQ,1715071373,Lesya,4829,4829,-700000,-700000,980,0,0,2998961,False,784B-B6XC-4KE2-KKM8
utkW0dfj5rDaxenGiA,1715070875,–íi–¥: –ü–†–ò–•–û–î–¨–ö–û –ï.–í. –§–û–ü,"–î–ª—è –ø–æ–ø–æ–≤–Ω–µ–Ω–Ω—è –∫–∞—Ä—Ç–∫–∏ 5375414101190360, –ü—Ä–∏—Ö–æ–¥—å–∫–æ –ï—Ä–Ω–µ—Å—Ç –íi–∫—Ç–æ—Ä–æ–≤–∏—á, 3487403339",4829,4829,3300000,3300000,980,0,0,3698961,False
dIt93XKtSEQlzYhg5A,1715059606,KAMILA MASIEWICZ SASIE,5812,5812,-36913,-3700,985,0,0,398961,False,374H-C608-0X1B-2X8M
mq_acw_4nu-6pgpO9pTLWQ,1715036849,Bolt,4121,4121,-5278,-5278,980,0,0,435874,True
4y-9kZLYPJR2rx1I0zTrVA,1715036849,Bolt,4121,4121,-9600,-9600,980,0,0,441152,True
T22MM1OYriJ3HA4B1MJ9jkwlNw8,1715036849,–°–∫–∞—Å—É–≤–∞–Ω–Ω—è. Bolt,4121,4121,9100,9100,980,0,0,450752,False
Z5plK5o5jZJcelrhq9rpo9CWF4E,1715036849,–°–∫–∞—Å—É–≤–∞–Ω–Ω—è. Bolt,4121,4121,5000,5000,980,0,0,441652,False
y_PSMYotxhVz4sBxNQ,1715009919,SHOP.PZU.COM.UA,6300,6300,-46000,-46000,980,0,0,436652,False,C303-X5KT-M941-HXTA
Rbj4PRhJ8FJInbtb7g,1715006776,Novapay,8999,8999,-7500,-7500,980,0,0,482652,False,K5C6-C6EB-H2TB-BCMM
a8bU8z-tU4Kr3WUC7w,1714998382,REBORN,5399,5399,-147500,-147500,980,0,1106,490152,False,24B1-K751-78B6-986C
4vSWFuygnwHxcC-bbw,1714986940,Bolt,4121,4121,-5000,-5000,980,0,0,637652,False
JDAmdxuDLOZGRDciZA,1714984785,KAVIARNI,5814,5814,-17800,-17800,980,0,0,642652,False,C852-B42C-5KK6-57H2
bJwj7TIB92frtT8i7w,1714983629,Bolt,4121,4121,-9100,-9100,980,0,0,660452,False
-jw8yqS6e-gl22g2vA,1714980008,"Lifecell
+380631692598",4814,4814,-26000,-26000,980,0,0,669552,False,579C-52T0-KM8X-51C2
b5AEZe-510k6Evpnjw,1714916623,–ê–ø—Ç–µ–∫–∞ ¬´–ë–∞–∂–∞—î–º–æ –∑–¥–æ—Ä–æ–≤'—è¬ª,5912,5399,-20428,-20428,980,0,153,695552,False,3CA6-92M6-K5KH-0EK6
0uZcbmnsNdEToe1nBQ,1714916465,OK Wine,5411,5411,-3000,-3000,980,0,22,715980,False,E2T1-AMT3-AMA3-CPM3
S653NKueG8I9Ya96Wg,1714916301,Konteiner,5814,5814,-24000,-24000,980,0,0,718980,False,3HEM-KH7X-69MX-0BTB
Uh2uzx4sFa1OpbZFQQ,1714915896,EVA,5977,5977,-4977,-4977,980,0,37,742980,False,9469-A9TX-83K3-14AA
MFOK8uvmRVsEFtjlFg,1714915469,Coffeereligia,5812,5812,-11800,-11800,980,0,0,747957,False,99EC-3H95-4H41-HMEK
_BrkS__EMidVr7XgrQ,1714901261,–ê–ø—Ç–µ–∫–∞ ¬´–ë–∞–∂–∞—î–º–æ –∑–¥–æ—Ä–æ–≤'—è¬ª,5912,5399,-40666,-40666,980,0,304,759757,False,K8EA-6E4X-C456-K944
zQy2hzCe1M4EWqcONA,1714900930,–°—ñ–ª—å–ø–æ,5411,5411,-166800,-166800,980,0,1251,800423,False,2250-3A00-64EA-7P6B
21lWf5o0zVQygdyRtw,1714847188,Pethouse,5995,5995,-338700,-338700,980,0,0,967223,False,T8M9-4EX7-99C5-83XM
ue82le0wRGUipTiFRA,1714823885,–ü–∞—Ä–∫–æ–≤–∫–∞,7523,7523,-3000,-3000,980,0,0,1305923,False,8T15-CC73-0910-M81A
dDg8hMW3VL6p-C9w0Q,1714823499,KAVYaRNYaCOFEFI,5814,5814,-6000,-6000,980,0,0,1308923,False,56BM-A7E4-KM86-132P
h7Z72cLPcpMgR-8cTg,1714823415,–°—ñ–ª—å–ø–æ,5411,5411,-278246,-278246,980,0,2086,1314923,False,1CPE-TTXA-0795-92XA
y0sSjUOtpX5DZDzygA,1714822328,Giulia,5631,5631,-59900,-59900,980,0,0,1593169,False,T9PC-82XA-652C-2824
KPEnP5zMHeGeE0_33w,1714821962,VISA,4812,4812,-9900,-9900,980,0,0,1653069,False,PP7B-KTE9-C3H6-MH09
xwYKywIAW6m-cPZo4A,1714821782,EVA,5977,5977,-24900,-24900,980,0,186,1662969,False,709B-C6P6-57P5-XPCH
92wYLrgWpHnWYSiFlg,1714820223,–ù–æ–≤–∞ –ø–æ—à—Ç–∞,7399,7399,-10500,-10500,980,0,0,1687869,False,2EX9-7X9K-T4EX-8A3K
TIXwuX4HAJC2b5LJPQ,1714814612,Novapay,8999,8999,-6000,-6000,980,0,0,1698369,False,3E8P-H26E-4PBE-0EAC
Fdc6GImL0XdFwFKrUQ,1714814428,KvitkoviymagazinFlower,5992,5992,-92000,-92000,980,0,0,1704369,False,5T75-6XPE-AM22-259T
0McSvbbye_bRrkT7Gw,1714807125,GUDFOOD –í–¥–æ–º–∞,5812,5812,-252500,-252500,980,0,0,1796369,False,773H-PXXH-53K6-889E
L6qFQOWip29fjEiIUw,1714750030,–ù–æ–≤–∞ –ø–æ—à—Ç–∞,7399,7399,-6500,-6500,980,0,0,2048869,False,MAX9-86AA-X2EH-AE21
CrHVIlpVhZRk2lwthg,1714747819,PHotosalonMAN,7221,7221,-30000,-30000,980,0,0,2055369,False,8KTT-M6A3-X432-AP78
x84mqSUJxvduuai2pw,1714742645,–ö–æ–ª–æ,5411,5499,-36000,-36000,980,0,360,2085369,False,K9T1-7CE5-5069-09A6
JwaxFbArigYUMjUcuQ,1714741449,5045Kavjarnja,5814,5814,-14000,-14000,980,0,0,2121369,False,P7C2-B2M2-2K33-PBXX
SaUXK_azglpZ4Ky3wA,1714736076,magazin 726008,5912,5912,-30370,-30370,980,0,607,2135369,False,2C3H-BK14-K295-1XMK
5CvKC9HAIbe6R9C65g,1714735940,–°—ñ–ª—å–ø–æ,5411,5411,-197526,-197526,980,0,1975,2165739,False,1080-8XXC-T62H-5EX0
G7inFBNxixer--KfOw,1714734028,WFP.GROCERY1,5499,5499,-91520,-91520,980,0,915,2363265,False,270A-CP0K-6TH6-X792
MPOl5WwnQ_3qU_oATQ,1714728375,–ü–µ—Ä–µ–∫–∞–∑ –Ω–∞ –∫–∞—Ä—Ç–∫—É,4829,4829,-900000,-900000,980,0,0,2454785,False
JQcDddlpe0oQE8252g,1714728341,–ü–æ–ø–æ–≤–Ω–µ–Ω–Ω—è ¬´–ù–∞ –∫–∞–º–ø—É—Ç—î—Ä –¥–ª—è –≥—Ç–∞6¬ª,4829,4829,-21763,-21763,980,0,0,3354785,False
aF8Q1eUu-Mn8tIo-nw,1714728297,–ü–æ–ø–æ–≤–Ω–µ–Ω–Ω—è ¬´–Ω–∞ –¥—Ä—ñ–º –≤–∞–Ω–Ω—É¬ª,4829,4829,-100000,-100000,980,0,0,3376548,False,XT43-79T3-7MBH-CC67
XBlEBC3G7MpprTUQFA,1714726189,–íi–¥: –ü–†–ò–•–û–î–¨–ö–û –ï.–í. –§–û–ü,"–î–ª—è –ø–æ–ø–æ–≤–Ω–µ–Ω–Ω—è –∫–∞—Ä—Ç–∫–∏ 5375414101190360, –ü—Ä–∏—Ö–æ–¥—å–∫–æ –ï—Ä–Ω–µ—Å—Ç –íi–∫—Ç–æ—Ä–æ–≤–∏—á, 3487403339",4829,4829,3200000,3200000,980,0,0,3476548,False
JZz5N_V1MHKZRo2vxQ,1714721830,Bestwaytocup,5814,5814,-170100,-170100,980,0,0,276548,False,8C6X-B2PE-62HT-8ME4
iMCjNfBTU4RyyMk-SA,1714665582,Bestwaytocup,5814,5814,-12000,-12000,980,0,0,446648,False,01P2-E79B-XC21-26BC
tBjKa6qNBYxmLNV6Kw,1714665272,OK Wine,5411,5411,-36650,-36650,980,0,274,458648,False,7M6M-1H6E-2B0C-BTTH
PPPh1we9EPMgilb0hA,1714653333,Beerplace,5814,5814,-38000,-38000,980,0,0,495298,False,07HK-B2PP-3C8C-8279
WVJJ6QSLwOW4qmglSA,1714653035,Novus,5411,5411,-5798,-5798,980,0,43,533298,False,K034-1E5P-TPM2-PP62
lmsDYpwSbrRnrd8kEw,1714652615,magazin 762597,5912,5912,-87514,-87514,980,0,656,539096,False,K796-2B8K-4PB9-KABP
bo64ia2dkylimB9eYQ,1714651812,V REBRO,5812,5812,-102500,-102500,980,0,0,626610,False,90C8-XB58-2A30-P0CC
DVxG_8e3JmkQRNVafw,1714651380,–ê–ø—Ç–µ–∫–∞ –ê–ù–¶,5912,5912,-20160,-20160,980,0,151,729110,False,83BH-9A12-EE5M-5M05
u6501fX_JEt7nXqQ-Q,1714645024,–ö–∞—Ñ–µ –ú–∞—Ä—ñ—è,5812,5812,-116600,-116600,980,0,0,749270,False,A9HA-7ECE-PBB3-38ME
fZuvI_DPaCyF0c2aDA,1714634121,Zoomagazin,5995,5995,-100000,-100000,980,0,0,865870,False,7HAM-C1TM-MA03-2M3P
zIl5eznfr7v6vNrfEA,1714584182,–°—ñ–ª—å–ø–æ,5411,5411,-65200,-65200,980,0,0,965870,False,6T45-BK16-735K-7MK7
6NNA_etesByFHs4REg,1714577941,Socar,5541,5541,-317576,-317576,980,0,0,1031070,False,4AEB-6C6X-E8EH-92XM
zvPg59zdT3J1tquqoQ,1714562589,Bestwaytocup,5814,5814,-9000,-9000,980,0,0,1348646,False,6APA-58M6-2T87-TTT6
HLV9vGqiMq-DU2O9-g,1714561886,Food Spot,5812,5812,-70800,-70800,980,0,0,1357646,False,0C97-0X1P-7E23-ACMT
XGptzvHx-hfCc01uJA,1714559268,–ö–ò–á–í–ì–ê–ó,5812,5812,-17600,-17600,980,0,0,1428446,False,XH74-C2M7-T80T-M6A3
apeyf7eD6W9HBHJR4w,1716800102,–ó —á–æ—Ä–Ω–æ—ó –∫–∞—Ä—Ç–∫–∏,4829,4829,150000,150000,980,0,0,424842,False
GyvwRrB8EpaYNz3ZtQ,1716696706,–†–µ–≥—É–ª—è—Ä–Ω–µ –ø–æ–ø–æ–≤–Ω–µ–Ω–Ω—è ¬´–§–æ–Ω–¥ –ü–æ–≤–µ—Ä–Ω–∏—Å—å –∂–∏–≤–∏–º¬ª,4829,4829,-25000,-25000,980,0,0,274842,False,P59K-10PT-8XEM-H946
eiW05pNFIla21RKVgw,1716663074,–ü–æ–ø–æ–≤–Ω–µ–Ω–Ω—è ¬´–ü—Ä–æ—Ç–µ–∑ –Ω–æ–≥–∏ Genium X¬ª,4829,4829,-10000,-10000,980,0,0,299842,False,787B-085M-M8E2-5ACB
KkZb-xJkArbV7uWL8w,1716555863,–§–û–ü –ö–æ–Ω–¥—Ä–∞—Ç—é–∫ –Ø–Ω–∞ –Ñ–≤–≥–µ–Ω—ñ—ó–≤–Ω–∞,4829,4829,-934000,-934000,980,0,0,309842,False,7417-AAEB-BKE9-PTP3
gqnybObFBR3v0etVQw,1716548619,–í—ñ–¥: –û–ª–µ—Å—è –°–∞—á–µ–Ω–∫–æ,4829,4829,500000,500000,980,0,0,1243842,False
Lyybl3v7gGrb0xoa9Q,1716135458,–ü–æ–ø–æ–≤–Ω–µ–Ω–Ω—è ¬´–ù–∞ –†–ï–ë –¥–ª—è —Ç–∞—Ç–∞‚ù§Ô∏è¬ª,4829,4829,-300000,-300000,980,0,0,743842,False,8M5C-4X56-XCP1-XE09
00jbBzHz2_45JXwlnw,1716135446,Lesya,4829,4829,-300000,-300000,980,0,0,1043842,False,A7MH-T7AC-821X-27HK
RK_nDNnCMcqP4BQWbg,1716085567,–†–µ–≥—É–ª—è—Ä–Ω–µ –ø–æ–ø–æ–≤–Ω–µ–Ω–Ω—è ¬´–§–æ–Ω–¥ –ü–æ–≤–µ—Ä–Ω–∏—Å—å –∂–∏–≤–∏–º¬ª,4829,4829,-25000,-25000,980,0,0,1343842,False,6CTM-A400-6BTM-8TXT
ZFtzbWHgRLrs767qVw,1715939580,–ó —á–æ—Ä–Ω–æ—ó –∫–∞—Ä—Ç–∫–∏,4829,4829,1200000,1200000,980,0,0,1368842,False
66y4iQBZWIKsGEA40g,1715781541,Post5_v2,7538,7538,-10000,-10000,980,0,0,168842,False,HE95-5CT2-44CC-5E98
FTGSeHCLCJ6_zGIogQ,1715780591,Post5_v2,7538,7538,-20000,-20000,980,0,0,178842,False,5BB1-12AE-MBAM-3880
nX6pVVGMD3EsNLEDJg,1715780123,Post5_v2,7538,7538,-10000,-10000,980,0,0,198842,False,EM4E-PXC4-T8TH-2H6T
B5o7N3EMY8fUk4DifA,1715779678,Post5_v2,7538,7538,-10000,-10000,980,0,0,208842,False,CB56-1XK8-B7AP-75M7
yrjLziMFsAX5eK86mQ,1715679908,–õ—ñ–ª—ñ—è –ö.,4829,4829,-595500,-595500,980,0,0,218842,False,B810-C6P1-EK03-MB6B
x_EFvftdvQ_-N6EkmQ,1715603185,–ó —á–æ—Ä–Ω–æ—ó –∫–∞—Ä—Ç–∫–∏,4829,4829,800000,800000,980,0,0,814342,False
EBz1pUsQnxjXr-xcnQ,1715500419,–ü–æ–ø–æ–≤–Ω–µ–Ω–Ω—è ¬´–ù–∞ –∫–∞–º–ø—É—Ç—î—Ä –¥–ª—è –≥—Ç–∞6¬ª,4829,4829,-1400,-1400,980,0,0,14342,False
C76__xyNAKEurqUlXQ,1715500406,–ü–æ–ø–æ–≤–Ω–µ–Ω–Ω—è ¬´–Ω–∞ –¥—Ä—ñ–º –≤–∞–Ω–Ω—É¬ª,4829,4829,-1000,-1000,980,0,0,15742,False,C8A9-9P4T-MAB2-X54X
Wy41JYR5pfVDl19TzQ,1715500383,–ü–µ—Ä–µ–∫–∞–∑ –Ω–∞ –∫–∞—Ä—Ç–∫—É,4829,4829,-250000,-250000,980,0,0,16742,False
M8TIv1yNSEueldV0Og,1715480788,–†–µ–≥—É–ª—è—Ä–Ω–µ –ø–æ–ø–æ–≤–Ω–µ–Ω–Ω—è ¬´–§–æ–Ω–¥ –ü–æ–≤–µ—Ä–Ω–∏—Å—å –∂–∏–≤–∏–º¬ª,4829,4829,-25000,-25000,980,0,0,266742,False,31A5-90E4-68BK-C2XM
HklcgLoe5GwMQ3ZZOQ,1715437460,–ü–µ—Ä–µ–∫–∞–∑ –Ω–∞ –∫–∞—Ä—Ç–∫—É,4829,4829,-800000,-800000,980,0,0,291742,False
xejSELQtHpWfYuF8Iw,1715430661,–ü–µ—Ä–µ–∫–∞–∑ –Ω–∞ –∫–∞—Ä—Ç–∫—É,4829,4829,-100000,-100000,980,0,0,1091742,False
-yQ1GItaMK-UAI3LzA,1715427970,Food Spot,5812,5812,-90200,-90200,980,0,0,1191742,False,7024-HMX0-HMM0-EXC4
Mi2Oiqhu3V4qcv7rSQ,1715413758,–ü–µ—Ä–µ–∫–∞–∑ –Ω–∞ –∫–∞—Ä—Ç–∫—É,4829,4829,-400000,-400000,980,0,0,1281942,False
30qVh1dJVca1pv04MA,1715354949,–ü–µ—Ä–µ–∫–∞–∑ –Ω–∞ –∫–∞—Ä—Ç–∫—É,4829,4829,-500000,-500000,980,0,0,1681942,False
-J-RD6DJoOZFd93pPA,1715071477,–ó —á–æ—Ä–Ω–æ—ó –∫–∞—Ä—Ç–∫–∏,4829,4829,600000,600000,980,0,0,2181942,False
BNCH_KkLyBcc837Wag,1714875990,–†–µ–≥—É–ª—è—Ä–Ω–µ –ø–æ–ø–æ–≤–Ω–µ–Ω–Ω—è ¬´–§–æ–Ω–¥ –ü–æ–≤–µ—Ä–Ω–∏—Å—å –∂–∏–≤–∏–º¬ª,4829,4829,-25000,-25000,980,0,0,1581942,False,607P-KEX9-M93E-C9K8
B7cvRKv7UzAN2K9nqA,1714728375,–ó —á–æ—Ä–Ω–æ—ó –∫–∞—Ä—Ç–∫–∏,4829,4829,900000,900000,980,0,0,1606942,False
xBczyKrjryNvKFmQzg,1714548713,–õ—ñ–ª—ñ—è –ö.,4829,4829,-200000,-200000,980,0,0,706942,False,9712-2H5A-4P3T-K8PM
pNBafGGXWDnTyPHBKQ,1719684014,LIQPAY*ULIS tovari,5812,5812,-15000,-15000,980,0,0,1089264,False,P631-X392-KE6T-PKAC
6CDP9jzOS5Ut-rZivg,1719683745,Novapay,8999,8999,-2500,-2500,980,0,0,1104264,False,KTK3-6824-M410-9B45
2IgmSsnJheYQnuUMlw,1719642696,Sushi time,5814,5814,-13000,-13000,980,0,0,1106764,False,1EPM-TMXX-6B99-70T0
VxpHLDncrsdz0evgEw,1719590236,Novapay,8999,8999,-5800,-5800,980,0,0,1119764,False,7X8C-3EM2-6T26-KCX9
GlA-8s6uwaoIIwmTcw,1719574579,Novus,5411,5411,-50091,-50091,980,0,375,1125564,False,49CP-5EBT-3668-76KC
HZ8kiCKKQVZP1GRWqw,1719569401,Beerplace,5814,5814,-125500,-125500,980,0,0,1175655,False,91A9-6A7C-59XT-AP28
ZqwKInVCDQnfxMsvfw,1719569074,Apteka 34,5912,5912,-12360,-12360,980,0,0,1301155,False,X6AT-H63H-9B07-68EP
0OQPfSxxIs8KconBNA,1719568910,–íi–¥: –ü–†–ò–•–û–î–¨–ö–û –ï.–í. –§–û–ü,"–î–ª—è –ø–æ–ø–æ–≤–Ω–µ–Ω–Ω—è –∫–∞—Ä—Ç–∫–∏ 5375414101190360, –ü—Ä–∏—Ö–æ–¥—å–∫–æ –ï—Ä–Ω–µ—Å—Ç –íi–∫—Ç–æ—Ä–æ–≤–∏—á, 3487403339",4829,4829,1100000,1100000,980,0,0,1313515,False
cg1LfT8-7i02kYrGIQ,1719568717,FOP Shevchenko,5499,5499,-3800,-3800,980,0,28,213515,False,H08K-1BK8-4C22-XC93
3qHL_MAvoh9k_DJH1A,1719567753,–°—ñ–ª—å–ø–æ,5411,5411,-55500,-55500,980,0,416,217315,False,9A2M-EC06-KT19-E3HP
0Vhsnwqjn5URhuup-g,1719563404,–í–µ—Ç–µ—Ä–∏–Ω–∞—Ä–Ω–∞ –∞–ø—Ç–µ–∫–∞,742,742,-200000,-200000,980,0,0,272815,False,0KK3-76TX-5T01-EX60
2ExCC9tjCgXex2s1oA,1719555719,–ö–£–ó–Ø,4900,4900,-35000,-35000,980,0,0,472815,False,7K5M-KPXH-4K6K-PC9K
eefIR1hhcpREEUEuDw,1719555604,FOP Shevchenko,5499,5499,-16000,-16000,980,0,120,507815,False,8A7A-8ACB-4989-60CA
_EOZrId_8mA-w1FdBg,1719509544,Urbanistikafe,5812,5812,-18000,-18000,980,0,0,523815,False,2HC2-PT41-K71A-76P6
G1iyZZazmxqlcuWMFA,1719509334,–°—ñ–ª—å–ø–æ,5411,5411,-20500,-20500,980,0,153,541815,False,K376-87PB-A3XB-408T
rxZrEmICwikBYIB0Zw,1719496540,PlanD,8999,8999,-229000,-229000,980,0,0,562315,False,H8H0-BPPK-4MB4-3TB6
PB3NoNgaRq-0Dz6uGQ,1719492151,–ó –±—ñ–ª–æ—ó –∫–∞—Ä—Ç–∫–∏,4829,4829,500000,500000,980,0,0,791315,False
eygMkZhWBmBVjNXUyg,1719474205,–í–µ—Ç–µ—Ä–∏–Ω–∞—Ä–Ω–∞ –∞–ø—Ç–µ–∫–∞,742,742,-375000,-375000,980,0,0,291315,False,KM85-3255-350T-H8EC
0d591mmK-9m25Nb9oA,1719471039,Bestwaytocup,5814,5814,-10000,-10000,980,0,0,666315,False,CB72-1H83-430P-A2K1
glkX2vBCUFFF-ao_Fg,1719469680,–ó –±—ñ–ª–æ—ó –∫–∞—Ä—Ç–∫–∏,4829,4829,400000,400000,980,0,0,676315,False
rk4otH7cMaU0e2AVvg,1719421247,Konteiner,5814,5814,-90000,-90000,980,0,0,276315,False,8B85-C7A6-TAP0-KM3C
SF6i2shEKPJl0_0z0A,1719420508,–ó –±—ñ–ª–æ—ó –∫–∞—Ä—Ç–∫–∏,4829,4829,300000,300000,980,0,0,366315,False
jD9N_3EcDPUPjy0QXw,1719414612,–ù–æ–≤–∞ –ø–æ—à—Ç–∞,7399,7399,-11500,-11500,980,0,0,66315,False,X7E8-M190-EC6B-58HK
N-nQnPeyIHN1-ty48g,1719414552,–ù–æ–≤–∞ –ø–æ—à—Ç–∞,7399,7399,-6600,-6600,980,0,0,77815,False,5E1M-X0A0-5EHX-6930
juIiQjfOv0otwRgSiw,1719402331,WFP.GROCERY1,5499,5499,-70320,-70320,980,0,527,84415,False,PM1P-4MP0-KM36-0C70
t23WwnQg2NI1y4wdZQ,1719399052,–û–ª–µ—Å—è –°.,4829,4829,-100000,-100000,980,0,0,154735,False
HVCUU96ZzRtL6pITK8HjFQ,1719357103,Bolt,4121,7999,-1850,-1850,980,0,0,254735,True
Ybn4WD1Ld3EuzCOWBN57yxKefwU,1719357103,–°–∫–∞—Å—É–≤–∞–Ω–Ω—è. Bolt,4121,7999,5000,5000,980,0,0,256585,False
dKv6ElrfGHVlv5w7IA,1719316767,LIQPAY*Seizo,7230,7230,-20000,-20000,980,0,0,251585,False,04MH-P8KA-0C92-HXKH
tQnrRaOL3raHGpp95g,1719304542,Novapay,8999,8999,-10000,-10000,980,0,0,271585,False,MMK7-9C7H-K0P0-8A29
ZKcWhHE5MCVCL2j-8w,1719300464,Bestwaytocup,5814,5814,-30000,-30000,980,0,0,281585,False,CK67-52K9-BE30-549X
IDrIcvoykP062ui3Ag,1719249000,5045Kavjarnja,5814,5814,-8000,-8000,980,0,0,311585,False,HMTB-7M5B-9X3P-64K8
yAT_2okzEUO1gi1TwA,1719246169,Pethouse,5995,5995,-334400,-334400,980,0,0,319585,False,91T4-8MP2-AEPB-CT5T
acQ-_5JEORDG9lJUvA,1719236933,Bestwaytocup,5814,5814,-30000,-30000,980,0,0,653985,False,CAX4-H5C3-983P-2CMX
4XDTVshA1AOsq5f1uA,1719236691,Novus,5411,5411,-13597,-13597,980,0,101,683985,False,484M-AEHX-03A7-8HC7
uzokyfdja-aoD6J81g,1719234846,–£–∫—Ä–ø–æ—à—Ç–∞,9402,9402,-1000,-1000,980,0,0,697582,False,XP09-M5B6-TXA5-719A
y2o6ndlHMooB-SPSjA,1719232446,FayniLodi,5814,5814,-12000,-12000,980,0,0,698582,False,A4BM-C249-HMM2-7X8X
uyllhdKYpC-VX0hmOg,1719232031,JYSK,5200,5200,-59900,-59900,980,0,0,710582,False,5260-T8HX-14A7-C10H
mgKrHq4_qnLoHGNDpg,1719229938,LIQPAY*FOP Klimenko,5399,5399,-4000,-4000,980,0,30,770482,False,7BT9-T57C-9388-HPX3
-LP-wtWcdb5x8Em_-w,1719229935,LIQPAY*FOP Klimenko,5399,5399,-4000,-4000,980,0,30,774482,False,P1P3-TKK9-PAHE-A467
xs6GxSTv6wtA043qDA,1719229441,Kim Kimchi Korean BBQ | Retroville,5812,5812,-230308,-230308,980,0,0,778482,False,H98P-4K76-H62H-86X3
wfTkCQH54Yj6-TDn_A,1719220448,Barbershop,7230,7230,-70000,-70000,980,0,0,1008790,False,17XK-62CC-X710-XCH2
GtcQx0w2VCthkNfrdw,1719211510,Portmone,5942,5942,-120000,-120000,980,0,0,1078790,False,1P76-E53B-59BT-C853
xa61feIl2d-hbhGf6w,1719210762,–°—ñ–ª—å–ø–æ,5411,5411,-5998,-5998,980,0,44,1198790,False,5M55-17E8-519P-7TK9
0aNjrgbvO3pRF11LFw,1719210324,Bolt,4121,7999,-5000,-5000,980,0,0,1204788,False
NNYkdlA0QNXUKMaFsw,1719209820,Bestwaytocup,5814,5814,-16000,-16000,980,0,0,1209788,False,2MX0-K2TB-5E20-6K4M
RmXGoveATBeSk-WWXw,1719177851,"Lifecell
+380731983817",4814,4814,-10000,-10000,980,0,0,1225788,False,518M-521A-04PP-BBA5
k-JSi07eKZet_3HMqA,1719162643,KavyarnyaCafeBookUa,5812,5812,-21000,-21000,980,0,0,1235788,False,46K1-6BK8-14M4-5TH3
fVLf2c89yBKghanRxg,1719153272,–°—ñ–ª—å–ø–æ,5411,5411,-144700,-144700,980,0,1085,1256788,False,40A7-95AH-T9PC-27PT
JS2XwkQJSben5XNGVw,1719152135,–ö–æ–ª–æ,5411,5499,-8050,-8050,980,0,60,1401488,False,H6AM-ME14-BBKK-P3EA
ANN1ajEPlVCT4dW2Ng,1719148739,EasyPay,5411,5411,-294013,-294013,980,0,2205,1409538,False,M4A3-01AP-89H5-5MEH
3F-CbdVIJusvQS7Aow,1719128317,–ö–æ–ª–æ,5411,5499,-16050,-16050,980,0,120,1703551,False,56X5-H65B-K4B6-B87C
HnT9AHzfkQv81F8x8Q,1719076884,Novus,5411,5411,-21047,-21047,980,0,157,1719601,False,H47P-911C-3EEH-CME3
ko5ogTS4Kd3Z6YlJLA,1719075993,20/2,5812,5812,-137500,-137500,980,0,0,1740648,False,7X15-TB27-7MK0-B7AC
xmsuOSgHNHS2wIdmQQ,1719053051,NUNU | –Ø—Ä–æ—Å–ª–∞–≤—ñ–≤ –í–∞–ª,5812,5812,-20500,-20500,980,0,0,1878148,False,BPT7-K817-P3MC-CH73
gKbdxHjNt5ZbaTarRQ,1719044182,Bestwaytocup,5814,5814,-10000,-10000,980,0,0,1898648,False,PAE9-0T03-KK9A-0PKE
fGShvlf8sSf0xnV9Ug,1719041263,Oberig,8099,8099,-290500,-290500,980,0,0,1908648,False,XKT9-P4H5-BMAE-8M5P
alMvfzqSPuGOMptXMA,1718996055,–ü–µ—Ä–µ–∫–∞–∑ –Ω–∞ –∫–∞—Ä—Ç–∫—É,4829,4829,-300000,-300000,980,0,0,2199148,False
BXTKmaqGRT3AOjOoCw,1718996037,–ü–æ–ø–æ–≤–Ω–µ–Ω–Ω—è ¬´–ù–∞ –∫–∞–º–ø—É—Ç—î—Ä –¥–ª—è –≥—Ç–∞6¬ª,4829,4829,-50000,-50000,980,0,0,2499148,False
ZbaxGTC3Ysd5USryrg,1718996018,–ü–æ–ø–æ–≤–Ω–µ–Ω–Ω—è ¬´–Ω–∞ –¥—Ä—ñ–º –≤–∞–Ω–Ω—É¬ª,4829,4829,-111100,-111100,980,0,0,2549148,False,P96H-7KP9-4AC9-BCKE
dCM-mVkblxHafYj0Sw,1718995408,Vodafone,4814,4814,-20000,-20000,980,0,0,2660248,False,M3T1-5AC7-AACT-5931
K3wRfZhyWk6UNu5EWw,1718992243,OK Wine,5411,5411,-4800,-4800,980,0,48,2680248,False,5290-1KAM-KAHH-KA1T
y2d44v6cH07m9zNweg,1718990180,Bestwaytocup,5814,5814,-10000,-10000,980,0,0,2685048,False,C868-PHPP-8M28-21P7
ONtx5U_wLK7RcK6GJg,1718980172,FOP Trenin MS,5814,5814,-16000,-16000,980,0,0,2695048,False,1H5X-2HT8-805E-CMMH
uLXW4D_uC_SHnjykXg,1718962256,–íi–¥: –ü–†–ò–•–û–î–¨–ö–û –ï.–í. –§–û–ü,"–î–ª—è –ø–æ–ø–æ–≤–Ω–µ–Ω–Ω—è –∫–∞—Ä—Ç–∫–∏ 5375414101190360, –ü—Ä–∏—Ö–æ–¥—å–∫–æ –ï—Ä–Ω–µ—Å—Ç –íi–∫—Ç–æ—Ä–æ–≤–∏—á, 3487403339",4829,4829,2100000,2100000,980,0,0,2711048,False
F3X1QhwEAvh9j0XYFw,1718960944,Bolt,4121,4121,-14000,-14000,980,0,0,611048,False,4X2T-6AH8-TX44-MK4C
drmpz2bpF1FnbAZZ1g,1718956959,Bestwaytocup,5814,5814,-10000,-10000,980,0,0,625048,False,7452-92CB-X0A2-2CX1
qFozTn-twM3kK81h5A,1718955770,FOP Shevchenko,5499,5499,-8000,-8000,980,0,60,635048,False,6P8E-6X9C-EK54-BBA2
NS5B6XcUCsg1ysXpjg,1718912603,Novapay,8999,8999,-5500,-5500,980,0,0,643048,False,1945-MT9B-18BA-AEC3
cNkAEoCSf_gJcSPQ-Q,1718912545,Novapay,8999,8999,-7000,-7000,980,0,0,648548,False,1440-C3KH-ME45-E201
jv9fVP30iy1-TDOeMA,1718906504,LIQPAY*Food Spot Corp.,5812,5812,-97015,-97015,980,0,0,655548,False,E460-EHKX-6M0A-222M
Eh7SvggelrIPitWMag,1718906197,OK Wine,5411,5411,-19400,-19400,980,0,145,752563,False,KEXP-4EHK-A9B9-59X4
Eg1lc1xAtpGaJjbfnQ,1718892780,Rozetka,5399,5399,-31000,-31000,980,0,232,771963,False,8T02-XC79-C47A-3XBM
9nstdMZuvvTA8bU16g,1718815035,Bestwaytocup,5814,5814,-21000,-21000,980,0,0,802963,False,1A2H-A862-C5P8-ABXC
FwK2AQMyXbw0Q0xAAg,1718814358,OK Wine,5411,5411,-136100,-136100,980,0,1020,823963,False,A57X-EHEA-AEP7-PABM
HMzW6Mq834GAhNmZcA,1718813321,Novapay,8999,8999,-5625,-5625,980,0,0,960063,False,24CC-X9A5-XE56-HBX0
3O2CLg8q18qvve_FqQ,1718813202,Novus,5411,5411,-17595,-17595,980,0,131,965688,False,96K5-2M42-9MTK-3A8C
_-o7jHyWSVZzRYV0Yg,1718806251,Libd,5814,5814,-5500,-5500,980,0,0,983283,False,BT6M-864E-1CAB-6H0C
lqtbC7KKJMJTNPezeg,1718800824,LIQPAY*HitTrejd,5993,5993,-180000,-180000,980,0,0,988783,False,3450-1EM7-C0P9-7TCX
tfZp2sWJYRIRSYGM3w,1718783584,FOP Trenin MS,5814,5814,-8000,-8000,980,0,0,1168783,False,0P80-2603-A0KC-CEAE
QU-f_w6-Bg0XxOJDTA,1718739770,Portmone,7011,7011,-1588400,-1588400,980,0,0,1176783,False,AK4B-B1X4-0TK3-4TKT
AIz7-IZ92MsG_VKTww,1718737228,–í—ñ–¥: –Ü–≤–∞–Ω–Ω–∞ –ö–æ–≤–∞–ª—å,–î—è–∫—É—é üß°,4829,4829,825000,825000,980,0,0,2765183,False
Q-rYz0xqNbBFqYfAAA,1718729631,Bestwaytocup,5814,5814,-10000,-10000,980,0,0,1940183,False,T0EA-KEBM-39MM-3P03
VZkBPmw-wjvApzZ3aA,1718729486,La Fabrique,5814,5814,-13000,-13000,980,0,0,1950183,False,CEPK-B3P6-703X-88HM
S2aRaqDiTlJnxsws2g,1718729282,Novus,5411,5411,-34091,-34091,980,0,255,1963183,False,7535-7870-T10B-5XCT
TLvlhHftyNWDqJi0xA,1718728490,Prostor,5977,5977,-23320,-23320,980,0,0,1997274,False,T1T1-9B7A-8708-9M70
GDGwuBTrFKsPAdZeJg,1718698677,Bestwaytocup,5814,5814,-8000,-8000,980,0,0,2020594,False,6X9T-AA4P-T3E1-MM2X
_oF-PlwJpgoZkbq0nA,1718698490,Novus,5411,5411,-8147,-8147,980,0,81,2028594,False,22M5-KXM5-6E7T-0BH6
B8eRs81bMtPGmsp31g,1718698177,Novapay,8999,8999,-7000,-7000,980,0,0,2036741,False,5501-XPPK-8025-KMH3
aYRO_eGDgCHdIaU8KQ,1718698173,Novapay,8999,8999,-29400,-29400,980,0,0,2043741,False,7H9P-1E4A-AE0H-13K0
aRdChJJjORmFasGxsg,1718698154,–°–∫–∞—Å—É–≤–∞–Ω–Ω—è. Google,7399,7399,600,600,980,0,0,2073141,False
y_cwA2k9AkpDqncD5A,1718698153,Google,7399,7399,-600,-600,980,0,0,2072541,False
8Jd5IYOSjuEx-OvKFQ,1718637859,–°—ñ–ª—å–ø–æ,5411,5411,-2400,-2400,980,0,24,2073141,False,325X-AC35-08C6-204A
D6neYgpYPKb1DLc8Sw,1718615119,–ü–æ–ø–æ–≤–Ω–µ–Ω–Ω—è ¬´–ù–∞ –∫–∞–º–ø—É—Ç—î—Ä –¥–ª—è –≥—Ç–∞6¬ª,4829,4829,-32100,-32100,980,0,0,2075541,False
rAk9hx1ohMEu_oPNIw,1718615103,–ü–µ—Ä–µ–∫–∞–∑ –Ω–∞ –∫–∞—Ä—Ç–∫—É,4829,4829,-500000,-500000,980,0,0,2107641,False
wg3KmrMyFFT4ACg5wQ,1718610745,–íi–¥: –ü–†–ò–•–û–î–¨–ö–û –ï.–í. –§–û–ü,"–î–ª—è –ø–æ–ø–æ–≤–Ω–µ–Ω–Ω—è –∫–∞—Ä—Ç–∫–∏ 5375414101190360, –ü—Ä–∏—Ö–æ–¥—å–∫–æ –ï—Ä–Ω–µ—Å—Ç –íi–∫—Ç–æ—Ä–æ–≤–∏—á, 3487403339",4829,4829,3500000,3500000,980,0,0,2607641,False
aB3CjqynCXMteMZEEQ,1718605023,–ü–ª–∞—Ç—ñ–∂ –ê–õ–õ–û,4829,4829,-1633300,-1633300,980,0,0,-892359,False
Jgxz0B_JogoQcEsHZw,1718560259,–°—ñ–ª—å–ø–æ,5411,5411,-56437,-56437,980,0,423,740941,False,0110-6068-KE9B-M03H
JYWEIAkh1XU3G4oQ2w,1718559667,SECHST,5912,5912,-18205,-18205,980,0,0,797378,False,4BB4-5TC5-5604-C9T3
sshACzUJ8UZ2Hh52dw,1718543446,–°–∫–∞—Å—É–≤–∞–Ω–Ω—è. Uklon,4121,4121,25000,25000,980,0,0,815583,False
V3FdbrVFnlNstlIMfw,1718543072,–°–∫–∞—Å—É–≤–∞–Ω–Ω—è. Bolt,4121,4121,15700,15700,980,0,0,790583,False
rXN7Zf0Oz5YObzEt_w,1718543052,Uklon,4121,4121,-25000,-25000,980,0,0,774883,False
b5EzoVrdMXn93FPxzA,1718542901,Bolt,4121,4121,-15700,-15700,980,0,0,799883,False
JavoXoq5vDlwNmrSkQ,1718541308,–ö–∞–≤‚Äô—è—Ä–Ω—è ¬´–°–≤—ñ—Ç –∫–∞–≤–∏¬ª,5814,5814,-15000,-15000,980,0,0,815583,False,HXBB-6601-5C3P-3B78
LTkx63hVbPLoOfoYog,1718538282,Cheese Bakery | Galytska,5812,5812,-82000,-82000,980,0,0,830583,False,K7HK-A5AP-HKHM-H094
roiyW3VUU1LZh3WrKg,1718535877,KAFE KHALA,5814,5814,-9000,-9000,980,0,0,912583,False,54K6-K72P-1BCX-7T29
EkUV7Vg623faEqwv0g,1718527226,Konditerskarestoran,5814,5814,-51900,-51900,980,0,0,921583,False,E92X-CBM1-5HT7-H9EX
ReAXflIfulnaAYn7jw,1718524416,–†–µ—Å–ø—É–±–ª—ñ–∫–∞ –°–∞–¥—É,5812,5812,-31400,-31400,980,0,0,973483,False,8157-4E99-1MCB-CK23
kHsIYTai0Q1LA8_7OMIT,1718493452,Bolt,4121,7999,-3590,-3590,980,0,0,1004883,True
RZLjVa5yVhrjByjuCcPd7vPEQoM,1718493452,–°–∫–∞—Å—É–≤–∞–Ω–Ω—è. Bolt,4121,7999,5000,5000,980,0,0,1008473,False
Qy34KyFGrXBtSDbgIQ,1718476436,Kolos,5812,5812,-82400,-82400,980,0,0,1003473,False,528E-K2HK-1EX3-9X8H
cYJqRJkmYryJZA9JTA,1718461429,SHOP A SHOP FOP HOLETS,5631,5631,-19800,-19800,980,0,0,1085873,False,ME50-092E-8HAK-9614
LKGGjerSLvq_qm6qPA,1718460829,Rimejkstor,5977,5977,-33000,-33000,980,0,0,1105673,False,319C-PKHA-89KC-5K0K
nZC9KE-z-ZqvwII4Sg,1718457553,TOV FRESH HANDMADE COS,5977,5977,-46500,-46500,980,0,0,1138673,False,X3T6-KMXE-8E25-EHK2
T52GfImfCbeOEvLeIw,1718457027,GAME STAR,7999,7999,-10000,-10000,980,0,0,1185173,False,KB6E-692H-9PTC-4AB6
cUG8xiFu7bkfxKzwHQ,1718455138,–¢–æ–≤–∞—Ä–∏—Å—Ç–≤–æ —Ä–æ–∑–≤–∏—Ç–∫—É —ñ –ø—Ä–∏–∫—Ä–∞—à–∞–Ω–Ω—è –º—ñ—Å—Ç–∞,5812,5812,-28900,-28900,980,0,0,1195173,False,140C-TAP3-B773-6X5B
uVGaoccFD4Aro3IMOQ,1718451575,MAGAZYN KNYGY,5942,5942,-53500,-53500,980,0,0,1224073,False,6H23-945A-1116-K9HK
Em0I8-PiEnYTg9pP-Q,1718448628,EkoPasika,5499,5499,-6000,-6000,980,0,45,1277573,False,9339-9XB4-62X5-P056
lrNFDgUlekPf85gmVQ,1718443730,Novus,5411,5411,-7247,-7247,980,0,54,1283573,False,BH89-HBK8-H7TC-P941
6AR8-YEBbARMYsGHOA,1718442333,Bestwaytocup,5814,5814,-7000,-7000,980,0,0,1290820,False,833H-221X-EMT3-MP30
UepvYpqnakef8T5Jxw,1718442297,Alternativnakava,5814,5814,-10500,-10500,980,0,0,1297820,False,B6PM-6EHC-E712-5H23
XJemT9b29daDe2Y-Yw,1718441164,Bestwaytocup,5814,5814,-8000,-8000,980,0,0,1308320,False,31P0-TKAB-TE7X-EKT7
ATdiC7wStUW_6ZS6aA,1718436571,Cheese Bakery | Kivsh,5812,5812,-55600,-55600,980,0,0,1316320,False,PE5T-8EAH-X7PK-KMP9
9I29-GVylb3z2bRASw,1718432742,Bolt,4121,4121,-9900,-9900,980,0,0,1371920,False,2E3E-4M8K-8K6B-4B37
eAAuAJQMQ56dReCVLQ,1718393418,Konteyner,5814,5814,-42000,-42000,980,0,0,1381820,False,3H70-AE8M-4B8H-32T5
OpLHfYQcLMygmC62zA,1718389781,Milk Pub,5812,5812,-26000,-26000,980,0,0,1423820,False,4C1A-3M73-H85K-33KK
Hq6OdWVJraNSLoe9LA,1718388366,Restoran Mriinyky,5812,5812,-46000,-46000,980,0,0,1449820,False,K0E7-6AXE-3BK9-HE26
7p5bJhwu7GVCXgxPCA,1718388346,Restoran Mriinyky,5812,5812,-36500,-36500,980,0,0,1495820,False,299B-PAB0-2C34-CAPC
d6jxzHjFXKNW8cdZVw,1718388186,Konteyner,5814,5814,-10400,-10400,980,0,0,1532320,False,400K-421T-7H6A-9TMB
lM5BTHIgQ3y3Ku0R4Q,1718385434,Konteyner,5814,5814,-24400,-24400,980,0,0,1542720,False,06MP-BKH3-XPH3-1HTA
ECoRp9hOF-95wXv5FA,1718381925,–°—Ç–∞—Ä—ñ –ú—É—Ä–∏,5812,5812,-111300,-111300,980,0,0,1567120,False,ECHK-0E54-X7T1-1C0B
dgs2TH3J29IwGpZ7aA,1718381142,Konteyner,5814,5814,-8000,-8000,980,0,0,1678420,False,A0PK-1M2E-EX4P-CKH2
U8aIKa6i38Y1qoWRPA,1718380530,Bolt,4121,7999,-5000,-5000,980,0,0,1686420,False
ZLzdwndr5C0i8UYnfA,1718364256,Salon GBarlviv,7230,7230,-75000,-75000,980,0,0,1691420,False,BBCA-3MT2-TT72-6323
tlr5kSDIBhDj_4GFZA,1718358514,OnTheSquareGuesthouse,7011,7011,-397100,-397100,980,0,0,1766420,False,7P43-C650-BPCA-T548
tYWMVOD59Ch6LUY5Wg,1718355928,Bolt,4121,4121,-17900,-17900,980,0,0,2163520,False,P8KE-AP2E-7EMH-062B
f18xc-7LKICAS0g7Sw,1718351114,WFP.GROCERY1,5499,5499,-91920,-91920,980,0,919,2181420,False,8BE2-2KX4-1M59-9XAA
7Puu8TcQ1PRshAv5sA,1718351094,–°–∫–∞—Å—É–≤–∞–Ω–Ω—è. Google,7399,7399,600,600,980,0,0,2273340,False
DptFJf8_iyFDGswc3A,1718351092,Google,7399,7399,-600,-600,980,0,0,2272740,False
wl_2Vn0c3tV-MrtskQ,1718344558,–ù–æ–≤–∞ –ø–æ—à—Ç–∞,7399,7399,-5350,-5350,980,0,0,2273340,False,CP6C-EH10-7XP0-9093
PN00c-cRjUi9lA23_A,1718344537,–ù–æ–≤–∞ –ø–æ—à—Ç–∞,7399,6538,-73298,-73298,980,0,0,2278690,False,P8C0-4T1C-9MH8-MTT9
0k5BgdNkM_ZNP7aO1w,1718344109,Novapay,8999,8999,-5000,-5000,980,0,0,2351988,False,T9BT-8M5C-BETM-635M
u907H2EG5o3uYD10mA,1718344105,Novapay,8999,8999,-32498,-32498,980,0,0,2356988,False,8MC9-4X83-T7PE-E25E
OTTilOtX485LR2GsGw,1718343500,FOP Shevchenko,5499,5499,-2500,-2500,980,0,25,2389486,False,0T9K-P721-7617-3XPC
XAewYBCIOtJtnu5Thw,1718299255,–°—ñ–ª—å–ø–æ,5411,5411,-104969,-104969,980,0,1049,2391986,False,H0TE-95T2-T8TE-1KM3
DQNdzRYIAwg6I_DBwA,1718299112,–°—ñ–ª—å–ø–æ,5411,5411,-6999,-6999,980,0,69,2496955,False,48XP-T4K8-794P-90E8
Kue9qg5HxlIR_2G0ww,1718297362,OKKO,5541,5541,-256639,-256639,980,0,0,2503954,False,KAE3-9M5E-AAH0-143A
3mg1j6_ID7l9cDsx3Q,1718296002,Bestwaytocup,5814,5814,-10000,-10000,980,0,0,2760593,False,AC86-C33K-B6AH-8BCX
Bi2L93H5KSonOMYVMw,1718295804,–ü–µ—Ä–µ–∫–∞–∑ –Ω–∞ –∫–∞—Ä—Ç–∫—É,4829,4829,-900000,-900000,980,0,0,2770593,False
Vs2Z-kqGkYOoM2P7Gg,1718266905,–°—ñ–ª—å–ø–æ,5411,5411,-52100,-52100,980,0,521,3670593,False,B5E1-CEXH-2B07-XBKB
EESPhpaHjooVaZjOHA,1718260041,–ê—Ñ—Ç–µ—Ä–Ω—É–Ω,5812,5812,-47300,-47300,980,0,0,3722693,False,PTXM-635T-843C-8CE0
Q2GkqbSEGpoj3jdYng,1718257646,Pethouse,5995,5995,-301500,-301500,980,0,0,3769993,False,756M-2XH7-6899-5BXK
QSRHw1GXAbI1WEts2g,1718217934,platon1*books.stores,5942,5942,-39750,-39750,980,0,0,4071493,False,8T0A-4466-H62A-5BCH
iIVsRmsf_d83hn3KeA,1718211489,Novus,5411,5411,-29792,-29792,980,0,297,4111243,False,4H8H-011H-194C-2524
wx5WhH2d8VvcD-jl_A,1718210852,Seizo,7230,7230,-100000,-100000,980,0,0,4141035,False,8C19-4B62-B3AT-60T0
Ots-VKIxQ7oraU6uTw,1718207547,5045Kavjarnja,5814,5814,-3500,-3500,980,0,0,4241035,False,KM23-P959-A044-1P29
3zm6pzjDobTzkagkwA,1718206776,–ö–ò–á–í–ì–ê–ó,5812,5812,-60000,-60000,980,0,0,4244535,False,6XXM-BMCT-K53K-T98M
PNcE-g6Ty2pCnHrzQA,1718204270,–°–∫–∞—Å—É–≤–∞–Ω–Ω—è. EasyPay,5411,5411,356780,356780,980,0,-3567,4304535,False
bUPa1DEN8jqiS28FMw,1718204248,EasyPay,5411,5411,-356780,-356780,980,0,3567,3947755,False
owzz_UgAsxDEK5yBBw,1718204218,EasyPay,5411,5411,-356780,-356780,980,0,3567,4304535,False,P253-1HBT-864A-M0A9
QbZAoMVl-B7lhYjO3Q,1718124045,–ú—ñ—Å—å–∫–∞ –∫–∞–≤'—è—Ä–Ω—è,5812,5812,-7000,-7000,980,0,0,4661315,False,BE35-9K80-4K9K-6EHH
V275m_EwMjevNU47cQ,1718123877,WineTime,5921,5921,-14700,-14700,980,0,147,4668315,False,CX7X-C327-9T96-68HA
Ag0peieD2ycetbXsEQ,1718123178,Ponchyk Boy | –û–ª–µ—Å—è –ì–æ–Ω—á–∞—Ä–∞,5812,5812,-16700,-16700,980,0,0,4683015,False,E6X7-14BK-PBAB-BCEP
nuVsWczhsW47K4u9Og,1718111890,–ö–æ–ª–æ,5411,5499,-4200,-4200,980,0,42,4699715,False,CCBB-5HB7-T5T1-E4P2
AFrLlLEHZK57DI0dNQ,1718111652,–ü–∏—Ä—ñ–∂–∫–æ–≤–∞ ¬´–¢—ñ—Ç–∫–∞ –ö–ª–∞—Ä–∞¬ª,5814,5814,-13600,-13600,980,0,0,4703915,False,KCE3-00ME-19X9-892A
cCT7NuTut_yAEsTdkQ,1718088477,–ü–ª–∞—Ç—ñ–∂ svit-matrasiv.com.ua,4829,4829,-335700,-335700,980,0,0,4717515,False
sQUm-7BL4aNZyKbgBA,1718086913,Bestwaytocup,5814,5814,-7000,-7000,980,0,0,5053215,False,HT9A-T696-9E9T-9H81
EEtA5SXiLknzZoWcGw,1718086006,Bestwaytocup,5814,5814,-40000,-40000,980,0,0,5060215,False,MEPT-38H0-AKK7-2060
WeR_V9-XczSkHK28wQ,1718038804,–ü–æ–ø–æ–≤–Ω–µ–Ω–Ω—è ¬´–ß–∞–π–æ–≤—ñ –¥–ª—è –∫–æ–º–∞–Ω–¥–∏ –á¬ª,4829,4829,-5000,-5000,980,0,0,5100215,False,1H00-9KH5-4919-5MAB
xgzPwZR-nPEoVRA0pw,1718038172,Miska yidalnia,5814,5814,-53000,-53000,980,0,0,5105215,False,148T-9BEC-3407-38E2
J8tq9VXWxKY5lLiZwA,1718021886,FOP Trenin MS,5814,5814,-10900,-10900,980,0,0,5158215,False,TA11-9P79-H7KK-212E
LSH0v7zSq6G02o5PbA,1718011510,–°—ñ–ª—å–ø–æ,5411,5411,-25000,-25000,980,0,250,5169115,False,P89X-2CCC-ETPT-X6AE
ciIwGJZBUgwIRtzoyw,1718009505,–ü–æ–ø–æ–≤–Ω–µ–Ω–Ω—è ¬´–ù–∞ –∫–∞–º–ø—É—Ç—î—Ä –¥–ª—è –≥—Ç–∞6¬ª,4829,4829,-60100,-60100,980,0,0,5194115,False
oWBEWNFUGp8vbRC5wQ,1718009492,–ü–æ–ø–æ–≤–Ω–µ–Ω–Ω—è ¬´–Ω–∞ –¥—Ä—ñ–º –≤–∞–Ω–Ω—É¬ª,4829,4829,-50000,-50000,980,0,0,5254215,False,9THB-EH0A-XMPA-B2P2
pPOc8rKA2frYsGJ_Yw,1718009476,Lesya,4829,4829,-500000,-500000,980,0,0,5304215,False,MAXM-06E6-6XT4-HE9T
fv6AKI7AGAZsfCSOvQ,1718006522,–íi–¥: –ü–†–ò–•–û–î–¨–ö–û –ï.–í. –§–û–ü,"–î–ª—è –ø–æ–ø–æ–≤–Ω–µ–Ω–Ω—è –∫–∞—Ä—Ç–∫–∏ 5375414101190360, –ü—Ä–∏—Ö–æ–¥—å–∫–æ –ï—Ä–Ω–µ—Å—Ç –íi–∫—Ç–æ—Ä–æ–≤–∏—á, 3487403339",4829,4829,5700000,5700000,980,0,0,5804215,False
3vn_eP689oMR-oZUlQ,1718002482,–¢–∞–±–∞–∫–µ—Ä–∫–∞,5993,5993,-19000,-19000,980,0,0,104215,False,116M-C02E-B6EK-T23A
D2_vr1DeHo61QEt3Ow,1717940673,–ö–∏—Ç–∞–π—Å—å–∫–∏–π –ø—Ä–∏–≤—ñ—Ç,5812,5812,-328500,-328500,980,0,0,123215,False,6984-1TPK-K42A-83T5
EimdpfS1nhLw7s2qzg,1717940535,–ó –±—ñ–ª–æ—ó –∫–∞—Ä—Ç–∫–∏,4829,4829,150000,150000,980,0,0,451715,False
o3aCDxxhKeW-crP_aQ,1717922667,Novapay,8999,8999,-7000,-7000,980,0,0,301715,False,17X5-HKCM-BM20-BAK6
ju3Lm0cKnyjPwEuqhTKI,1717887915,Bolt,4121,4121,-5194,-5194,980,0,0,308715,True
9QQ_PUY_9Z6nPicfDraSqA_sUX0,1717887915,–°–∫–∞—Å—É–≤–∞–Ω–Ω—è. Bolt,4121,4121,5000,5000,980,0,0,313909,False
EtFZ9qdMIBG16dTnQA,1717875701,Uklon,4121,4121,-900,-900,980,0,0,308909,False,H36X-614M-T2E7-2M56
A-nxybb2oh7ZdFUrog,1717874380,Uklon,4121,4121,-21100,-21100,980,0,0,309809,False,3X47-M0B9-A5A5-6718
JyPSZbXUqKdddH9PJg,1717859188,Uklon,4121,4121,-900,-900,980,0,0,330909,False,0KPB-CXEH-67XA-KC05
NK893kPdaWuY2JDDVw,1717858635,Magazin odiagu Etnodim,5651,5651,-500000,-500000,980,0,0,331809,False,5EK5-AH1A-5778-6X8K
md_djX5cmiJ1lH72oA,1717858372,–ó –±—ñ–ª–æ—ó –∫–∞—Ä—Ç–∫–∏,4829,4829,600000,600000,980,0,0,831809,False
pqsVDJweDe3VWw5zRA,1717857447,Uklon,4121,4121,-12100,-12100,980,0,0,231809,False,TT1H-6642-6914-PEB9
A3_RooIVYZKEfkuYCg,1717853521,KFC,5814,5814,-14500,-14500,980,0,0,243909,False,3MXM-17T0-1205-3PK4
TI927g7E1s_8H0sqJQ,1717851247,Wine Point,5921,5921,-48900,-48900,980,0,366,258409,False,A39E-2A6E-EB22-CX2A
Yhw2IijJ1TG3Nwy2_g,1717832229,Bestwaytocup,5814,5814,-21500,-21500,980,0,0,307309,False,H14C-A865-P6HB-KCCC
Ae0dRRWooZmH6koQ2g,1717775364,Bolt,4121,4121,-5000,-5000,980,0,0,328809,False
b8Mt4ylyTADcRDd87Q,1717752353,LIQPAY*HitTrejd,5993,5993,-190000,-190000,980,0,0,333809,False,X9E2-EBT6-X4C4-7XXK
ern2RplrsNxccQdImg,1717746421,FOP Shevchenko,5499,5499,-17000,-17000,980,0,127,523809,False,15X0-3607-385E-914B
xIgPnM1mSVIUUPqOTw,1717745946,Rozetka,5399,5399,-13900,-13900,980,0,104,540809,False,57CA-418K-CX8A-0BBE
DCBdzQc3Ozg8csFcWg,1717658103,Novus,5411,5411,-5199,-5199,980,0,38,554709,False,ETBK-16TH-MX8K-K8P5
Vz0UG9pH-eYXn_c_qg,1717657710,WineTime,5921,5921,-13200,-13200,980,0,99,559908,False,8214-CHMC-P68C-2AAX
u_Rbw1skmzZIoAVJbA,1717657341,MasterZoo,5995,5995,-35200,-35200,980,0,0,573108,False,BA6T-2074-387M-B657
m_Ph6sTgqtliY4Z76w,1717656674,os9vigotovlennyaklyuch,8999,8999,-48000,-48000,980,0,0,608308,False,AA09-0E3P-162E-9820
nSu6Kd4zNx9lGs_Qbg,1717656357,SECHST,5912,5912,-38090,-38090,980,0,0,656308,False,8665-5APH-14T0-1AH4
bXVVb-AzJ0dwIOA7Nw,1717651776,Novapay,8999,8999,-5000,-5000,980,0,0,694398,False,0E69-14HP-BTKC-1AK5
PvEqTzRu0C1-EtuRqg,1717651210,–ö–∏—ó–≤–ø–∞—Å—Ç—Ä–∞–Ω—Å,4111,4111,-800,-800,980,0,0,699398,False,58P5-E4H4-M5HP-T491
alIudDf7frQE08HpPw,1717605519,–ü—Ä–æ–¥—É–∫—Ç–æ–≤–∞ –õ–∞–≤–∫–∞,5499,5499,-8100,-8100,980,0,60,700198,False,XBEX-TKK9-2191-CEB8
pHisoG36fXk_oELEsA,1717605407,TITKA KLARA,5814,5814,-20600,-20600,980,0,0,708298,False,926C-A7H5-6580-3AT3
b18i3G73hAAprDiUQg,1717604876,–ü–∞—Ä–∫–æ–≤–∫–∞,7523,7523,-24000,-24000,980,0,0,728898,False,71CM-07X0-HTKH-H073
Rn56G7ZIpD1cycmQtA,1717591282,–ü–æ–ø–æ–≤–Ω–µ–Ω–Ω—è ¬´–ù–∞ –¥—Ä–æ–Ω–∏ –¥–ª—è –ó–°–£¬ª,4829,4829,-52000,-52000,980,2000,0,752898,False,KE9K-6507-0M41-MB28
InxfD9MTu5w2p-mJww,1717590598,STEAKHOUSE02,5812,5812,-64000,-64000,980,0,0,804898,False,2XCE-H37E-T8E4-9M0B
fV6dOe7BeH1YA5Fc0w,1717581578,Novapay,8999,8999,-848940,-848940,980,0,0,868898,False,E19M-ATKX-1AAB-EPPX
YRd3nR4j3DcSkeKh2w,1717581189,Novapay,8999,8999,-627460,-627460,980,0,0,1717838,False,C2ET-KHH7-2M8P-191E
TbdtHf5kQpORKz1cBA,1717579670,–ü–µ—Ä–µ–∫–∞–∑ –Ω–∞ –∫–∞—Ä—Ç–∫—É,4829,4829,-1500000,-1500000,980,0,0,2345298,False
nwL1AJrOgeyhjEHIxw,1717579644,–ü–ª–∞—Ç—ñ–∂ Rozetka,4829,4829,-425800,-425800,980,0,0,3845298,False
W1fTTXUo7kFaH7UH8Q,1717578963,–ü–æ–ø–æ–≤–Ω–µ–Ω–Ω—è ¬´–ù–∞ –∫–∞–º–ø—É—Ç—î—Ä –¥–ª—è –≥—Ç–∞6¬ª,4829,4829,-7500,-7500,980,0,0,4271098,False
p_mXUxnIMfWayL0WXw,1717578750,–ü–æ–ø–æ–≤–Ω–µ–Ω–Ω—è ¬´–Ω–∞ –¥—Ä—ñ–º –≤–∞–Ω–Ω—É¬ª,4829,4829,-50100,-50100,980,0,0,4278598,False,MKT5-5E0P-CE8H-1X39
kw3tGeSX9RiDeQt93w,1717576492,–ü–æ–ø–æ–≤–Ω–µ–Ω–Ω—è ¬´–Ü–¥—É –¥–æ –≤—ñ–π—Å—å–∫–∞¬ª,4829,4829,-1000000,-1000000,980,0,0,4328698,False,0A7P-7T3X-HB57-0716
03VPlDxTYLpfO60G0Q,1717575371,–íi–¥: –ü–†–ò–•–û–î–¨–ö–û –ï.–í. –§–û–ü,"–î–ª—è –ø–æ–ø–æ–≤–Ω–µ–Ω–Ω—è –∫–∞—Ä—Ç–∫–∏ 5375414101190360, –ü—Ä–∏—Ö–æ–¥—å–∫–æ –ï—Ä–Ω–µ—Å—Ç –íi–∫—Ç–æ—Ä–æ–≤–∏—á, 3487403339",4829,4829,4000000,4000000,980,0,0,5328698,False
XF4LJjfK-vshvfcuSw,1717574183,Brain,5722,5722,-137400,-137400,980,0,0,1328698,False,M6MM-P54A-E9T1-PP7B
mXZ1Wn3fkuHlXt6kDA,1717572376,CLICK.UA,5732,5732,-35200,-35200,980,0,0,1466098,False,P31T-M2BB-0628-CEB9
J5Fv352Q2z6xuoliGA,1717568268,Novus,5411,5411,-14297,-14297,980,0,107,1501298,False,4H12-4MT9-46H1-HC08
6N4SWP2DXZNKJYJKDQ,1717525659,–ö–æ–ª–æ,5411,5499,-4500,-4500,980,0,33,1515595,False,CPX7-BCA5-B7EP-P227
l2mLflWbXtc4nkEc2A,1717514027,–°—ñ–ª—å–ø–æ,5411,5411,-55800,-55800,980,0,418,1520095,False,7020-H1A4-7CXP-K6C2
0TqsldBoiYVSpfZMDg,1717485107,–ê–ø—Ç–µ–∫–∞ –î–æ–±—Ä–æ–≥–æ –î–Ω—è,5912,5912,-52016,-52016,980,0,0,1575895,False,20A5-18E9-HCCM-66MX
ZkKO3QM547nXryL8EA,1717481853,WFP.GROCERY1,5499,5499,-45810,-45810,980,0,343,1627911,False,1AP0-PK9A-MA17-TX59
pQmfq_I7vnM-ifJN0w,1717432747,Produkti,5499,5499,-3700,-3700,980,0,27,1673721,False,XA98-37EC-9580-AECX
DkJbCcTfpq3ZcWsU6w,1717427384,LIQPAY*Seizo,7230,7230,-20000,-20000,980,0,0,1677421,False,A1HB-T0KH-9HHK-E95A
-hA1Uw_V4MjoNPAscQ,1717409526,–ú—ñ—Å—å–∫–∞ –∫–∞–≤'—è—Ä–Ω—è,5812,5812,-19500,-19500,980,0,0,1697421,False,MH4M-34AX-7MPC-KKP4
Cft6msC566W7jeLJhA,1717408718,–ú—ñ—Å—å–∫–∞ –á–¥–∞–ª—å–Ω—è,5814,5814,-28000,-28000,980,0,0,1716921,False,5HXM-4EC9-76X4-8HK0
3LV1TnNwjZ5SYciEHw,1717408675,–ú—ñ—Å—å–∫–∞ –á–¥–∞–ª—å–Ω—è,5814,5814,-35000,-35000,980,0,0,1744921,False,2PA6-2HK5-E9E9-501E
-HDU9aV9Wlil9x_vNQ,1717399060,"Lifecell
+380631692598",4814,4814,-25000,-25000,980,0,0,1779921,False,MEPH-307A-T5B6-BEAK
50EQqurpIyWvhHqsGQ,1717332422,Bestwaytocup,5814,5814,-9000,-9000,980,0,0,1804921,False,9XCH-16C0-A16C-T7H3
xZqGzMOpiDFFO8yE1g,1717331485,Ponchyk Boy | –û–ª–µ—Å—è –ì–æ–Ω—á–∞—Ä–∞,5812,5812,-8900,-8900,980,0,0,1813921,False,4MKC-BCB0-9784-A7HM
1j2QCnqj-siPknwyMQ,1717330939,Ponchyk Boy | –û–ª–µ—Å—è –ì–æ–Ω—á–∞—Ä–∞,5812,5812,-70800,-70800,980,0,0,1822821,False,ACXK-P254-A7AB-1EE7
kHsLDTeq0Q9NacrzPA,1717320804,GENESIS VETCLINIC,742,742,-151000,-151000,980,0,0,1893621,False,4E14-P50C-TCAX-T346
spmb9cA0eo4JrezA5A,1717315122,LIQPAY*ULIS tovari,5812,5812,-6500,-6500,980,0,0,2044621,False,128P-C7M6-80TX-3057
qW3Vh_4NMlGrS42_4A,1719568866,–í—ñ–∫—Ç–æ—Ä –ì.,4829,4829,-25300,-25300,980,0,0,198261,False,027H-HH3K-T67X-PCTA
SJbTdKB5ksrsd8TraQ,1719568297,–ê–Ω–∂–µ–ª–∞ –ü.,4829,4829,-82500,-82500,980,0,0,223561,False,8026-7C05-C211-62A4
0vArEoyPjLHn007gpA,1719567992,414962****9431,4829,4829,-29300,-29300,980,0,0,306061,False,T6CE-B394-8218-HP49
PIgIRcGM5kax6aetyA,1719492150,–ü–µ—Ä–µ–∫–∞–∑ –Ω–∞ –∫–∞—Ä—Ç–∫—É,4829,4829,-500000,-500000,980,0,0,335361,False
QB2lh_cUBSnXkvLbPg,1719469680,–ü–µ—Ä–µ–∫–∞–∑ –Ω–∞ –∫–∞—Ä—Ç–∫—É,4829,4829,-400000,-400000,980,0,0,835361,False
6i3rk-ygVZCDiJrXmw,1719420508,–ü–µ—Ä–µ–∫–∞–∑ –Ω–∞ –∫–∞—Ä—Ç–∫—É,4829,4829,-300000,-300000,980,0,0,1235361,False
DHwhsWbp6r6mq9Dkxw,1719408058,Lesya,4829,4829,-120000,-120000,980,0,0,1535361,False,1H7M-5CK1-8AA3-1ACM
LCzwm_GOhopuDx0vpw,1719340309,Broen,5812,5812,-258500,-258500,980,0,0,1655361,False,A5B8-XT17-B63K-XHT4
w-hFLLtGRPJU-Q9aqg,1719299938,–ü–æ–ø–æ–≤–Ω–µ–Ω–Ω—è ¬´–ù–∞ –∑–∞—Ä—è–¥–Ω—ñ —Å—Ç–∞–Ω—Ü—ñ—ó¬ª,4829,4829,-200000,-200000,980,0,0,1913861,False,002M-HEKM-T9H5-P701
CJdJ5rKhT_7cPi8zaQ,1719235590,–ñ–∞–Ω–Ω–∞ –ñ.,4829,4829,-250000,-250000,980,0,0,2113861,False,118C-T5HH-979A-7597
FU1FMyJCf8IFaSeq1A,1719109629,–†–µ–≥—É–ª—è—Ä–Ω–µ –ø–æ–ø–æ–≤–Ω–µ–Ω–Ω—è ¬´–§–æ–Ω–¥ –ü–æ–≤–µ—Ä–Ω–∏—Å—å –∂–∏–≤–∏–º¬ª,4829,4829,-25000,-25000,980,0,0,2363861,False,HC01-M78B-87HM-3B25
_RHKPGfVCSLXWUkteg,1718996055,–ó —á–æ—Ä–Ω–æ—ó –∫–∞—Ä—Ç–∫–∏,4829,4829,300000,300000,980,0,0,2388861,False
y9sh-WuqxP5D_mr66g,1718956346,545708****7962,4829,4829,-10000,-10000,980,0,0,2088861,False,C7KC-99PE-4AX8-EE11
qYkV1n8xrAz-UZGcmQ,1718955572,414949****2985,4829,4829,-10000,-10000,980,0,0,2098861,False,4M9M-B5T5-9MKM-K7BP
DAdq3GAnbWyijKkwtg,1718955499,545708****9397,4829,4829,-19800,-19800,980,0,0,2108861,False,B09C-6M9H-8TC0-6TCH
xI8sHPYUf6ZWmwgRag,1718895170,–ü–æ–ø–æ–≤–Ω–µ–Ω–Ω—è ¬´–ë—ñ–æ–Ω–∏–∫—É –í—ñ—Ç–∞–ª—ñ—é¬ª,4829,4829,-50000,-50000,980,0,0,2128661,False,XTP8-A275-7B7B-MTB2
KxRYViArmbT6oaXlKg,1718747594,FUNKEYS,5045,5045,-125000,-125000,980,0,0,2178661,False,9C07-TH79-ETMX-6762
xkVXqSKZjo3rAQNA_Q,1718644325,–ü–æ–ø–æ–≤–Ω–µ–Ω–Ω—è ¬´–Ω–∞ –¥—Ä—ñ–º –≤–∞–Ω–Ω—É¬ª,4829,4829,-123400,-123400,980,0,0,2303661,False,XBHH-H52K-ATAK-2703
TAnPz-j8w6dKC03BnQ,1718641171,–í—ñ–¥: –û–ª–µ—Å—è –°–∞—á–µ–Ω–∫–æ,4829,4829,1633300,1633300,980,0,0,2427061,False
F_cB6YJCrV45HCqTPQ,1718615136,–ü–æ–ø–æ–≤–Ω–µ–Ω–Ω—è ¬´–Ω–∞ –¥—Ä—ñ–º –≤–∞–Ω–Ω—É¬ª,4829,4829,-75000,-75000,980,0,0,793761,False,0217-0EE9-X8HB-9K6X
bdvlFppjgV6XLtywDQ,1718615104,–ó —á–æ—Ä–Ω–æ—ó –∫–∞—Ä—Ç–∫–∏,4829,4829,500000,500000,980,0,0,868761,False
z2o7q27J08rYQErplg,1718544169,Lesya,4829,4829,-400000,-400000,980,0,0,368761,False,6X1H-T6MC-BA70-4KAK
nyUIL91jH7I2okkRhQ,1718536067,516874****3490,4829,4829,-30151,-30151,980,0,0,768761,False,T9KT-28M1-60MK-1525
UYt4AkRINrZGHbiaeg,1718504832,–†–µ–≥—É–ª—è—Ä–Ω–µ –ø–æ–ø–æ–≤–Ω–µ–Ω–Ω—è ¬´–§–æ–Ω–¥ –ü–æ–≤–µ—Ä–Ω–∏—Å—å –∂–∏–≤–∏–º¬ª,4829,4829,-25000,-25000,980,0,0,798912,False,E9CK-C3CP-M684-1068
ZU5Lk6HYZjtkQMuO7A,1718343637,414949****2985,4829,4829,-6030,-6030,980,0,0,823912,False,H656-7BC7-9MK5-BB4P
HrMYjjvPVLsybIFFrQ,1718295821,–ñ–∞–Ω–Ω–∞ –ñ.,4829,4829,-250000,-250000,980,0,0,829942,False,X002-T478-5ME9-BM91
lG8STCw0Kf8g-Uhckw,1718295804,–ó —á–æ—Ä–Ω–æ—ó –∫–∞—Ä—Ç–∫–∏,4829,4829,900000,900000,980,0,0,1079942,False
1f1zxeIYol_uSNW0Jg,1717940534,–ü–µ—Ä–µ–∫–∞–∑ –Ω–∞ –∫–∞—Ä—Ç–∫—É,4829,4829,-150000,-150000,980,0,0,179942,False
Se_NTfYDDpBbFR5kAA,1717925059,–í—ñ–∫—Ç–æ—Ä –ó.,4829,4829,-5000,-5000,980,0,0,329942,False,3A13-K49B-12XH-EH9B
ZRTrQjhZSeR9EZrGBw,1717900011,–†–µ–≥—É–ª—è—Ä–Ω–µ –ø–æ–ø–æ–≤–Ω–µ–Ω–Ω—è ¬´–§–æ–Ω–¥ –ü–æ–≤–µ—Ä–Ω–∏—Å—å –∂–∏–≤–∏–º¬ª,4829,4829,-25000,-25000,980,0,0,334942,False,26C7-4XK4-B7CT-9E16
OJw9gUGPhOT3DYMjFg,1717858371,–ü–µ—Ä–µ–∫–∞–∑ –Ω–∞ –∫–∞—Ä—Ç–∫—É,4829,4829,-600000,-600000,980,0,0,359942,False
mO74jiveO8XEQJ1Ykw,1717851261,–ü–æ–ø–æ–≤–Ω–µ–Ω–Ω—è ¬´–Ω–∞ –¥—Ä—ñ–º –≤–∞–Ω–Ω—É¬ª,4829,4829,-23400,-23400,980,0,0,959942,False,5428-8EM0-ATBK-B0PK
o2LqZMpjx0PApJqaAg,1717851243,–ü–æ–ø–æ–≤–Ω–µ–Ω–Ω—è ¬´–ù–∞ –∫–∞–º–ø—É—Ç—î—Ä –¥–ª—è –≥—Ç–∞6¬ª,4829,4829,-15000,-15000,980,0,0,983342,False
zgogjBF6_mKVXMmKXA,1717827581,–ü–æ–ø–æ–≤–Ω–µ–Ω–Ω—è ¬´–Ω–∞ —Ä–µ–º–æ–Ω—Ç¬ª,4829,4829,-100000,-100000,980,0,0,998342,False,PXA4-AK9C-K616-91M7
yloj-w6K-A7WBo4LGA,1717789103,–û–ª–µ–∫—Å—ñ–π –•.,4829,4829,-90000,-90000,980,0,0,1098342,False,1PBX-X155-T9B4-M994
EzMjTI2JjIv7VVkBIQ,1717747045,545708****3309,4829,4829,-12000,-12000,980,0,0,1188342,False,367X-C8X8-762E-7MHX
5bGR_0bU7XoRRNZEKA,1717746720,–ê–Ω–∂–µ–ª–∞ –ü.,4829,4829,-39500,-39500,980,0,0,1200342,False,66A8-BH95-XC55-MP8M
0GGf0EHoILLI99q0WA,1717746602,414949****2985,4829,4829,-10050,-10050,980,0,0,1239842,False,KE1T-C89X-T749-CE91
gjqeg50HAUEG7SfdAg,1717699311,t.c.pizza,5812,5812,-158500,-158500,980,0,0,1249892,False,1CH3-5913-2712-K49M
j-ErREPJ-EnXsDZxzQ,1717607621,–ü–æ–ø–æ–≤–Ω–µ–Ω–Ω—è ¬´–ê–ó–û–í / –ë—Ä–ê–ì¬ª,4829,4829,-100000,-100000,980,0,0,1408392,False,M879-208C-H690-52EA
LKAkmTfvZDGSZTLLkw,1717579670,–ó —á–æ—Ä–Ω–æ—ó –∫–∞—Ä—Ç–∫–∏,4829,4829,1500000,1500000,980,0,0,1508392,False
hdHYxDF9Q0k228nh_A,1717500416,–Ü—Ä–∏–Ω–∞ –ö.,–û–ª–µ—Å—è,4829,4829,-193000,-193000,980,0,0,8392,False,XME9-CBKX-PK35-CM9X
0URsHnj0f3Vo6u4Rvw,1717431492,Ponchyk Boy | –û–ª–µ—Å—è –ì–æ–Ω—á–∞—Ä–∞,5812,5812,-18700,-18700,980,0,0,201392,False,T5H0-7TPK-H0A3-H3K2
ORPm_TNlKXT_lf9Rng,1717412491,Lesya,4829,4829,-50000,-50000,980,0,0,220092,False,7CX9-AP11-TPKB-91H9
qvfsIPAqIqeOBfH0qw,1717405355,–ü–æ–ø–æ–≤–Ω–µ–Ω–Ω—è ¬´–û–ß–Ü –î–õ–Ø –†–û–ó–í–Ü–î–ö–ò¬ª,4829,4829,-10000,-10000,980,0,0,270092,False
wU1LiWv6md0VWrDLrA,1717398698,–ü–æ–ø–æ–≤–Ω–µ–Ω–Ω—è ¬´1200 FPV ¬´–°–í–û–ë–û–î–ê¬ª¬ª,4829,4829,-30000,-30000,980,0,0,280092,False,4M72-TCH6-TCB1-7K01
YwaYe5yntgTOsEfGFg,1717331013,–ü–æ–ø–æ–≤–Ω–µ–Ω–Ω—è ¬´–ù–∞ –∫–∞–º–ø—É—Ç—î—Ä –¥–ª—è –≥—Ç–∞6¬ª,4829,4829,-7500,-7500,980,0,0,310092,False
M1YtOEFYz3ng5vJZVA,1717330993,–ü–æ–ø–æ–≤–Ω–µ–Ω–Ω—è ¬´–Ω–∞ –¥—Ä—ñ–º –≤–∞–Ω–Ω—É¬ª,4829,4829,-10000,-10000,980,0,0,317592,False,5BTX-TX10-P09B-AAC4
jXhG58oiSENNTLNGUA,1717295220,–†–µ–≥—É–ª—è—Ä–Ω–µ –ø–æ–ø–æ–≤–Ω–µ–Ω–Ω—è ¬´–§–æ–Ω–¥ –ü–æ–≤–µ—Ä–Ω–∏—Å—å –∂–∏–≤–∏–º¬ª,4829,4829,-25000,-25000,980,0,0,327592,False,X655-X911-8152-HMCT
SgXRYVCOZCdBG8S6VQ,1722357842,Kafe Kaviarnia humans,5814,5814,-20500,-20500,980,0,153,933584,False,3B79-0KK3-76H2-H100
DlhDBOt-hfCfrtvesw,1722357491,Fresh Baza,5399,5399,-39100,-39100,980,0,0,954084,False,2C8A-HTCM-XP87-E55H
aIzHOIseutCu-_NfTg,1722356891,magazin Kiyiv Zolotous,5921,5921,-9380,-9380,980,0,0,993184,False,M0PP-5165-CE3A-113M
MqNPIe61xGdDMJ_imwdMWw,1722295008,Bolt,4121,7999,-3081,-3081,980,0,0,1002564,True
kvXKO8cxvwnllFyADLK9tg,1722295008,Bolt,4121,7999,-4147,-4147,980,0,0,1005645,True
5_CdaD6WpGQ5aj5VPwX-8nwfvBc,1722295008,–°–∫–∞—Å—É–≤–∞–Ω–Ω—è. Bolt,4121,7999,5000,5000,980,0,0,1009792,False
2GqpEVW-KUAxAvbExCNXMPnkSrA,1722295008,–°–∫–∞—Å—É–≤–∞–Ω–Ω—è. Bolt,4121,7999,5000,5000,980,0,0,1004792,False
n8BkOGvW7IVh6m64kA,1722274566,–°—ñ–ª—å–ø–æ,5411,5411,-75600,-75600,980,0,0,999792,False,XTB2-6629-HC2T-4PH3
_AE6MfCjXRzjS0hBog,1722273146,Noodes,5812,5812,-96100,-96100,980,0,720,1075392,False,E3M4-HTTE-09CB-BACK
dWzdOFmMgqy0OztH_g,1722251008,LIQPAY*FOP Dmitrishina,5651,5651,-87000,-87000,980,0,0,1171492,False,8A30-KCEK-HT0M-0BCP
bLniHKR5BShTGLFR3A,1722241472,–°—ñ–ª—å–ø–æ,5411,5411,-67600,-67600,980,0,0,1258492,False,CK1M-2205-25H9-B376
rf_-fD2K2ZVzKEykYQ,1722236119,Fitness23,7997,7997,-90000,-90000,980,0,0,1326092,False,MK0A-H775-M9X8-7B9C
DGTB2hSBHgUD4a8Jfg,1722235489,"Lifecell
+380631692598",4814,4814,-26000,-26000,980,0,0,1416092,False,0TTK-C2P0-P0MC-P742
sJXo3Lt8UUk5r5YQfQ,1722188848,Hotel at Booking.com,7011,7011,-152032,-14400,985,0,0,1442092,False,8BXP-P5EX-1XK7-49H8
St3ek5y9McLxk5D3cg,1722186554,Prostor,5977,5977,-11450,-11450,980,0,0,1594124,False,TP70-B6K2-6H5X-E6K5
2dLA0IewhlpeK9zmkw,1722183192,Best Way To Cup,5814,5814,-9000,-9000,980,0,67,1605574,False,130P-EC7B-96KK-8AEK
aiRXqVi6cL-7WdjL3A,1722182586,–û—Ñ—ñ—Å-—á–∞–π,5812,5812,-14700,-14700,980,0,110,1614574,False,0ECK-6HC2-8360-8M72
YQzu-79IpZ06TcrNNQ,1722175808,Wfp.aquamarket,5499,5499,-76670,-76670,980,0,0,1629274,False,77KB-1C9T-7A6A-8BB5
UhPJsiUDBNF4oL1IsA,1722166779,Novus,5411,5411,-25680,-25680,980,0,0,1705944,False,CTK3-P8PT-HEAM-5XXA
VDsq1WliUGTD3iBP4Q,1722166466,OK Wine,5411,5411,-14300,-14300,980,0,0,1731624,False,K5XM-MPET-X396-4A5H
PSD9gPUPibtMC9FZJg,1722166134,Prostor,5977,5977,-17440,-17440,980,0,0,1745924,False,6PT9-002P-AXP6-71P9
ELuqaRHpN67FTt2Krw,1722164717,LIQPAY*Food Spot Corp.,5812,5812,-88400,-88400,980,0,663,1763364,False,A1HH-K9XA-X91X-B8XX
MCcHTWvwlXrSManzvg,1722154044,Bolt,4121,7999,-5000,-5000,980,0,0,1851764,False
kiy0qxwcEdFyKpvMpw,1722151302,–ö–£–ó–Ø,4900,4900,-35000,-35000,980,0,0,1856764,False,9MC4-6TPP-B8H0-TK62
s-OMKyxuJuCHDMmb2A,1722148987,Bolt,4121,7999,-5000,-5000,980,0,0,1891764,False
dMXgBlV5iCOvopQeMC5D,1722122119,Bolt,4121,7999,-2507,-2507,980,0,0,1896764,True
Oi3Pb_sXVrP5BHMA93-CC3Mv4VM,1722122119,–°–∫–∞—Å—É–≤–∞–Ω–Ω—è. Bolt,4121,7999,5000,5000,980,0,0,1899271,False
14bOIIsJFeSkYwiMug,1722101737,WineTime,5921,5921,-82860,-82860,980,0,0,1894271,False,2135-METH-P63P-C620
2gi2g2VkeoREMQHtZw,1722092463,–ù–æ–≤–∞ –ø–æ—à—Ç–∞,7399,7399,-7400,-7400,980,0,0,1977131,False,9919-9508-37XX-C6K5
1PA5LrDm5iXv8sIWpw,1722082465,–ê–ø—Ç–µ–∫–∞ ¬´–ë–∞–∂–∞—î–º–æ –∑–¥–æ—Ä–æ–≤'—è¬ª,5912,5399,-58860,-58860,980,0,0,1984531,False,175K-46H3-7E6K-A4B4
1e8HFoeAOkiS7bW-YQ,1722082421,–ê–ø—Ç–µ–∫–∞ ¬´–ë–∞–∂–∞—î–º–æ –∑–¥–æ—Ä–æ–≤'—è¬ª,5912,5399,-43880,-43880,980,0,0,2043391,False,TCP6-0C50-712T-MCKP
rTmfmpi47fKxAxWUKA,1722082295,–ê–ø—Ç–µ–∫–∞ –ê–ù–¶,5912,5912,-53770,-53770,980,0,0,2087271,False,B80T-AA9C-4XMP-4H4A
DhLqNPERDTNkr5lnhQ,1722082209,Konteiner,5814,5814,-27500,-27500,980,0,550,2141041,False,H8KC-8BX4-TE37-B10C
5jfKXgXtEHVAiblb6w,1722082072,OK Wine,5411,5411,-8500,-8500,980,0,0,2168541,False,MPTM-3CC6-9674-XC62
UF_ztt61Qe13hKYvNA,1722081124,SILPO,5411,5411,-7500,-7500,980,0,0,2177041,False,BAKP-13H9-16KC-8H22
rPOon8dlk9EzvmkJGg,1722080225,MAHAZYN HALFPRICE 4656,5661,5661,-18900,-18900,980,0,0,2184541,False,6C07-1785-69A1-E705
RUJU5vrB_QTSwiIAbg,1722079979,5045Kavjarnja,5814,5814,-8500,-8500,980,0,170,2203441,False,PPA6-HMBC-H7BX-M14K
KFWrIzHtSHDcKH8oVg,1722079706,–ü–µ—Ä–µ–∫–∞–∑ –Ω–∞ –∫–∞—Ä—Ç–∫—É,4829,4829,-600000,-600000,980,0,0,2211941,False
bN5M-6qEp83sld0H2g,1722079652,–ü–æ–ø–æ–≤–Ω–µ–Ω–Ω—è ¬´–ù–∞ –∫–∞–º–ø—É—Ç—î—Ä –¥–ª—è –≥—Ç–∞6¬ª,4829,4829,-42100,-42100,980,0,0,2811941,False
qZumQlWb901Jr2qcLg,1722079445,–ö–ò–á–í–ì–ê–ó,5812,5812,-67100,-67100,980,0,1342,2854041,False,M4T8-3355-A93M-3BT0
X5XPPczOUpz_yAO4cQ,1722076703,Fresh dzhus end Babl T,5813,5813,-14000,-14000,980,0,280,2921141,False,7BH3-674C-3611-KK64
8229uMS8hdPfLzFKOQ,1722076480,ITIS CAFE,5814,5814,-9800,-9800,980,0,196,2935141,False,30H7-HH79-638E-TE9H
32KCUZRiOchdGLGMbw,1722074479,KFC,5814,5814,-9500,-9500,980,0,190,2944941,False,E11X-CT44-CXPE-EKE3
GB_SWM2E01O5KXmw4A,1722074112,MasterZoo,5995,5995,-19080,-19080,980,0,0,2954441,False,27CT-4C29-HK46-M369
qLa5L1RCq12jJYH3IsC_Aw,1722035207,Bolt,4121,7999,-2794,-2794,980,0,0,2973521,True
a3mnqGgXNLNCh7oxYS5rl4ueGqo,1722035207,–°–∫–∞—Å—É–≤–∞–Ω–Ω—è. Bolt,4121,7999,5000,5000,980,0,0,2976315,False
EB0EjfXdR4a7qYj0gQ,1721998677,Beerplace,5814,5814,-12000,-12000,980,0,240,2971315,False,X451-22K6-7KK0-0A19
_061ofgwCq9bu_hywA,1721996028,–û—Ñ—ñ—Å-—á–∞–π,5812,5812,-13700,-13700,980,0,274,2983315,False,KCXH-T192-621P-T025
1yMiF_mUCLep8qQvcg,1721991083,PershiyPoverh,5814,5814,-11500,-11500,980,0,230,2997015,False,6599-66HC-281K-418K
vu4xHSlx-f2nx-ClEA,1721984340,Bolt,4121,7999,-5000,-5000,980,0,0,3008515,False
PyHEyBzhN10GBh3RQg,1721978254,FOP Shevchenko,5499,5499,-19800,-19800,980,0,0,3013515,False,56EP-6X67-7A83-H978
9IishAv86kvqQUQSFw,1721977094,Lesya,4829,4829,-150000,-150000,980,0,0,3033315,False,P61B-701M-B1M0-4M34
HW3GpT5BzskUsPW3G1xOEg,1721951357,Bolt,4121,7999,-3086,-3086,980,0,0,3183315,True
VnLr2ccV9hltcH3re_XP7LXcAPw,1721951357,–°–∫–∞—Å—É–≤–∞–Ω–Ω—è. Bolt,4121,7999,5042,5042,980,0,0,3186401,False
1vidKJyRWLXdjUKoyA,1721933573,Novapay,8999,8999,-7530,-7530,980,0,0,3181359,False,2805-4KMA-39ET-999M
AYnUMn463ALqwajH_Q,1721928472,–°—ñ–ª—å–ø–æ,5411,5411,-150400,-150400,980,0,0,3188889,False,M908-8H78-9AK0-4XT2
ZN0nOKMgn7VZ0lKI6g,1721924610,Urbanisty cafe,5812,5812,-20500,-20500,980,0,410,3339289,False,4041-8KTX-4K3P-H1E1
ZE4RMmhLNBpEsRImwg,1721908185,Yaroslaviv Val 37-1,5921,5921,-5300,-5300,980,0,0,3359789,False,A3XB-3731-B5BH-B17H
1kcTCnLSLnV3yp6ALQ,1721906343,NUNU | –Ø—Ä–æ—Å–ª–∞–≤—ñ–≤ –í–∞–ª,5812,5812,-28200,-28200,980,0,564,3365089,False,998H-9T6B-HK4T-HX3M
BFHOzJ8mkM8iZ90XMw,1721903476,Bolt,4121,7999,-5000,-5000,980,0,0,3393289,False
SJIoo6f3JAX91MxHig,1721891227,–°—ñ–ª—å–ø–æ,5411,5411,-15698,-15698,980,0,0,3398289,False,B49K-PC90-KH9P-38K6
Lrewj4cxpKqA9QHj_Q,1721890504,UNIVERSUM CLINIC,8099,8099,-46000,-46000,980,0,0,3413987,False,5130-T88C-HA3P-B3TM
cMmpYCwHP1OYN_mI7Q,1721841574,Novapay,8999,8999,-7750,-7750,980,0,0,3459987,False,HPPE-08CH-65C4-X5K4
DoRGUXPHM9PRhBScUQ,1721830107,–í—ñ—Ç–∞–ª—ñ–π –®.,4829,4829,-450000,-450000,980,0,0,3467737,False,3BTT-5CEE-28K4-BC4B
lDOa09qdh5UdEUT0kQ,1721814092,Fotovramci,5946,5946,-35000,-35000,980,0,0,3917737,False,831H-P2TH-618K-39P6
TfugYsdsunrbfExrZw,1721814021,Fotovramci,5946,5946,-80000,-80000,980,0,0,3952737,False,B6CP-9HH7-H299-41T2
uEGFvVWjx76rKHlxFw,1721806662,Bolt,4121,7999,-5042,-5042,980,0,0,4032737,False
ASKcdR0HMIid8UKveA,1721806642,–°–∫–∞—Å—É–≤–∞–Ω–Ω—è. Bolt,4121,7999,5042,5042,980,0,0,4037779,False
TBlsl5-wbRrCS6yqAQ,1721806565,Bolt,4121,7999,-5042,-5042,980,0,0,4032737,False
BGjBYxPq1wVSGm7iEQ,1721802341,Fitness23,7997,7997,-30000,-30000,980,0,0,4037779,False,24HH-KP6C-4901-180E
HoPp6sbSauUAYPXiSQ,1721753274,OkvajnSichovih,5921,5921,-50400,-50400,980,0,0,4067779,False,0K9B-CHP9-2AE7-5192
u8HeyKFAlxac7Vv4wg,1721750877,5045Kavjarnja,5814,5814,-17500,-17500,980,0,350,4118179,False,A122-P02T-M6E7-KP6X
T6tPlCCQPtxb30rQdA,1721731586,Novapay,8999,8999,-8000,-8000,980,0,0,4135679,False,9352-E02K-X3MM-KH36
3ZZYV5CxkjHVrcu8ow,1721728745,Novus,5411,5411,-1399,-1399,980,0,0,4143679,False,29KC-CM4K-B95K-1A05
rVtxlIqrxVI5vsLDFQ,1721667596,–ü–æ–ø–æ–≤–Ω–µ–Ω–Ω—è ¬´–Ω–∞ –¥—Ä—ñ–º –≤–∞–Ω–Ω—É¬ª,4829,4829,-20100,-20100,980,0,0,4145078,False,HBX8-3MKX-0HB2-EPBT
_-FeBEMhEo9cGaoMGg,1721667557,–ü–æ–ø–æ–≤–Ω–µ–Ω–Ω—è ¬´–ù–∞ –∫–∞–º–ø—É—Ç—î—Ä –¥–ª—è –≥—Ç–∞6¬ª,4829,4829,-42000,-42000,980,0,0,4165178,False
QX1BJAtIqTbj4Wxzzw,1721636625,–°—ñ–ª—å–ø–æ,5411,5411,-5400,-5400,980,0,0,4207178,False,8457-1308-MXCM-T40T
OR8jvjjSbIKKgj4v0A,1721636178,Bolt,4121,7999,-5000,-5000,980,0,0,4212578,False,EB4B-5M8T-6T85-BXBB
CqyAUPq9FkUmR0XTFw,1721636114,WineTime,5921,5921,-12900,-12900,980,0,0,4217578,False,0C5C-A4AA-9737-6HB8
5iNgJmEg_-R8VHFMPw,1721633209,–íi–¥: –ü–†–ò–•–û–î–¨–ö–û –ï.–í. –§–û–ü,"–î–ª—è –ø–æ–ø–æ–≤–Ω–µ–Ω–Ω—è –∫–∞—Ä—Ç–∫–∏ 5375414101190360, –ü—Ä–∏—Ö–æ–¥—å–∫–æ –ï—Ä–Ω–µ—Å—Ç –íi–∫—Ç–æ—Ä–æ–≤–∏—á, 3487403339",4829,4829,4200000,4200000,980,0,0,4230478,False
yGZzzfZYyn6bY_ho6Q,1721631527,2bfit_fitness_club,7941,7941,-40000,-40000,980,0,0,30478,False,M531-H449-P13K-A22P
lnQdadCD7DwkxFUPJA,1721631498,2bfit_fitness_club,7941,7941,-60000,-60000,980,0,0,70478,False,9952-T94M-628P-CH11
s5oWTZFmecTAUEoPYw,1721577406,–°—ñ–ª—å–ø–æ,5411,5411,-37500,-37500,980,0,0,130478,False,0X8H-08CT-T97B-TH8T
g9ragLcCaPJ2__SIiw,1721577122,–ó –±—ñ–ª–æ—ó –∫–∞—Ä—Ç–∫–∏,4829,4829,100000,100000,980,0,0,167978,False
SizVaUqR-XdUF9eV4w,1721576825,–ó–æ–æ–º–∞–≥–∞–∑–∏–Ω –õ—é–±–∏–º—ã–π,5995,5995,-38500,-38500,980,0,0,67978,False,8160-CCX6-647P-KA12
OR1FGf6vf8Ae4PmHlw,1721576500,–ê–ø—Ç–µ–∫–∞ –ê–ù–¶,5912,5912,-100,-100,980,0,0,106478,False,8B9K-5CAP-87A5-70A3
on8a3NC6Qxlhh7W_PA,1721576398,–ê–ø—Ç–µ–∫–∞ –ê–ù–¶,5912,5912,-31260,-31260,980,0,0,106578,False,9E9K-E5M2-X4PA-19P7
632qvbUwQDAqpb-3yw,1721561799,–ó –±—ñ–ª–æ—ó –∫–∞—Ä—Ç–∫–∏,4829,4829,100000,100000,980,0,0,137838,False
9-eV_C8T2BE-jwmJsw,1721561688,Kudryashova 18A,5921,5921,-19800,-19800,980,0,0,37838,False,AM39-45BB-K8B9-0PA4
mB-HFT87ErN85fW7KQ,1721550366,Simona,5812,5812,-126900,-126900,980,0,951,57638,False,C6TB-HE7E-41E5-6P62
haHmNgFhkOMXgOGZvQ,1721549448,–ó –±—ñ–ª–æ—ó –∫–∞—Ä—Ç–∫–∏,4829,4829,150000,150000,980,0,0,184538,False
H3Xf27XzN9a2fcZ-Ag,1721549410,EasyPay,5411,5411,-182398,-182398,980,0,0,34538,False,B15P-K7C8-62KE-536H
5Ft0sqCoMEeFaApD7w,1721546832,PivnichniyzaYizd,7523,7523,-10000,-10000,980,0,0,216936,False,0H32-8MHT-M6X6-5KH6
MrxN3Ycmzn5eK3IVGQ,1721545555,Wfp.aquamarket,5499,5499,-31920,-31920,980,0,0,226936,False,3E8C-24KM-EEC8-C729
MTs15KjHAn3bBIAaFg,1721500043,–°—ñ–ª—å–ø–æ,5411,5411,-62300,-62300,980,0,0,258856,False,BKXX-PBKM-BKT6-11XX
XF2yQ0kyiN8FbBDepQ,1721498585,–ü–∞—Ä–∫ ¬´–ú—É—Ä–æ–º–µ—Ü—å¬ª,7523,7523,-3200,-3200,980,0,0,321156,False,AM6C-76H9-4TCA-E8CE
K_TOTtEwavhYwK2ecw,1721490869,KHMIL,5921,5921,-25300,-25300,980,0,0,324356,False,4169-646P-E8E6-H41P
SI1GpF6B20RDSksfcw,1721490196,GENESIS VETCLINIC,742,742,-361000,-361000,980,0,0,349656,False,A1XK-T1P1-89E7-AT7H
YpQv0YhuWMKjv7VqHw,1721478229,–°—ñ–ª—å–ø–æ,5411,5411,-51100,-51100,980,0,0,710656,False,HH7P-7C77-KAB5-KAB4
-bj6iUciHPgGW3R__g,1721477787,Ladushky,5814,5814,-24000,-24000,980,0,180,761756,False,7M5B-ABAA-K8AP-1CP1
DKNUndOhhKeqkldTzA,1721475872,Avtostoyanka,7999,7999,-2000,-2000,980,0,0,785756,False,E4XB-TMT3-A92B-P499
ITbtwg0I4PZholcvyA,1721472116,–ï–ø—ñ—Ü–µ–Ω—Ç—Ä,5211,5211,-13800,-13800,980,0,0,787756,False,7C77-C5CC-XCE4-A962
ar27OiXZD9-rrC6v4Q,1721465874,KFC,5814,5812,-12000,-12000,980,0,90,801556,False,4CCX-60AE-B699-P2M4
r7zP85CO6_8thH1gGw,1721465635,KAFE BAR VYNNYI,5812,5812,-4500,-4500,980,0,33,813556,False,XX5T-P2CM-790A-3H4X
Godd3pfybYfXSy39GQ,1721325730,WWW.HOME.LIBRI.DE,5942,5942,-130530,-2850,978,0,978,818056,False,HK05-4263-A0H7-81CC
zGFDdmNHqlxYf7-Y_Q,1721322812,–°—ñ–ª—å–ø–æ,5411,5411,-64849,-64849,980,0,0,948586,False,TH75-0011-1K7E-B6H4
hlbtakDWNk90pVxekA,1721321495,APTEKA 13,5912,5912,-27550,-27550,980,0,0,1013435,False,H834-H09P-EMC1-3E7T
m9p6Uthf98_8EImlSQ,1721315829,OKKO,5541,5541,-8000,-8000,980,0,0,1040985,False,K26K-E104-38XE-3613
3ddTkYPH93Kdpql8xA,1721313796,–ü–∞—Ä–∫–æ–≤–∫–∞,7523,7033,-16000,-16000,980,0,0,1048985,False,20PM-0T5X-CK3K-593M
ZJ2Meyd3GYop55yDEQ,1721300178,KYIVTHEFOOD,5812,5812,-18000,-18000,980,0,135,1064985,False,0EP8-8104-990E-7M28
a9F9KnoKpSm8lmwFdQ,1721294013,Vodafone,4814,4814,-20000,-20000,980,0,0,1082985,False,8TT6-A5CK-P5M7-K4P9
c45wzcAx8LwKESPsfQ,1721290854,–ü—Ä–æ–¥—É–∫—Ç–∏,5499,5499,-5000,-5000,980,0,0,1102985,False,4X74-TK4M-P80M-X336
UV8fyImM2GCu5Ycw_Q,1721290196,–•–ª—ñ–±–Ω–∞ –ö–∞–≤–∞,5462,5462,-2500,-2500,980,0,0,1107985,False,X531-ATHT-M1P0-E2E2
O3qwilYfS_26g9tERA,1721285355,2bfit_fitness_club,7941,7941,-140000,-140000,980,0,0,1110485,False,XKX8-T2CM-0MXM-2C99
9awQwqBMRveOufFQ7Q,1721238938,SILPO,5411,5411,-64800,-64800,980,0,0,1250485,False,97T9-M32E-0CCB-8K66
H4z5qa9B4gIEK7oiLw,1721237621,OKKO,5541,5541,-205870,-205870,980,0,0,1315285,False,AX55-KB6C-ME0E-768X
vn6NmQ2OYVZkowyyXA,1721223656,–û—Ñ—ñ—Å-—á–∞–π,5812,5812,-13700,-13700,980,0,102,1521155,False,30TC-2HHE-0PBA-PM43
0ROxU6h7MztpqE3Qiw,1721209401,DzhordzhianFUD,5499,5499,-31000,-31000,980,0,0,1534855,False,X9BH-05C6-014H-EH52
N_FvbCekrUlIj5gddw,1721209155,–ö–æ–ª–æ,5411,5499,-6750,-6750,980,0,0,1565855,False,THM8-1P97-K5HT-KMKB
uCeeMUoPRrNV8NfQOQ,1721197455,Best Way To Cup,5814,5814,-10000,-10000,980,0,75,1572605,False,0K21-E563-2081-PE22
bW5VKllRzdwFBBVetg,1721196368,Kafe Diletant,5814,5814,-13000,-13000,980,0,97,1582605,False,KH64-31XX-010K-H5BB
CMYdA_r_FPip7Agy6g,1721196355,Kafe Diletant,5814,5814,-29500,-29500,980,0,221,1595605,False,E810-9TTX-6551-300C
w0KFkkxDzVMkr49Zfg,1721148368,Best Way To Cup,5814,5814,-11500,-11500,980,0,86,1625105,False,C3T1-A3KK-85HH-6BM4
GOIZTBiHPWQgBreReg,1721148199,Best Way To Cup,5814,5814,-10000,-10000,980,0,75,1636605,False,5T49-BB0M-1642-TABB
wMHYOjEG6gTRbGS_bw,1721143481,PHotosalonMAN,7221,7221,-3000,-3000,980,0,0,1646605,False,XC60-09MP-48BP-EP90
enQUpwR9GpPikPZ2BA,1721142084,–°—ñ–ª—å–ø–æ,5411,5411,-120400,-120400,980,0,0,1649605,False,M5C7-0681-135E-31TT
6Av-TAKJg7hW4Sj3MQ,1721114601,KAFE TITKA KLARA,5814,5814,-9000,-9000,980,0,67,1770005,False,C1BX-1675-7EC9-EBP3
HCtuzMl8bUQdOxTYZg,1721064169,KitayskiPelmeni,5812,5812,-134000,-134000,980,0,1005,1779005,False,4KH6-KAHA-9B09-2E97
ls0uVngrczZhwA-YCQ,1721064161,KitayskiPelmeni,5812,5812,-20000,-20000,980,0,150,1913005,False,TACP-79A7-X091-T193
LHjIhYxFATSVdFjTmA,1721059063,TRTSPlazma,7523,7523,-2000,-2000,980,0,0,1933005,False,E9A4-8XBX-XEP6-P208
VlwXDPti7lAcab_kYg,1721054592,Promn,5651,5651,-41000,-41000,980,0,0,1935005,False,86C3-KE6X-CCCA-B4T5
cp1FZQBLH1pfq3XWkg,1721047350,Novus,5411,5411,-15099,-15099,980,0,0,1976005,False,07H3-T1P2-1BAE-K4EP
DdUyxEakbb7m_1Mjyw,1721047024,Seizo,7230,7230,-35000,-35000,980,0,0,1991104,False,K7H2-7858-952H-TKAT
K1ac6ul8c1KTfhK4-w,1721026837,RIZNI,5812,5812,-23500,-23500,980,0,470,2026104,False,18AH-XEKX-95E7-4XAB
fxWY5OsEpJYPOgT6bw,1721023859,–ê–ø—Ç–µ–∫–∞ ¬´–ë–∞–∂–∞—î–º–æ –∑–¥–æ—Ä–æ–≤'—è¬ª,5912,5399,-26510,-26510,980,0,0,2049604,False,5601-18KT-P4B1-P7K1
0Y3zaUo8MRD2PNFjzA,1720970788,Konteiner,5814,5814,-7200,-7200,980,0,144,2076114,False,P4MB-6AEX-HH90-11A7
H3Z8bn0qFtuLEC9joA,1720969905,Konteiner,5814,5814,-9600,-9600,980,0,192,2083314,False,K898-81BC-2398-PHM6
SdHOenzrobzy3J-oLw,1720968949,AVANGARDEN,5812,5812,-82000,-82000,980,0,1640,2092914,False,1505-P493-BA6M-751B
Zd-TlpqVfDDjNSYb2g,1720967377,APTEKA 13,5912,5912,-9350,-9350,980,0,0,2174914,False,BP55-597C-75E0-THT4
7_vQz6OhFAR_q-7npg,1720965129,Bestwaytocup,5814,5814,-23000,-23000,980,0,460,2184264,False,19B0-K37M-BK89-T94B
TBVdqluXl1ejknyTgA,1720960152,–ü–æ–ø–æ–≤–Ω–µ–Ω–Ω—è ¬´–Ω–∞ –¥—Ä—ñ–º –≤–∞–Ω–Ω—É¬ª,4829,4829,-10000,-10000,980,0,0,2207264,False,2EMB-XEM7-2CEK-5130
-4642d29rDysbRU8fA,1720960082,–ü–µ—Ä–µ–∫–∞–∑ –Ω–∞ –∫–∞—Ä—Ç–∫—É,4829,4829,-1300000,-1300000,980,0,0,2217264,False
cXYDIkXhMuoGMiZ3iQ,1720960017,Comfy,5722,5722,-141700,-141700,980,0,0,3517264,False,BK9P-0EK7-HT2K-4TBC
ZJIYdE1xX-2Yr2XNOg,1720955745,Lesya,4829,4829,-20000,-20000,980,0,0,3658964,False,0CBT-6BAE-KT20-3ME4
XdqUvpSnn3wYaQOBcg,1720949854,–ö–∞–≤‚Äô—è—Ä–Ω—è ¬´–°–≤—ñ—Ç –∫–∞–≤–∏¬ª,5814,5814,-28000,-28000,980,0,0,3678964,False,5T24-CE1M-TXT6-4EP8
GB3FpNVbB5qLaCZGUw,1720894527,ULTRAMARKET,5411,5411,-22730,-22730,980,0,0,3706964,False,5P68-507K-62PM-3K5E
CQtTgzPww_Wkh12eCg,1720893463,SILPO,5411,5411,-49800,-49800,980,0,0,3729694,False,2A92-44M9-7XB9-3TT3
pzDJqe6FAnxHqdF5fQ,1720872575,Ponchyk Boy | –û–ª–µ—Å—è –ì–æ–Ω—á–∞—Ä–∞,5812,5812,-31300,-31300,980,0,0,3779494,False,AEEX-7HM1-0HHK-MK1E
qvWOb-MDQxasWr4odg,1720871594,Brewers,5814,5814,-44300,-44300,980,0,0,3810794,False,AMAH-3PKH-X863-7H3E
3S09W-xA5gT_y5Gp7g,1720870639,FatTonny,5814,5814,-61800,-61800,980,0,0,3855094,False,MPBT-CB2P-MTH8-KEA1
A8OCohC0J3apfs218Q,1720867821,HLIBBOV,5499,5499,-6000,-6000,980,0,0,3916894,False,7245-EC6P-78XE-3519
DrOeiGs82_5jKXH7VQ,1720865757,Kebabgrill,5812,5812,-20000,-20000,980,0,0,3922894,False,79P8-H1CE-1C4T-55B6
Aun9ZhBDNLGbvliL1g,1720861629,KASA DOBROPARK,7991,7991,-70000,-70000,980,0,0,3942894,False,X167-7PA5-PB9K-6BA0
w4pL1x5XXRseu42FWA,1720857235,LIQPAY*Seizo,7230,7230,-20000,-20000,980,0,0,4012894,False,CT86-1C1B-P939-46TK
1qXY95QlaoyI6KnRcg,1720856897,Novapay,8999,8999,-5000,-5000,980,0,0,4032894,False,215E-785H-448E-PC84
Bep74UPYUkC2xVVucA,1720806414,Yaroslaviv Val 37-1,5921,5921,-26800,-26800,980,0,0,4037894,False,CB5K-MCP6-5926-62E8
i3hcUi8O8MXtY1OfBw,1720803851,"–ö–∞—Ñ–µ ""–ö–æ–º–µ—Ç–∞""",5812,5812,-52300,-52300,980,0,0,4064694,False,BTE3-P5XK-E5BM-6839
fCydu3egzudm4AY9Ww,1720803204,Restaurant prague,5812,5812,-32000,-32000,980,0,0,4116994,False,MHK3-8C56-M82C-4E0X
xcV_vIzVN8YPTjtATA,1720801871,"""–ì—ñ–ª—å–¥–∞"" –≤–µ—Ä–º—É—Ç–µ—Ä—ñ—è –Ω–∞ –ó–æ–ª–æ—Ç–∏—Ö",5812,5812,-16500,-16500,980,0,0,4148994,False,18M7-55PK-31PP-HEMC
zCjb1BdgVqlTUS0Edw,1720769356,Bestwaytocup,5814,5814,-19000,-19000,980,0,0,4165494,False,HMXA-CC23-HXP5-45H5
l2UIMK5XBa1mOP8wxg,1720768894,FOP Shevchenko,5499,5499,-8000,-8000,980,0,0,4184494,False,6CET-AMP1-XM1K-8K0M
PgqEY6Gb93wemBao1w,1720768686,414962****9431,4829,4829,-15800,-15800,980,0,0,4192494,False,0T0A-MH36-3X0T-46H1
6uXZUl7po_x3ZlrVKw,1720768563,414949****2985,4829,4829,-10050,-10050,980,0,0,4208294,False,16C7-13C0-PKE7-BABK
LZGHXW9wVIitjm7ehg,1720728230,Novapay,8999,8999,-5350,-5350,980,0,0,4218344,False,X233-M61T-1H63-1096
MOfiXqMhw4gtBjO0NQ,1720720399,Noodes,5812,5812,-107500,-107500,980,0,0,4223694,False,KC5P-PBX3-5KPM-9A47
TTjimSet8f6HiEA_KQ,1720680046,–ü–ª–∞—Ç—ñ–∂ svit-matrasiv.com.ua,4829,4829,-335700,-335700,980,0,0,4331194,False
MfmiD4OFS4z7XoS-Fg,1720678991,–°—ñ–ª—å–ø–æ,5411,5411,-71984,-71984,980,0,0,4666894,False,M1CH-492C-9891-6T58
pSTNz9Q2ixiF2oFpWg,1720632684,–í–µ–∑—É–≤—ñ–æ –ü—ñ—Ü–∞,5814,5814,-31000,-31000,980,0,0,4738878,False,BPH9-1KCX-574M-CCAK
wOXRkmulFossp6iSwA,1720632666,KAFE-PITSERIIA,5814,5814,-15000,-15000,980,0,0,4769878,False,1P7M-5M3K-H022-E532
-Zu9fs2rMr5xDeoB7Q,1720623883,–°–ü√â–õ–¨–¢–ê,5812,5812,-63300,-63300,980,0,0,4784878,False,BB43-C38M-HM6T-PKX3
DHUAVPyOrZTDa-xDGg,1720618493,PivnichniyzaYizd,7523,7523,-10000,-10000,980,0,0,4848178,False,6768-B7PM-8P15-62T8
6DFpgICdS-xz-RPzag,1720610687,TITKA KLARA,5814,5814,-13500,-13500,980,0,0,4858178,False,CT31-TX50-C8X5-E6B7
6j-87LGC95TrIDwE0Q,1720610606,–ü—Ä–æ–¥—É–∫—Ç–æ–≤–∞ –õ–∞–≤–∫–∞,5499,5499,-3800,-3800,980,0,0,4871678,False,H0C0-3X77-6352-7BXP
ObhN7B6AuXOK9lBSOA,1720599368,Kafe Mariia,5812,5812,-26400,-26400,980,0,0,4875478,False,13KK-885P-A1KB-CAB7
RuL3U1_ljiMIfzds9A,1720598395,Bolt,4121,4121,-7500,-7500,980,0,0,4901878,False,T81P-C854-AP4X-ATET
-XV5Lo0TKFeyv5RhIA,1720592822,Right coffee bar,5814,5814,-10000,-10000,980,0,0,4909378,False,B37M-C8BT-9PCB-XA78
a8iId4_swltku_QKDQ,1720592431,Lesya,4829,4829,-150000,-150000,980,0,0,4919378,False,0KK7-P490-EH61-MA8K
0Xp_xfIQ0gbZ3YOWBw,1720592420,–ü–æ–ø–æ–≤–Ω–µ–Ω–Ω—è ¬´36 –¥—Ä—É–∑—ñ–≤¬ª,4829,4829,-100000,-100000,980,0,0,5069378,False,HAE3-5434-6E84-8K21
NTYTw58jX_OKuWgPGw,1720557390,WFP.GROCERY1,5499,5499,-60420,-60420,980,0,0,5169378,False,PC9C-50HH-30PB-5HBK
ELDFJxonMbA9I5zhZg,1720549767,AVANGARDEN,5812,5812,-48400,-48400,980,0,0,5229798,False,772A-774H-59K8-M1E7
p71wgROLTE3MHFsT8Q,1720547662,Yaroslaviv Val 37-1,5921,5921,-7700,-7700,980,0,0,5278198,False,B99M-04AA-104H-0612
1azXfAlV3GOs-7hjiw,1720539198,Novapay,8999,8999,-8000,-8000,980,0,0,5285898,False,X8AP-9EKX-1T83-M492
-joctpu2kFr4Y_8AGQ,1720520067,GERC UA APAY UTIL,4900,4900,-101838,-101838,980,0,0,5293898,False,A30H-BPMA-1HCH-8B06
sF-jRqFV2z-_W73oaA,1720514537,–íi–¥: –ü–†–ò–•–û–î–¨–ö–û –ï.–í. –§–û–ü,"–î–ª—è –ø–æ–ø–æ–≤–Ω–µ–Ω–Ω—è –∫–∞—Ä—Ç–∫–∏ 5375414101190360, –ü—Ä–∏—Ö–æ–¥—å–∫–æ –ï—Ä–Ω–µ—Å—Ç –íi–∫—Ç–æ—Ä–æ–≤–∏—á, 3487403339",4829,4829,5200000,5200000,980,0,0,5395736,False
YcdV2CdWmjx5ab52Vg,1720509503,Bestwaytocup,5814,5814,-24000,-24000,980,0,0,195736,False,4M9C-C8TP-XKA4-BK80
2RqlrZXRgDutzr5Mmw,1720462816,–ü—Ä–æ–¥—É–∫—Ç–∏,5499,5499,-8300,-8300,980,0,0,219736,False,9K7P-8X88-TE1H-A37K
AhhURZHkVTloGZjyJQ,1720461873,WineTime,5921,5921,-10400,-10400,980,0,0,228036,False,A4MX-1AEB-HB71-5P3M
RgCpKgpT8C-bCvHtzQ,1720439975,–ü—Ä–æ–¥—É–∫—Ç–æ–≤–∞ –õ–∞–≤–∫–∞,5499,5499,-3200,-3200,980,0,0,238436,False,E647-51E7-KMTB-6K25
P_gVY-s8DcGzl1_ifw,1720439892,TITKA KLARA,5814,5814,-13500,-13500,980,0,0,241636,False,0E81-60A5-C666-6HHB
0FuUvwfrS2hDrYqBJg,1720430625,–ú—ñ—Å—å–∫–µ –∫–∞—Ñ–µ –•–∞—Ä–º—Å,5812,5812,-7600,-7600,980,0,0,255136,False,H3BC-111T-ECM6-6TE0
oGye2QC3o3huwFg47g,1720419544,Bestwaytocup,5814,5814,-26500,-26500,980,0,0,262736,False,4H28-HT3X-TBBK-5H04
quW0fe7y55FBSfT4_Q,1720419346,Novus,5411,5411,-2812,-2812,980,0,0,289236,False,2K6T-T46M-5K11-2361
CMXWcmhY3QQvI1RUow,1720376671,–°—ñ–ª—å–ø–æ,5411,5411,-24300,-24300,980,0,0,292048,False,9P68-BCPA-4TAX-M5BT
CZjQXhPJBkCOOu9hcg,1720366599,EasyPay,5411,5411,-179420,-179420,980,0,0,316348,False,E066-PAAM-2PCH-8P20
do0GE2ATsIjJhFXxlw,1720366444,–ó –±—ñ–ª–æ—ó –∫–∞—Ä—Ç–∫–∏,4829,4829,300000,300000,980,0,0,495768,False
ifVeI24HCbnP1cbPnA,1720364765,Socar,5541,5541,-6700,-6700,980,0,0,195768,False,4KTP-H654-132P-90C5
wl1AbnxR-bYWyOb9Vw,1720343857,MasterZoo,5995,5995,-20400,-20400,980,0,0,202468,False,A5E3-6XB3-65MA-3114
6QJYjU3ryf-e78QiQg,1720343712,ULTRAMARKET,5411,5411,-175881,-175881,980,0,0,222868,False,KMA4-5E3T-862B-1H40
UEICVDOPqR_jAfkf6g,1720289760,TSUM,7523,7523,-20000,-20000,980,0,0,398749,False,E0X0-0KX8-M0B7-6B41
8XrmHaFLg0X17ytI2A,1720289432,SENS NA KHRESHCHATYKU,5942,5942,-21200,-21200,980,0,159,418749,False,PM24-4236-BE46-9MM5
IgygVjLu9dR6qNnzrA,1720283374,–°–∏—Ä–Ω–µ –∫–æ—Ä–æ–ª—ñ–≤—Å—Ç–≤–æ,5451,5451,-14500,-14500,980,0,0,439949,False,9HC9-383H-82T0-BM5A
E1KExgW0GKA0ej41ug,1720282827,KINOTEATR,7832,7999,-10000,-10000,980,0,0,454449,False,0K0K-83TC-PM9E-XH2P
XIn0gH5_vVGWgMlSbg,1720282464,–ó –±—ñ–ª–æ—ó –∫–∞—Ä—Ç–∫–∏,4829,4829,200000,200000,980,0,0,464449,False
ipBIyIHn2PMRke-lJQ,1720268859,magazin 742478,5912,5912,-54360,-54360,980,0,0,264449,False,HAP1-C4EP-E6H4-4AEM
Qsh33t60a8o2qwzaUw,1720267325,NUANCECOFFEE,5814,5814,-27500,-27500,980,0,0,318809,False,CHPA-794H-HKHH-06X3
O7ijZLGTt6jSD3PTAQ,1720266238,SHOP BAR KONTEYNER,5812,5812,-9300,-9300,980,0,0,346309,False,M66E-TBHA-669T-0BH1
--aM8Ifi3keB-6KxiA,1720264933,BurgerFarm,5814,5814,-17100,-17100,980,0,0,355609,False,37HH-72C6-884X-K983
Yj_wRDG7v7uyfC3FEw,1720264079,SHOP BAR KONTEYNER,5812,5812,-67400,-67400,980,0,0,372709,False,2XBP-ETPB-P5A9-E9T0
ffINzQtK0sv8p4bIlQ,1720260768,–ï–ø—ñ—Ü–µ–Ω—Ç—Ä,5211,5211,-119000,-119000,980,0,0,440109,False,137X-BP06-PPM9-H5HK
Qm94bgiLZgKOSYMM6w,1720260479,–ó –±—ñ–ª–æ—ó –∫–∞—Ä—Ç–∫–∏,4829,4829,400000,400000,980,0,0,559109,False
fDSa2mIX59DGXuzFmQ,1720258214,–ï–ø—ñ—Ü–µ–Ω—Ç—Ä,5200,5200,-3550,-3550,980,0,0,159109,False,61BT-2CEM-735M-3CE3
6ibVx0mG4JdNQkQI_Q,1720255514,–°–ø—ñ–ª—å–Ω–æ—Ç–∞,5812,5812,-54500,-54500,980,0,0,162659,False,1682-1BX8-17BT-B47M
E7p31p9KwAuE02-xbg,1720251880,CentralniyzaYizd,7523,7523,-10000,-10000,980,0,0,217159,False,MCAM-85CX-99K5-5KT5
ZTWfZlqZm6VOc7xuEw,1720244515,KLO,5541,5541,-253150,-253150,980,0,0,227159,False,X880-6C73-KTHK-4TKH
V3hrc84JDckb9EAMLA,1720202878,–°—ñ–ª—å–ø–æ,5411,5411,-108547,-108547,980,0,0,480309,False,48X6-C8C9-E4HB-HTC5
SyrypiLe0tByM_BCpg,1720200611,–°–∫–∞—Å—É–≤–∞–Ω–Ω—è. Bolt,4121,7999,5000,5000,980,0,0,588856,False
RCDV3r8DudIfVqGUqQ,1720200544,Bolt,4121,7999,-5000,-5000,980,0,0,583856,False
QgRtmNsZrJL4M-Q_mg,1720198842,TUTMARKET,5499,5499,-3100,-3100,980,0,0,588856,False,X5AA-241E-M1C5-9CEE
icq0Vgj1J0PNF8rPQg,1720185723,KFC,5814,5812,-22000,-22000,980,0,0,591956,False,PMMP-BTE4-7P8M-H7BT
vr5FGAU88TJM8YnjvA,1720165166,Novus,5411,5411,-17816,-17816,980,0,0,613956,False,A1AK-0PPP-574C-4180
NRkGkIyJnRT8vV5ltA,1720162616,Bestwaytocup,5814,5814,-26500,-26500,980,0,0,631772,False,1C1C-MB51-P628-A8T9
xfTbhrRP2pcRMiZp2Q,1720160551,–ü–ª–∞—Ç—ñ–∂ Rozetka,4829,4829,-425800,-425800,980,0,0,658272,False
eClNE6mmNgvdWUzUlg,1720117176,SVit Gela,5814,5814,-18600,-18600,980,0,0,1084072,False,6789-2T17-P942-K1AE
GdErXF5pvVgvqhnHyw,1720114817,Naushi,5812,5812,-141600,-141600,980,0,0,1102672,False,C9AH-K25M-X315-C5XA
D1Xlwb70uboRNKimqA,1720111718,Novus,5411,5411,-102543,-102543,980,0,0,1244272,False,5K8A-1MXA-4366-5486
wFovkfkbcKppyJ2knQ,1720110334,Uklon,4121,4121,-300,-300,980,0,0,1346815,False,04PC-BB4K-1ECX-41BT
9aPMO3zP9KLmGWWNug,1720109587,–°–∫–∞—Å—É–≤–∞–Ω–Ω—è. Uklon,4121,4121,300,300,980,0,0,1347115,False
h8ItS4PKK0kdHyDUEw,1720109583,Uklon,4121,4121,-300,-300,980,0,0,1346815,False
Ta-rpYZzwsAkYPwaew,1720108226,Bestwaytocup,5814,5814,-10000,-10000,980,0,0,1347115,False,BPH2-KXAM-61H7-HC46
9vXU3tJ9eOuVyFDxqQ,1720107416,Uklon,4121,4121,-18200,-18200,980,0,0,1357115,False,5C0C-8H3M-AEXA-ATP6
A99yvHXUTKrYWpqw3A,1720093781,–ö–æ–ª–æ,5411,5499,-3800,-3800,980,0,0,1375315,False,M2TX-MHA3-7MXX-BE8C
haQWDBWh6VY3NZ5eFA,1720093600,DzhordzhianFUD,5499,5499,-19000,-19000,980,0,0,1379115,False,H4PC-8TK8-58B5-H1XP
O9hiVtMCjNjwS8CmCw,1720081917,LIQPAY*Poster QR,5812,5812,-11500,-11500,980,0,0,1398115,False,2AT9-H6AC-4B62-BPEK
5FNZsHx-hOSjFiVHag,1720079581,Prostor,5977,5977,-5000,-5000,980,0,0,1409615,False,KA8A-C7A4-K9H4-3H2E
BdeYOK6Hwp2gzXtSPw,1720035896,Novapay,8999,8999,-5970,-5970,980,0,0,1414615,False,8BH5-7894-X44C-TH4E
_xENBUSw4kRV0asMug,1720027957,EVA,5977,5977,-32700,-32700,980,0,0,1420585,False,7M6P-5P4K-K746-6B2E
o2jWVW8hqm5-Pq1pjQ,1720026891,–ö–ò–á–í–ì–ê–ó,5812,5812,-76500,-76500,980,0,0,1453285,False,5CT6-C32M-C43T-86EX
j4SvHVS2avpQMXzqGw,1720016194,OKKO,5541,5541,-15980,-15980,980,0,0,1529785,False,6T73-AK94-PA3T-A293
IJRN5opFoeNgKR-b-A,1719997864,–î–æ—Å—Ç—Ä–æ–∫–æ–≤–µ –ø–æ–≥–∞—à–µ–Ω–Ω—è –ê–õ–õ–û,4829,4829,-1633300,-1633300,980,0,0,1545765,False
S3SYYsh1rkBudKTSHQ,1719997827,–ü–µ—Ä–µ–∫–∞–∑ –Ω–∞ –∫–∞—Ä—Ç–∫—É,4829,4829,-2800000,-2800000,980,0,0,3179065,False
OMgnvWJA9i5EHHw-KQ,1719996182,Novus,5411,5411,-23398,-23398,980,0,0,5979065,False,0E0X-18E9-MM57-K1KA
2dYx0yB5uXAZq9l4rQ,1719995959,Novus,5411,5411,-21597,-21597,980,0,0,6002463,False,CK4P-7531-EB3E-354X
Ee0kBauXYR0dAih4rA,1719995425,Seizo,7230,7230,-85000,-85000,980,0,0,6024060,False,062B-H4EB-4THB-P96E
ascZ9oxRPCaGeAG7eA,1719989501,Bestwaytocup,5814,5814,-10000,-10000,980,0,0,6109060,False,AM02-8C81-KE66-3X09
jPntapLiR4kEySmklqDtHQ,1719962226,Bolt,4121,7999,-4103,-4103,980,0,0,6119060,True
8xGx4AEQJ2JKD1grsBJturjEBis,1719962226,–°–∫–∞—Å—É–≤–∞–Ω–Ω—è. Bolt,4121,7999,5000,5000,980,0,0,6123163,False
59lJ0KoTzO9o-2uXtA,1719940797,OK Wine,5921,5921,-22350,-22350,980,0,0,6118163,False,7AHT-EMB2-H19X-698P
KGYkcWQHrAyNu2Hs_w,1719940638,La Fabrique,5814,5814,-2500,-2500,980,0,0,6140513,False,TA89-7988-T40T-17BP
qJM2nGhgKl1QvUfhFg,1719938343,OkvajnSichovih,5921,5921,-6900,-6900,980,0,0,6143013,False,6XBT-A87C-3B13-B135
9HRMyq2H8YplOeAAcg,1719932678,NUNU | –Ø—Ä–æ—Å–ª–∞–≤—ñ–≤ –í–∞–ª,5812,5812,-24700,-24700,980,0,0,6149913,False,K464-78CE-K9P6-H530
2-b5gdkpdfI_kpMWKA,1719924301,LIQPAY*Poster QR,5812,5812,-12500,-12500,980,0,0,6174613,False,B8CM-0M7H-77T2-PC6T
XOfqJEIMFNsdHX3TmQ,1719922765,LIQPAY*Poster QR,5812,5812,-34500,-34500,980,0,0,6187113,False,A9B3-4CBC-25B1-B0CC
F7NOdxoEkFXeOMSqqOKs5w,1719876164,Bolt,4121,7999,-2542,-2542,980,0,0,6221613,True
0nIkrlrbA03GlQIeyrxMGw,1719876164,Bolt,4121,7999,-2477,-2477,980,0,0,6224155,True
da0W8qCvz2xHj4345VWzmI-aWKg,1719876164,–°–∫–∞—Å—É–≤–∞–Ω–Ω—è. Bolt,4121,7999,5000,5000,980,0,0,6226632,False
8UBJpqY_JZvVJ2-OXHrOxyZzE7I,1719876164,–°–∫–∞—Å—É–≤–∞–Ω–Ω—è. Bolt,4121,7999,5000,5000,980,0,0,6221632,False
64qGdwi-0TYYqnW6NA,1719861257,–ü—Ä–æ–¥—É–∫—Ç–∏,5499,5499,-3100,-3100,980,0,0,6216632,False,P930-83X6-MEX8-9PEP
ItgS0zO8sBeUqU2TBQ,1719860069,–°—ñ–ª—å–ø–æ,5411,5411,-16400,-16400,980,0,0,6219732,False,E0A5-T65B-M7C7-7613
poC-LAvt_Y9Tb9VIlw,1719858071,Simona,5812,5812,-97800,-97800,980,0,0,6236132,False,T60T-X1H7-PPBK-E016
wm6BqDdvBXKO4UOWrA,1719849312,Bolt,4121,4121,-14700,-14700,980,0,0,6333932,False,7K9P-2X2T-6492-C3H8
GkEZHRQkEFcSiv1U7w,1719846640,SHIBUYA | –ù–∏–∂–Ω—ñ–π –í–∞–ª,5812,5812,-102800,-102800,980,0,0,6348632,False,3901-B4T7-B4T8-H904
jUd9YlbsLDPDUACB5g,1719842465,Bolt,4121,7999,-5000,-5000,980,0,0,6451432,False
i9szYYpVGtRb5CGBJA,1719831975,TSUM,7523,7523,-10000,-10000,980,0,0,6456432,False,959H-P9E7-T314-PBTA
idNk-c--APrlTWChTw,1719829866,Ponchyk Boy | –¶–£–ú,5812,5812,-20800,-20800,980,0,0,6466432,False,1K91-815X-3A36-B0T2
KpCGrDUTsJFKQQYW0Q,1719823576,–ü–æ–ø–æ–≤–Ω–µ–Ω–Ω—è ¬´–ù–∞ –∫–∞–º–ø—É—Ç—î—Ä –¥–ª—è –≥—Ç–∞6¬ª,4829,4829,-43200,-43200,980,0,0,6487232,False
yKnf4JSJCZhEhk6DSw,1719823563,–ü–æ–ø–æ–≤–Ω–µ–Ω–Ω—è ¬´–Ω–∞ –¥—Ä—ñ–º –≤–∞–Ω–Ω—É¬ª,4829,4829,-92000,-92000,980,0,0,6530432,False,190C-0APH-KEHX-4C3P
W65dyJNKfFKglVtsgg,1719823548,Lesya,4829,4829,-1500000,-1500000,980,0,0,6622432,False,2P9M-P1E6-7E0A-62E5
D6neYgtRNKf2Drs9Sg,1719823099,–íi–¥: –ü–†–ò–•–û–î–¨–ö–û –ï.–í. –§–û–ü,"–î–ª—è –ø–æ–ø–æ–≤–Ω–µ–Ω–Ω—è –∫–∞—Ä—Ç–∫–∏ 5375414101190360, –ü—Ä–∏—Ö–æ–¥—å–∫–æ –ï—Ä–Ω–µ—Å—Ç –íi–∫—Ç–æ—Ä–æ–≤–∏—á, 3487403339",4829,4829,7700000,7700000,980,0,0,8122432,False
9xiBSP2QIy4ojEOF3A,1719822037,"Lifecell
+380631692598",4814,4814,-27000,-27000,980,0,0,422432,False,C1KE-HAAA-X5CM-75CE
9OASUJ9tiK_UuQX-Xw,1719817582,Novus,5411,5411,-19295,-19295,980,0,0,449432,False,E11K-X7A0-P866-26H4
9GDdMtr7bSfxYbybfQ,1719815299,LIQPAY*TOV MLDILA,8099,8099,-307500,-307500,980,0,0,468727,False,9AAC-0PH5-A0K5-PXKM
9CDN9pWsncrIjZpuYA,1722243591,Lesya,4829,4829,-100000,-100000,980,0,0,561676,False,H0X1-55M2-HMXP-4T1K
skcV03GoIJIswdmPYA,1722133537,–†–µ–≥—É–ª—è—Ä–Ω–µ –ø–æ–ø–æ–≤–Ω–µ–Ω–Ω—è ¬´–§–æ–Ω–¥ –ü–æ–≤–µ—Ä–Ω–∏—Å—å –∂–∏–≤–∏–º¬ª,4829,4829,-25000,-25000,980,0,0,661676,False,6165-MEEP-P025-9102
K1ac7eF4clKceB--_w,1722079707,–ó —á–æ—Ä–Ω–æ—ó –∫–∞—Ä—Ç–∫–∏,4829,4829,600000,600000,980,0,0,686676,False
WhGikZJT5IjImBGrYQ,1721667539,–ñ–∞–Ω–Ω–∞ –ñ.,4829,4829,-250000,-250000,980,0,0,86676,False,466M-KXB3-7702-4CK6
Ix_GIoSuM__CIbsXNA,1721577122,–ü–µ—Ä–µ–∫–∞–∑ –Ω–∞ –∫–∞—Ä—Ç–∫—É,4829,4829,-100000,-100000,980,0,0,336676,False
q2jG6PLHJi6LArn2gg,1721561798,–ü–µ—Ä–µ–∫–∞–∑ –Ω–∞ –∫–∞—Ä—Ç–∫—É,4829,4829,-100000,-100000,980,0,0,436676,False
JTdezubZ38A0K0z6iA,1721549448,–ü–µ—Ä–µ–∫–∞–∑ –Ω–∞ –∫–∞—Ä—Ç–∫—É,4829,4829,-150000,-150000,980,0,0,536676,False
MSocV7KrCcUi4dfrkg,1721528803,–†–µ–≥—É–ª—è—Ä–Ω–µ –ø–æ–ø–æ–≤–Ω–µ–Ω–Ω—è ¬´–§–æ–Ω–¥ –ü–æ–≤–µ—Ä–Ω–∏—Å—å –∂–∏–≤–∏–º¬ª,4829,4829,-25000,-25000,980,0,0,686676,False,A012-AC00-43CE-AB60
EvZWvKRuDDMehZxb3w,1721381034,Lesya,4829,4829,-100000,-100000,980,0,0,711676,False,7C7P-443B-34E5-17KK
Ig33XzTgkUEoTsFHtQ,1721380829,Lesya,4829,4829,-400000,-400000,980,0,0,811676,False,2CBE-916M-TXP3-H46P
E_T4sDlwKCga2b0u2g,1721368993,Lesya,4829,4829,-3000,-3000,980,0,0,1211676,False,3425-4722-C287-3BH2
-9lnEo2SrBvY9exAZg,1721042811,Lesya,4829,4829,-400000,-400000,980,0,0,1214676,False,8E7C-X48X-A3B3-XB44
a4oZildNp2uccGiGgQ,1720960082,–ó —á–æ—Ä–Ω–æ—ó –∫–∞—Ä—Ç–∫–∏,4829,4829,1300000,1300000,980,0,0,1614676,False
2vaJbk2Q6mdPNjZQRw,1720923985,–†–µ–≥—É–ª—è—Ä–Ω–µ –ø–æ–ø–æ–≤–Ω–µ–Ω–Ω—è ¬´–§–æ–Ω–¥ –ü–æ–≤–µ—Ä–Ω–∏—Å—å –∂–∏–≤–∏–º¬ª,4829,4829,-25000,-25000,980,0,0,314676,False,24X8-28M0-49PH-E784
Y4JXoMsi7UizjgDcrg,1720514056,–ü–æ–ø–æ–≤–Ω–µ–Ω–Ω—è ¬´–ù–∞ –∫–∞–º–ø—É—Ç—î—Ä –¥–ª—è –≥—Ç–∞6¬ª,4829,4829,-18985,-18985,980,0,0,339676,False
kOis-CMIgAuJojz63A,1720513946,–ü–æ–ø–æ–≤–Ω–µ–Ω–Ω—è ¬´–Ω–∞ –¥—Ä—ñ–º –≤–∞–Ω–Ω—É¬ª,4829,4829,-50000,-50000,980,0,0,358661,False,7A64-2A91-E213-9TM6
VCS3EvM_g4FPQ_F1RQ,1720470900,–í—ñ–¥: –õ—é–±–æ–≤ –í—ñ–≥—É—Ä–∞,4829,4829,85000,85000,980,0,0,408661,False
HHAPPexY6j1s8gPUTA,1720456857,–§–û–ü –¶–µ–≥–µ–ª—å—Å—å–∫–∞ –†—É—Å–ª–∞–Ω–∞ –ú–∏—Ö–∞–π–ª—ñ–≤–Ω–∞,4829,4829,-170000,-170000,980,0,0,323661,False,A6X9-XC59-9A49-93A7
JZDvefGpZN_NFlvfKQ,1720454184,–ú—ñ—Å—å–∫–µ –∫–∞—Ñ–µ –•–∞—Ä–º—Å,5812,5812,-28600,-28600,980,0,0,493661,False,PE29-04K4-TAB9-32KA
wXeDyvcUeSkiQL45Ew,1720444581,–ñ–∞–Ω–Ω–∞ –ñ.,4829,4829,-250000,-250000,980,0,0,522261,False,7TAE-TBB7-CEE9-C16C
4fi3BM9mjZE7vk_LzA,1720374118,AVANGARDEN,5812,5812,-27000,-27000,980,0,0,772261,False,5H34-6XC9-H02M-770H
hM5XFOL5hZCCC4C3qg,1720366444,–ü–µ—Ä–µ–∫–∞–∑ –Ω–∞ –∫–∞—Ä—Ç–∫—É,4829,4829,-300000,-300000,980,0,0,799261,False
c5X1EJm-b8mjNVsGLw,1720319223,–†–µ–≥—É–ª—è—Ä–Ω–µ –ø–æ–ø–æ–≤–Ω–µ–Ω–Ω—è ¬´–§–æ–Ω–¥ –ü–æ–≤–µ—Ä–Ω–∏—Å—å –∂–∏–≤–∏–º¬ª,4829,4829,-25000,-25000,980,0,0,1099261,False,B76B-TXPC-K2H3-1048
Kest_n1Bj5am09we8Q,1720292550,20/2,5812,5812,-99000,-99000,980,0,0,1124261,False,362X-1E75-X80B-6HH9
brNfSsY46fvh-bdMbQ,1720282516,Lesya,4829,4829,-300000,-300000,980,0,0,1223261,False,14A4-6K63-6456-C9A8
zQtbMPLiBYexlY_WRw,1720282463,–ü–µ—Ä–µ–∫–∞–∑ –Ω–∞ –∫–∞—Ä—Ç–∫—É,4829,4829,-200000,-200000,980,0,0,1523261,False
gZ1_tEs4bSt2mb_QeA,1720260479,–ü–µ—Ä–µ–∫–∞–∑ –Ω–∞ –∫–∞—Ä—Ç–∫—É,4829,4829,-400000,-400000,980,0,0,1723261,False
6ilifFc3c-nL-Qt16g,1720018686,Lesya,4829,4829,-700000,-700000,980,0,0,2123261,False,5BAC-TBEP-3ETH-K7M0
vreFLLXcGObZskCm7g,1719997827,–ó —á–æ—Ä–Ω–æ—ó –∫–∞—Ä—Ç–∫–∏,4829,4829,2800000,2800000,980,0,0,2823261,False
dr10bNczGru6EC5M5A,1724952362,–°—ñ–ª—å–ø–æ,5411,5411,-88500,-88500,980,0,0,50543,False,M1HX-TX4X-ATKB-5PX6
tWsEpZPf6HMJkD2gJw,1724950566,–ó –±—ñ–ª–æ—ó –∫–∞—Ä—Ç–∫–∏,4829,4829,100000,100000,980,0,0,139043,False
z5_kYQjns11GbVqt-A,1724855486,Novapay,8999,8999,-5500,-5500,980,0,0,39043,False,XKP4-4CT3-73T9-4P8K
9KJiqLTDz8IbwEbaHQ,1724854518,Novus,5411,5411,-9697,-9697,980,0,0,44543,False,KBBM-8XC8-15X9-0BB2
fK6oKve6Qg7y9EBP-Q,1724854379,–ó –±—ñ–ª–æ—ó –∫–∞—Ä—Ç–∫–∏,4829,4829,40000,40000,980,0,0,54240,False
4NrKn_U9KvOZzzHN3w,1724853417,PHotosalonMAN,7221,7221,-1500,-1500,980,0,0,14240,False,B8XC-HEC4-4HKM-H24A
n9MVNvGenYYTmHggbw,1724846461,Wfp.aquamarket,5499,5499,-50480,-50480,980,0,0,15740,False,14A6-381E-TB01-0C26
xSwJQvg7HdAi4-w68g,1724828376,Novus,5411,5411,-12498,-12498,980,0,0,66220,False,XMKB-2ME1-K646-2A7P
5IuSPnNN1bJJ-Tc1nA,1724762270,–ê–ø—Ç–µ–∫–∞ –ê–ù–¶,5912,5912,-31500,-31500,980,0,0,78718,False,37ME-K423-H5E5-K80K
DkgbpGbE8Iwmh_oIzQ,1724762042,–°—ñ–ª—å–ø–æ,5411,5411,-13100,-13100,980,0,0,110218,False,7P5P-6XK7-86P1-8300
pH3zUi2Bu1SujPikCA,1724743813,–ù–æ–≤–∞ –ø–æ—à—Ç–∞,7399,7399,-5500,-5500,980,0,0,123318,False,T8T9-CMKB-TE61-4CTP
Y2KPqG-JrXzCyIdfTw,1724742495,PHotosalonMAN,7221,7221,-4000,-4000,980,0,0,128818,False,0T97-CB76-8212-C538
CcHI463H_gvJET-4nA,1724685035,Novus,5411,5411,-11698,-11698,980,0,0,132818,False,BA06-9B93-89AX-48B4
IGw0ykbLZjDrHlQwpw,1724667998,Steam,5816,5816,-9900,-9900,980,0,0,144516,False,H57A-68BM-0761-3EM0
eMRUMuxFQjxU0zMAjw,1724598345,Beerplace,5814,5814,-25500,-25500,980,0,0,154416,False,HTT0-6EM2-02M3-T6X2
Ut5y2JVuvmCnmasgnA,1724587637,–ö–≤—ñ—Ç–∏,5992,5992,-45000,-45000,980,0,337,179916,False,HB73-9BXM-KT91-PHT8
QcH3KKbhsnVx4rVZhA,1724587240,–ü—Ä–æ–¥—É–∫—Ç–∏,5499,5499,-4500,-4500,980,0,0,224916,False,M99X-BK44-BXXP-B1PA
eem2HiuIqGfSnQWB2g,1724574348,A 2068 APTEKA,5912,5912,-7900,-7900,980,0,0,229416,False,1981-3A7C-T805-ATK6
V-G06xWk4W2GyW38OQ,1724510645,GelatoMama,5814,5814,-32000,-32000,980,0,0,237316,False,002P-8EHH-XX4K-42T7
dJdcvQjDt8cBcShUTw,1724507450,–í–∏–ø–ª–∞—Ç–∞ –±–∞–Ω–∫–∏ ¬´–ù–∞ –∫–∞–º–ø—É—Ç—î—Ä –¥–ª—è –≥—Ç–∞6¬ª,4829,4829,260291,260291,980,0,0,269316,False
pdJIJWIUvqHCL_ofsA,1724495153,–°—ñ–ª—å–ø–æ,5411,5411,-35200,-35200,980,0,0,9025,False,BT7X-MMX1-C67E-AMHX
eh7cYBuiFFo_2-FV_Q,1724493686,FIRST POINT Espresso Bar,5812,5812,-65500,-65500,980,0,0,44225,False,X26P-9135-892M-14M7
UyykfedWhokDvuqgmA,1724432294,Novus,5411,5411,-16796,-16796,980,0,0,109725,False,T5CE-TTK8-XX3E-A999
VydiUpBLx0VWS2ZZ_w,1724431832,–ù–æ–≤–∞ –ø–æ—à—Ç–∞,7399,7399,-8000,-8000,980,0,0,126521,False,2P67-KX6P-X70K-A24B
u8hWEc9UwTEzKs-ifA,1724429958,GelatoMamma,5814,5814,-24000,-24000,980,0,0,134521,False,A896-XX2B-ACPC-XHP5
zQG06QYNlXXLQnJ74Q,1724405242,PHotosalonMAN,7221,7221,-37500,-37500,980,0,0,158521,False,HC21-7PX8-B2P2-C9CP
pBiGoc6x7DG3QSy13Q,1724404282,–ó –¥–æ–ª–∞—Ä–æ–≤–æ—ó –∫–∞—Ä—Ç–∫–∏,4829,4829,184815,4500,840,0,0,196021,False
8Ozinfx-2j595NIrBw,1724404258,FOP Shevchenko,5499,5499,-7000,-7000,980,0,0,11206,False,01MP-6EEH-APE3-1K6X
UYi3YFwLbpOsbCHA0g,1724347893,Novus,5411,5411,-28595,-28595,980,0,0,18206,False,0645-HM10-51HT-B74H
ckb0E42rYW4kCwARqQ,1724346262,–°—ñ–ª—å–ø–æ,5411,5411,-82100,-82100,980,0,0,46801,False,0189-K9X4-72MH-011B
zYiq4H4w2DwkdSx_1w,1724260348,–°—ñ–ª—å–ø–æ,5411,5411,-24985,-24985,980,0,0,128901,False,PH9M-HC47-38H1-AK62
lCsyBIcGLJF-Nktggg,1724259412,–ó –±—ñ–ª–æ—ó –∫–∞—Ä—Ç–∫–∏,4829,4829,100000,100000,980,0,0,153886,False
-mc_uPGsuXqgjpNPWg,1724247787,OK Wine,5411,5411,-14900,-14900,980,0,0,53886,False,47P9-M99T-AX62-879P
oWQAeoEWw67hLSlw8A,1724247651,–ù–æ–≤–∞ –ø–æ—à—Ç–∞,7399,7399,-5500,-5500,980,0,0,68786,False,M8PE-78X6-46BA-CP18
v3wqQ5F86BiFSuxeWA,1724238478,PHotosalonMAN,7221,7221,-29500,-29500,980,0,0,74286,False,XBXH-7P18-553X-E037
MNBGIHvk8_MXGsLYHQ,1724149481,Novus,5411,5411,-3499,-3499,980,0,0,103786,False,P5E5-TA63-T0K2-27EB
CA7XK-sA-4Qv5Z-X9Q,1724146990,–ü–∞—Ä–∫–æ–≤–∫–∞,7523,7523,-16000,-16000,980,0,0,107285,False,H193-K73K-7PA0-3532
RP6y17YbQ92e4r6dBw,1724142890,–∫–∞–≤‚Äò—è—Ä–Ω—è –ü–∞—Ä–∫—ñ–Ω–≥,5812,5812,-9400,-9400,980,0,0,123285,False,559K-7TMM-52TB-6CH5
F4vn9Ga0-ro6BZaM7Q,1724088188,–°—ñ–ª—å–ø–æ,5411,5411,-8300,-8300,980,0,0,132685,False,5154-63XM-1508-7821
qcAcTafxZWBdvMKeaA,1724071106,Wfp.aquamarket,5499,5499,-106580,-106580,980,0,0,140985,False,BT46-BP96-THE7-MX71
FRJqykckEo2Mlbvg-g,1724071080,–ó –±—ñ–ª–æ—ó –∫–∞—Ä—Ç–∫–∏,4829,4829,200000,200000,980,0,0,247565,False
p8VDtw8sFzGluwV50w,1723990800,LIQPAY*Poster QR,5812,5812,-30900,-30900,980,0,0,47565,False,B1A6-XXTP-3378-EXM8
ulEWn8CBRtZQdMxpRg,1723990772,–ó –±—ñ–ª–æ—ó –∫–∞—Ä—Ç–∫–∏,4829,4829,50000,50000,980,0,0,78465,False
pwJ9WLK9LB6fGztlOg,1723976812,–§–ö –ï–í–û,5399,5399,-59900,-59900,980,0,0,28465,False,CX11-7CM8-3T34-X7M7
t2_Tn-Ekq1RQUwSEnQ,1723976298,Novus,5411,5411,-10255,-10255,980,0,0,88365,False,3HP0-0A8B-97XP-PPEA
9-Vnl_I2HnQj1fiWTQ,1723975102,VARUS,5499,5411,-11640,-11640,980,0,0,98620,False,4P1A-4TP0-9BM9-ETPM
jEY72QXUImK23DyCKA,1723974951,–ó –±—ñ–ª–æ—ó –∫–∞—Ä—Ç–∫–∏,4829,4829,100000,100000,980,0,0,110260,False
zqqLZhtlCUOYI_G-5g,1723968391,Best Way To Cup,5814,5814,-16000,-16000,980,0,0,10260,False,7MH1-HA0A-6BEH-M08A
7sIVMCfMimjN87GTDQ,1723965274,Best Way To Cup,5814,5814,-53000,-53000,980,0,0,26260,False,MC8P-7572-C125-7H05
kMxkAj1CM-bis9fbAPyOhQ,1723935500,Bolt,4121,7999,-2151,-2151,980,0,0,79260,True
wpGVLA3nCK8wtY7fTI4JvOwW1XE,1723935500,–°–∫–∞—Å—É–≤–∞–Ω–Ω—è. Bolt,4121,7999,5000,5000,980,0,0,81411,False
DjraUULFuFnlvJULqQ,1723908638,–°—ñ–ª—å–ø–æ,5411,5411,-16850,-16850,980,0,0,76411,False,TMKB-15PT-K76A-7675
rqlJC4t9N36GZBA4ow,1723908607,–ó –±—ñ–ª–æ—ó –∫–∞—Ä—Ç–∫–∏,4829,4829,50000,50000,980,0,0,93261,False
EPL7Qq3JJ2oV1Uqdqg,1723900652,–°—ñ–ª—å–ø–æ,5411,5411,-10847,-10847,980,0,0,43261,False,X52H-9EE3-5843-PAH4
-RXWxK_pAYlSzeMUaQ,1723900643,–ó –±—ñ–ª–æ—ó –∫–∞—Ä—Ç–∫–∏,4829,4829,50000,50000,980,0,0,54108,False
HQeDfNIM24n8VlUE6Q,1723879619,Best Way To Cup,5814,5814,-8000,-8000,980,0,0,4108,False,3TKB-TE4K-699M-8T09
SVqOCA2ga3fTluryvg,1723878807,Best Way To Cup,5814,5814,-54500,-54500,980,0,0,12108,False,TK4B-MTXT-2245-EEBC
45ypGa0hLWfJPNFueQ,1723829195,Konteiner,5814,5814,-9000,-9000,980,0,0,66608,False,116E-178M-0E94-H4H5
xwyrcWcdsWzEAwnxGw,1723828963,BARMAGAZiN,5814,5814,-26500,-26500,980,0,0,75608,False,9PT6-X06K-BTE3-PC23
J8SzMt8mfVVr4Gs7Gw,1723828493,–ó –±—ñ–ª–æ—ó –∫–∞—Ä—Ç–∫–∏,4829,4829,50000,50000,980,0,0,102108,False
NbBWUQcQdbaprDfz2A,1723826547,–ê–ø—Ç–µ–∫–∞ –ê–ù–¶,5912,5912,-42084,-42084,980,0,0,52108,False,M5AE-TA9X-C45P-ECA2
vkTblFpHjxsyAkJA7g,1723825573,Beerplace,5814,5814,-39500,-39500,980,0,0,94192,False,EP90-3T8A-66AT-M542
umJMYqEQ18i5I-8TzA,1723825427,–ó –±—ñ–ª–æ—ó –∫–∞—Ä—Ç–∫–∏,4829,4829,110000,110000,980,0,0,133692,False
cZOPiEJPah62aY2jLg,1723791391,Bolt,4121,7999,-5000,-5000,980,0,0,23692,False
QnzM3ECfYUnRKdK8jA,1723789384,FOP Shevchenko,5499,5499,-11000,-11000,980,0,0,28692,False,M6BX-5A0E-2M6C-4578
pCGCdLwjYTtpPXUdowkZqQ,1723763248,Bolt,4121,7999,-2450,-2450,980,0,0,39692,True
GTiww_8KEvERy1b0CAWlO6QOf68,1723763248,–°–∫–∞—Å—É–≤–∞–Ω–Ω—è. Bolt,4121,7999,5000,5000,980,0,0,42142,False
ZyLeDPASGj0OzZtV-g,1723706303,–ù–æ–≤–∞ –ø–æ—à—Ç–∞,7399,7399,-53400,-53400,980,0,0,37142,False,TP52-75T6-M7TE-1X2M
NNps29fmTHe7pr7__w,1723656114,Novus,5411,5411,-4798,-4798,980,0,0,90542,False,M266-T25C-X60T-378E
mmkyj3hYRrl1mYOTdw,1723655318,Prostor,5977,5977,-8780,-8780,980,0,0,95340,False,CE5M-P251-785B-P856
AwArJ_fWaq7o-95-Zw,1723622785,Bolt,4121,7999,-5000,-5000,980,0,0,104120,False
rUA6QlIChZIQBKeqKFcZjA,1723504221,Bolt,4121,4121,-12000,-12000,980,0,0,109120,True
l5EMpXDcmcCNvz-MIFSDbyLPcPc,1723504221,–°–∫–∞—Å—É–≤–∞–Ω–Ω—è. Bolt,4121,4121,11000,11000,980,0,0,121120,False
_xM7-fpF_aweu0mljQ,1723481376,–°—ñ–ª—å–ø–æ,5411,5411,-19029,-19029,980,0,0,110120,False,2KCK-HM6P-P9B5-XK10
jPKdbjKKIdczMFYY2A,1723479303,magazin 762597,5912,5912,-5020,-5020,980,0,0,129149,False,HX54-BBXH-T153-3P03
FN3RjTdKH8O6eMFo9Q,1723458909,–ó –±—ñ–ª–æ—ó –∫–∞—Ä—Ç–∫–∏,4829,4829,100000,100000,980,0,0,134169,False
jJxh1Qlajohjq2Ri7g,1723451467,Bolt,4121,4121,-11000,-11000,980,0,0,34169,False,HM8T-T30P-T7PT-9C3E
dJPj22-PPShhnXff3Q,1723448378,Bolt,4121,4121,-11000,-11000,980,0,0,45169,False
vmKnPMrRl2FWDnC1Wg,1723389864,Beerplace,5814,5814,-26500,-26500,980,0,0,56169,False,K7H1-M0P8-901B-T8XE
MBmclGba_3niGaYe1g,1723388020,–ó –±—ñ–ª–æ—ó –∫–∞—Ä—Ç–∫–∏,4829,4829,100000,100000,980,0,0,82669,False
x4SnTzV4i7qQKhP3FA,1723357709,–ü–ª–∞—Ç—ñ–∂ svit-matrasiv.com.ua,4829,4829,-335700,-335700,980,0,0,-17331,False
sCNH27avHYouBtI29FS2fw,1723331762,Bolt,4121,7999,-3934,-3934,980,0,0,318369,True
SC2DcxUbdJraCPRkcQBDeKVhZFU,1723331762,–°–∫–∞—Å—É–≤–∞–Ω–Ω—è. Bolt,4121,7999,5000,5000,980,0,0,322303,False
Ffs2tyrd2E1pNp6FYg,1723310455,–°—ñ–ª—å–ø–æ,5411,5411,-27960,-27960,980,0,0,317303,False,5MKE-K559-0MMP-308B
s_s6MfS192PMWLMLTw,1723299673,Novus,5411,5411,-91845,-91845,980,0,0,345263,False,0745-H137-25K9-7AX4
5-gtESM6ABnyX7xe0Q,1723297609,LIQPAY*Poster QR,5812,5812,-15800,-15800,980,0,0,437108,False,PXT5-C55T-5639-86M7
n0bl8jgPY07Zzd7MMA,1723296255,LIQPAY*Poster QR,5812,5812,-19300,-19300,980,0,0,452908,False,88C7-B70K-66B4-B16P
LFuL5orqax37vJk7ng,1723294105,Prostor,5977,5977,-5360,-5360,980,0,0,472208,False,PEH9-EMK2-3094-BMAH
baM-z80nSDUf1ruIGg,1723285243,–ö–∏—ó–≤ –¶–∏—Ñ—Ä–æ–≤–∏–π,4111,4111,-17500,-17500,980,0,0,477568,False,35X4-8K34-A8MM-E4E4
u2_hQOLDYBOVbKsbnA,1723280226,–§–ö –ï–í–û,5399,5399,-3800,-3800,980,0,0,495068,False,EEK7-MEKB-6H7P-X4KC
dDK0ysT-lKkocrv8bg,1723279325,–ö–≤—ñ—Ç–∏,5992,5992,-65000,-65000,980,0,487,498868,False,C859-1HBB-5673-9CBE
tp6TSyj5Z6PUyFCYGA,1723274707,RIZNI,5812,5812,-62000,-62000,980,0,0,563868,False,C89C-A6MP-XACK-H055
j85m3rdPHA-rWQm-QA,1723274476,Prostor,5977,5977,-12100,-12100,980,0,0,625868,False,2EEE-PM4C-43AE-1897
y_QBKDDL4lxRy9-U6A,1723229444,–í—ñ–¥: –û–ª–µ—Å—è –°–∞—á–µ–Ω–∫–æ,4829,4829,335000,335000,980,0,0,637968,False
DZG1hNFSYxv862gDlA,1723228750,Novapay,8999,8999,-10350,-10350,980,0,0,302968,False,78M3-04X1-8640-972H
49wfPfZSh_xq0wyM-A,1723226485,–°—ñ–ª—å–ø–æ,5411,5411,-56900,-56900,980,0,0,313318,False,62E3-5T8H-K260-BXK9
gNpHTzxb6JFyle71zQ,1723217258,OK Wine,5411,5411,-6900,-6900,980,0,0,370218,False,XMA8-1795-KK77-A06H
xkTsp7h4wXXESn__Sw,1723191036,Bolt,4121,7999,-5000,-5000,980,0,0,377118,False
AkPd86aWspedybZQdw,1723183353,Novapay,8999,8999,-7000,-7000,980,0,0,382118,False,TK68-7EK4-CT45-61AC
2nRHieRqqQBZ4qqa88SyXw,1723165965,Bolt,4121,7999,-2388,-2388,980,0,0,389118,True
mwdeKIVI72d19EoKBgwZf81Z_hU,1723165965,–°–∫–∞—Å—É–≤–∞–Ω–Ω—è. Bolt,4121,7999,5000,5000,980,0,0,391506,False
00Ld24GJhObxQA2L-g,1723129057,Seizo,7230,7230,-55000,-55000,980,0,0,386506,False,234T-ATT3-E21X-2T5B
LcPuHCYGzyDeR6wgvg,1723098327,Wfp.aquamarket,5499,5499,-34580,-34580,980,0,0,441506,False,BMBP-79PK-PCAB-95TE
F0gFqnAoFifA3zuKzwZqtg,1723075123,Bolt,4121,7999,-2651,-2651,980,0,0,476086,True
acsJ-thxwaCAfuYrWx_MWFiNN4k,1723075123,–°–∫–∞—Å—É–≤–∞–Ω–Ω—è. Bolt,4121,7999,5000,5000,980,0,0,478737,False
OdotJQadglZeeB1d1w,1723052691,–í–µ–∑—É–≤—ñ–æ –ü—ñ—Ü–∞,5814,5814,-130000,-130000,980,0,0,473737,False,9PP4-B8K0-8367-29A7
VDjNYH27kvogXWTq0Q,1723044042,IDEALIST COFFEE CO,5814,5814,-8900,-8900,980,0,0,603737,False,E603-0X72-91CM-BKEK
kUDwCQwhewDXs1a10Q,1723026468,–ü–∞—Ä–∫–æ–≤–∫–∞,7523,7523,-3000,-3000,980,0,0,612637,False,M97X-470T-H6C1-KAXA
T2qzzpuEJ79GdKT3Qg,1723025215,–°—ñ–ª—å–ø–æ,5411,5411,-32100,-32100,980,0,0,615637,False,53T7-7MKK-1HBC-0CTX
D7YQ5tIyb_dIlSCjkA,1723014035,Novus,5411,5411,-71517,-71517,980,0,0,647737,False,X33X-2K1H-A32H-AAMM
Cxi-Cf2mCfbDJmvjlw,1723012225,Novapay,8999,8999,-7300,-7300,980,0,0,719254,False,6H4X-T36T-858P-10XB
Hvyeu0xrROKKW0cdZg,1723009693,Bolt,4121,7999,-5000,-5000,980,0,0,726554,False
slfNL6TJfNHlagm1HQVsdw,1722986546,Bolt,4121,7999,-2212,-2212,980,0,0,731554,True
tNsyHV5Z8VJj_DclTq0Jeu8HbrA,1722986546,–°–∫–∞—Å—É–≤–∞–Ω–Ω—è. Bolt,4121,7999,5000,5000,980,0,0,733766,False
_X2SXBMibPMGTVF8Dw,1722949593,–í–∏–≤–µ–¥–µ–Ω–Ω—è –∫–µ—à–±–µ–∫—É 8431.12‚Ç¥,4829,4829,678704,678704,980,0,0,728766,False
nlbeffiwU1ZLkCi9hA,1722942433,Novus,5411,5411,-55578,-55578,980,0,0,50062,False,9B94-8769-3M2B-7ECK
3eDZWElN1G95Lx_6FQ,1722932233,Bolt,4121,7999,-5000,-5000,980,0,0,105640,False
pGohLUH0p--pEGX0kQ,1722879503,Prostor,5977,5977,-35800,-35800,980,0,0,110640,False,2CH5-3H8X-PM85-E3M8
l7E7aKzqlTCThre_xw,1722874976,WOG,5541,5541,-179970,-179970,980,0,5399,146440,False,CEA0-3458-8T22-6PM0
OvkqcEm1DV2JtmZITg,1722874553,–ó –±—ñ–ª–æ—ó –∫–∞—Ä—Ç–∫–∏,4829,4829,300000,300000,980,0,0,326410,False
feT5Bemc2oUU3SZEDw,1722854375,Novus,5411,5411,-25294,-25294,980,0,0,26410,False,E8H7-KTC7-362K-51E2
9ofJvVirCBT5NoL27w,1722840898,Bolt,4121,7999,-5000,-5000,980,0,0,51704,False
k6-ylyO4rE_ZKgZZlA,1722839673,–ü–ª–∞—Ç—ñ–∂ Rozetka,4829,4829,-425800,-425800,980,0,0,56704,False
zMBCkHDt3L9aY4GHcw,1722764460,magazin 726008,5912,5912,-26040,-26040,980,0,0,482504,False,8M9H-KCM3-3906-H29E
kFQNj5xcTKfSkdsM5Q,1722757483,Novus,5411,5411,-10298,-10298,980,0,0,508544,False,192H-PHME-6E5K-CP5P
BlpUp3xGf9qWw3vaiw,1722756897,CHEGO,5631,5631,-460000,-460000,980,0,0,518842,False,043E-7CM1-7EC9-ME12
utSpQAIF-_vsOQ6MeQ,1722700755,Magazin,5499,5499,-7300,-7300,980,0,0,978842,False,B7PB-C22A-7547-MM36
5gkvyh2FVlx5CeBl4A,1722700231,–§–ö –ï–í–û,5399,5399,-8300,-8300,980,0,0,986142,False,24M0-9BMB-HB07-06EH
lYJiQxHMowtPFYIJfg,1722677849,–ö–≤—ñ—Ç–∏,5992,5992,-50000,-50000,980,0,375,994442,False,3X39-55C1-E27E-T480
yFf-VeVlxv3EKpkiXg,1722675707,Best Way To Cup,5814,5814,-8000,-8000,980,0,0,1044442,False,E402-8729-HB2P-7H0P
R_hcpvJ8auXDRVl3sA,1722612970,Pethouse,5995,5995,-462900,-462900,980,0,3471,1052442,False,9C43-3651-AC17-4T4T
HlEfHU_aT8zZ6IGovQ,1722611464,Novus,5411,5411,-44667,-44667,980,0,0,1515342,False,MM1T-7835-AEPK-1HK0
XoxsTfCk3ZaQDTgkaw,1722610805,Novapay,8999,8999,-7000,-7000,980,0,0,1560009,False,5EEB-2H0M-0BT4-35KA
MpboYoWLjjj5aIKH9A,1722579710,Best Way To Cup,5814,5814,-16000,-16000,980,0,0,1567009,False,TKT9-9MEK-91XB-5142
LZPcJfB9GAG-S2dI-A,1722579416,Aptechnii punkt,5912,5912,-20604,-20604,980,0,0,1583009,False,CM0K-8E69-BT61-0352
gJAJusQQRLr6soTZxw,1722579182,FOP Shevchenko,5499,5499,-14000,-14000,980,0,0,1603613,False,3HE2-MM24-EP1T-XB4X
eGpaIiWC3R-c1WlmQw,1722527012,–ú–æ–ª–æ–∫–æ –≤—ñ–¥ —Ñ–µ—Ä–º–µ—Ä–∞,5499,5499,-3900,-3900,980,0,0,1617613,False,M9PK-8471-T45B-K73T
z4bTsnuOQyHIdyJovw,1722526735,A 2068 APTEKA,5912,5912,-85212,-85212,980,0,0,1621513,False,92AM-X688-ATPT-TEB3
EBIpwR1wv1fndxmJew,1722526549,–ê–ø—Ç–µ–∫–∞ –ê–ù–¶,5912,5912,-74120,-74120,980,0,0,1706725,False,38HA-6B74-P5XX-ATM1
gCnR4_xkoAaBmF_fuA,1722524471,EasyPay,5411,5411,-310039,-310039,980,0,0,1780845,False,0P66-PECC-H69A-2XXX
rMyYZpukOYT9XGolJA,1722501276,–ü–æ–ø–æ–≤–Ω–µ–Ω–Ω—è ¬´–ù–∞ –∫–∞–º–ø—É—Ç—î—Ä –¥–ª—è –≥—Ç–∞6¬ª,4829,4829,-33300,-33300,980,0,0,2090884,False
6lurX4YNtwnnkQi0Kw,1722501262,–ü–æ–ø–æ–≤–Ω–µ–Ω–Ω—è ¬´–Ω–∞ –¥—Ä—ñ–º –≤–∞–Ω–Ω—É¬ª,4829,4829,-15000,-15000,980,0,0,2124184,False,955B-03C3-BAM8-95HC
fKri5K9Btlbwn-x6Dw,1722501248,–ü–µ—Ä–µ–∫–∞–∑ –Ω–∞ –∫–∞—Ä—Ç–∫—É,4829,4829,-600000,-600000,980,0,0,2139184,False
LXCh68AvjB8lzTZXsg,1722501135,–¢–µ—Ç—è–Ω–∞ –°.,‚ö°,4829,4829,-7100000,-7100000,980,0,0,2739184,False,A832-65X5-A2M4-50PK
Nm1f0v7srOMG-Ga8-g,1722500642,–íi–¥: –ü–†–ò–•–û–î–¨–ö–û –ï.–í. –§–û–ü,"–î–ª—è –ø–æ–ø–æ–≤–Ω–µ–Ω–Ω—è –∫–∞—Ä—Ç–∫–∏ 5375414101190360, –ü—Ä–∏—Ö–æ–¥—å–∫–æ –ï—Ä–Ω–µ—Å—Ç –íi–∫—Ç–æ—Ä–æ–≤–∏—á, 3487403339",4829,4829,9000000,9000000,980,0,0,9839184,False
hZ_-3sjwASEavegh0g,1724950565,–ü–µ—Ä–µ–∫–∞–∑ –Ω–∞ –∫–∞—Ä—Ç–∫—É,4829,4829,-100000,-100000,980,0,0,4695,False
jP3zfPrcqZBRePjg5g,1724854378,–ü–µ—Ä–µ–∫–∞–∑ –Ω–∞ –∫–∞—Ä—Ç–∫—É,4829,4829,-40000,-40000,980,0,0,104695,False
UmC_-0OVteIHLFY5ew,1724826686,"Lifecell
+380631692598",4814,4814,-25000,-25000,980,0,0,144695,False,T1M4-64ME-XMM4-746M
m-HuoWLfP7e7RQ-exA,1724761487,–ö–∏—ó–≤ –¶–∏—Ñ—Ä–æ–≤–∏–π,9222,9222,-36750,-36750,980,0,0,169695,False,EH47-2KK1-9TCM-3E73
1rD3EkRPgq2yLIr3CA,1724552961,–†–µ–≥—É–ª—è—Ä–Ω–µ –ø–æ–ø–æ–≤–Ω–µ–Ω–Ω—è ¬´–§–æ–Ω–¥ –ü–æ–≤–µ—Ä–Ω–∏—Å—å –∂–∏–≤–∏–º¬ª,4829,4829,-25000,-25000,980,0,0,206445,False,M6K9-H7MA-H2EA-C6C9
LPZwuCBoPzlhLdTkzw,1724512538,LIQPAY*Poster QR,5812,5812,-15900,-15900,980,0,0,231445,False,EP8M-06KK-0MB2-9C90
6RubuHOgkWfgSfCDDg,1724431053,WOG,5541,5541,-100000,-100000,980,0,3000,247345,False,A60M-X62A-BEAB-09B3
NCgtGSn72IFkf1OHiA,1724259412,–ü–µ—Ä–µ–∫–∞–∑ –Ω–∞ –∫–∞—Ä—Ç–∫—É,4829,4829,-100000,-100000,980,0,0,347345,False
tcNbUbWLkal067p24Q,1724225990,Bolt,4121,4121,-10400,-10400,980,0,0,447345,False,7391-173E-T167-E1TP
t5GeWajOojOl9dkJtw,1724071080,–ü–µ—Ä–µ–∫–∞–∑ –Ω–∞ –∫–∞—Ä—Ç–∫—É,4829,4829,-200000,-200000,980,0,0,457745,False
eOWplGhiByF8P5PrHw,1723990771,–ü–µ—Ä–µ–∫–∞–∑ –Ω–∞ –∫–∞—Ä—Ç–∫—É,4829,4829,-50000,-50000,980,0,0,657745,False
YEiXv_x4O_Oz04hueg,1723984697,414960****1035,4829,4829,-50000,-50000,980,0,0,707745,False,H6K3-833A-95A3-X580
vjdR98IUr3SHRmqgyA,1723974950,–ü–µ—Ä–µ–∫–∞–∑ –Ω–∞ –∫–∞—Ä—Ç–∫—É,4829,4829,-100000,-100000,980,0,0,757745,False
MX2qWVpcSMcVcRgTFA,1723948057,–†–µ–≥—É–ª—è—Ä–Ω–µ –ø–æ–ø–æ–≤–Ω–µ–Ω–Ω—è ¬´–§–æ–Ω–¥ –ü–æ–≤–µ—Ä–Ω–∏—Å—å –∂–∏–≤–∏–º¬ª,4829,4829,-25000,-25000,980,0,0,857745,False,KCKK-BX18-48AX-1BHH
U85e5WcSb4xHG1jaTA,1723908801,–í—ñ–∫—Ç–æ—Ä –ó.,4829,4829,-40000,-40000,980,0,0,882745,False,9331-P4XH-8236-777A
zL0mUy4estYhPhBt8A,1723908606,–ü–µ—Ä–µ–∫–∞–∑ –Ω–∞ –∫–∞—Ä—Ç–∫—É,4829,4829,-50000,-50000,980,0,0,922745,False
y5JqcCGU2ccV-DRdbg,1723900643,–ü–µ—Ä–µ–∫–∞–∑ –Ω–∞ –∫–∞—Ä—Ç–∫—É,4829,4829,-50000,-50000,980,0,0,972745,False
_OwhVuuXCPmzsBlEBw,1723898410,Urbanisty cafe,5812,5812,-9000,-9000,980,0,0,1022745,False,3CBT-M350-CH3E-MTA8
tRYK3gxJ6GFKoLGbjA,1723828493,–ü–µ—Ä–µ–∫–∞–∑ –Ω–∞ –∫–∞—Ä—Ç–∫—É,4829,4829,-50000,-50000,980,0,0,1031745,False
kV-4l4waXkgwySd2rg,1723828428,–ß–∞—Å—Ç–∫–æ–≤–µ –∑–Ω—è—Ç—Ç—è –±–∞–Ω–∫–∏ ¬´–ù–∞ –∫–∞–º–ø—É—Ç—î—Ä –¥–ª—è –≥—Ç–∞6¬ª,4829,4829,1000000,1000000,980,0,0,1081745,False
fJDbbN6TJe3MF2TU_w,1723825427,–ü–µ—Ä–µ–∫–∞–∑ –Ω–∞ –∫–∞—Ä—Ç–∫—É,4829,4829,-110000,-110000,980,0,0,81745,False
83jjcHnabFqOvYoGLg,1723724080,–ü–æ–ø–æ–≤–Ω–µ–Ω–Ω—è ¬´–ê—Ä—Ç–∏–ª–µ—Ä–∏—Å—Ç–∞–º 67 –±—Ä¬ª,4829,4829,-100000,-100000,980,0,0,191745,False,5ACH-H6CM-1KHT-P31E
hcWreeOh8LBpf0ryoA,1723724037,–í—ñ–¥: –û–ª–µ—Å—è –°–∞—á–µ–Ω–∫–æ,4829,4829,100000,100000,980,0,0,291745,False
WzmHfaYG6uzDpQXQfA,1723481076,–ñ–∞–Ω–Ω–∞ –ñ.,4829,4829,-250000,-250000,980,0,0,191745,False,HX94-B463-MP8P-83BE
tavRXD1rV_buT80nMg,1723458909,–ü–µ—Ä–µ–∫–∞–∑ –Ω–∞ –∫–∞—Ä—Ç–∫—É,4829,4829,-100000,-100000,980,0,0,441745,False
EC64U6hnN-YqyqXvSA,1723451587,–ü–æ–ø–æ–≤–Ω–µ–Ω–Ω—è ¬´–ù–∞ –ª—ñ—Ö—Ç–∞—Ä–∏–∫–∏¬ª,4829,4829,-200000,-200000,980,0,0,541745,False,PAAK-B348-09TE-PK16
wxq0lFEZi335OojFEQ,1723388020,–ü–µ—Ä–µ–∫–∞–∑ –Ω–∞ –∫–∞—Ä—Ç–∫—É,4829,4829,-100000,-100000,980,0,0,741745,False
dlmIsPFNxRuv13v1IA,1723381161,Novus,5499,5499,-14500,-14500,980,0,0,841745,False,4M43-56P6-H2TM-9KH1
21ZIShJz0DX9JUyjfw,1723381096,Novus,5499,5499,-8900,-8900,980,0,0,856245,False,10K7-6T37-K0PH-T80X
DrrwSDins74h-0pffA,1723380428,–¢–µ—Ä–º—ñ–Ω–∞–ª City24,4829,4829,500000,500000,980,0,0,865145,False
KNnSFhoKzqzoR8OLgw,1723343254,–†–µ–≥—É–ª—è—Ä–Ω–µ –ø–æ–ø–æ–≤–Ω–µ–Ω–Ω—è ¬´–§–æ–Ω–¥ –ü–æ–≤–µ—Ä–Ω–∏—Å—å –∂–∏–≤–∏–º¬ª,4829,4829,-25000,-25000,980,0,0,365145,False,C101-KXM9-P641-7K79
YCLKb8NIOmWepecC6w,1723185165,–û–ª—å–≥–∞ –î.,4829,4829,-17000,-17000,980,0,0,390145,False,XBTC-081A-ET9B-47CE
ki-j6Xx9F2KT4rhN2Q,1723185060,–í–æ–ª–æ–¥–∏–º–∏—Ä –®.,4829,4829,-9000,-9000,980,0,0,407145,False,3PB7-83KX-MB5P-K213
Sj0K6wREoWrZQ2pqBg,1723184783,414949****2985,4829,4829,-10000,-10000,980,0,0,416145,False,2K0A-3K42-8B5X-8C1B
WggIPuPcVMrM3lV2Fw,1722874553,–ü–µ—Ä–µ–∫–∞–∑ –Ω–∞ –∫–∞—Ä—Ç–∫—É,4829,4829,-300000,-300000,980,0,0,426145,False
Sahc5BuEh_PR8UIZrA,1722853059,414962****1871,4829,4829,-150000,-150000,980,0,0,726145,False,BXCT-1K72-TKPT-485X
OzUc_KtVXVtlrsFv3w,1722738361,–†–µ–≥—É–ª—è—Ä–Ω–µ –ø–æ–ø–æ–≤–Ω–µ–Ω–Ω—è ¬´–§–æ–Ω–¥ –ü–æ–≤–µ—Ä–Ω–∏—Å—å –∂–∏–≤–∏–º¬ª,4829,4829,-25000,-25000,980,0,0,876145,False,MPTK-1AH3-5M5H-4554
0gBpkhQG9bxFr-xF1g,1722619441,–ü–æ–ø–æ–≤–Ω–µ–Ω–Ω—è ¬´–ó–ë–Ü–† –î–õ–Ø –ë–†–ê–¢–ê¬ª,4829,4829,-95000,-95000,980,0,0,901145,False,MB2K-2K8H-9K6P-T64M
lduj2MPjxiCqmuxaWw,1722619347,–ü–æ–ø–æ–≤–Ω–µ–Ω–Ω—è ¬´–ó–ë–Ü–† –î–õ–Ø –ë–†–ê–¢–ê¬ª,4829,4829,-100000,-100000,980,0,0,996145,False,72PT-XP33-HE83-3BMA
YO8oQnHzNRru-YxeYw,1722618944,–ü–æ–ø–æ–≤–Ω–µ–Ω–Ω—è ¬´–ó–ë–Ü–† –î–õ–Ø –ë–†–ê–¢–ê¬ª,4829,4829,-533000,-533000,980,0,0,1096145,False,1BT8-A9H8-E835-BK33
jY39mkq3kiSS3Phecw,1722618921,–ü–æ–ø–æ–≤–Ω–µ–Ω–Ω—è ¬´–ó–ë–Ü–† –î–õ–Ø –ë–†–ê–¢–ê¬ª,4829,4829,-339400,-339400,980,0,0,1629145,False,EXBT-H030-H691-4503
6ruH8rJrssghxnLVpA,1722618821,–ü–æ–ø–æ–≤–Ω–µ–Ω–Ω—è ¬´–ó–ë–Ü–† –î–õ–Ø –ë–†–ê–¢–ê¬ª,4829,4829,-540600,-540600,980,0,0,1968545,False,1KH1-557P-0MPE-6EHT
JRRj24HbCvHb9n6TFA,1722618767,–ü–æ–ø–æ–≤–Ω–µ–Ω–Ω—è ¬´–ó–ë–Ü–† –î–õ–Ø –ë–†–ê–¢–ê¬ª,4829,4829,-438000,-438000,980,0,0,2509145,False,KTHC-ACHA-A7BC-HB03
k_QpPENp5ZtD4clkjQ,1722618756,–ü–æ–ø–æ–≤–Ω–µ–Ω–Ω—è ¬´–ó–ë–Ü–† –î–õ–Ø –ë–†–ê–¢–ê¬ª,4829,4829,-494000,-494000,980,0,0,2947145,False,M0E8-93CA-TM3T-K338
pFG8QM62ABVNNEZkCg,1722618733,–ü–æ–ø–æ–≤–Ω–µ–Ω–Ω—è ¬´–ó–ë–Ü–† –î–õ–Ø –ë–†–ê–¢–ê¬ª,4829,4829,-459200,-459200,980,0,0,3441145,False,4HBA-4KM7-KPHE-B99P
ryA4shcqFksxfIkQog,1722618720,–ü–æ–ø–æ–≤–Ω–µ–Ω–Ω—è ¬´–ó–ë–Ü–† –î–õ–Ø –ë–†–ê–¢–ê¬ª,4829,4829,-530000,-530000,980,0,0,3900345,False,PBTH-B65X-CAB4-CC2K
iq6-CHwC4zuzsmuNnA,1722618702,–ü–æ–ø–æ–≤–Ω–µ–Ω–Ω—è ¬´–ó–ë–Ü–† –î–õ–Ø –ë–†–ê–¢–ê¬ª,4829,4829,-783200,-783200,980,0,0,4430345,False,X63P-8H38-HCBE-5424
8DpT4ZmCPcB5GkGV2g,1722618671,–ü–æ–ø–æ–≤–Ω–µ–Ω–Ω—è ¬´–ó–ë–Ü–† –î–õ–Ø –ë–†–ê–¢–ê¬ª,4829,4829,-163000,-163000,980,0,0,5213545,False,MXKX-HE93-K67E-P423
PUmb9TwnTvwHK3ANnw,1722618655,–ü–æ–ø–æ–≤–Ω–µ–Ω–Ω—è ¬´–ó–ë–Ü–† –î–õ–Ø –ë–†–ê–¢–ê¬ª,4829,4829,-345000,-345000,980,0,0,5376545,False,170A-1701-AP62-M20E
afZbqd0vzmt7S1mH_Q,1722618631,–ü–æ–ø–æ–≤–Ω–µ–Ω–Ω—è ¬´–ó–ë–Ü–† –î–õ–Ø –ë–†–ê–¢–ê¬ª,4829,4829,-80000,-80000,980,0,0,5721545,False,BMPX-3AB9-A90B-C2MK
Emh7XegBYz2SlunO_Q,1722618251,–í–∏–ø–ª–∞—Ç–∞ –±–∞–Ω–∫–∏ ¬´–ù–∞ –µ–∫–≤—ñ–ø –¥–ª—è –±—Ä–∞—Ç–∞¬ª,4829,4829,4900000,4900000,980,0,0,5801545,False
9ft8is1S3iaF0pcS8g,1722615668,–ü–æ–ø–æ–≤–Ω–µ–Ω–Ω—è ¬´–ó–ë–Ü–† –î–õ–Ø –ë–†–ê–¢–ê¬ª,4829,4829,-52600,-52600,980,0,0,901545,False,28H8-8T6M-A5KB-HKEB
3tWk01n88WNxUGRjEQ,1722615575,–ü–æ–ø–æ–≤–Ω–µ–Ω–Ω—è ¬´–ó–ë–Ü–† –î–õ–Ø –ë–†–ê–¢–ê¬ª,4829,4829,-50000,-50000,980,0,0,954145,False,PMTX-HH8X-PKMM-9EP6
sxuwvkY4NQ9u8RG_cQ,1722615503,–ü–æ–ø–æ–≤–Ω–µ–Ω–Ω—è ¬´–ó–ë–Ü–† –î–õ–Ø –ë–†–ê–¢–ê¬ª,4829,4829,-40000,-40000,980,0,0,1004145,False,1T12-B0HK-2E5B-6PX8
-_4FQWDtzyi8OapGzg,1722615487,–ü–æ–ø–æ–≤–Ω–µ–Ω–Ω—è ¬´–ó–ë–Ü–† –î–õ–Ø –ë–†–ê–¢–ê¬ª,4829,4829,-30000,-30000,980,0,0,1044145,False,KECT-3ECK-MCAK-X00M
Ez_oiA-yfIOX2cGz_w,1722615468,–ü–æ–ø–æ–≤–Ω–µ–Ω–Ω—è ¬´–ó–ë–Ü–† –î–õ–Ø –ë–†–ê–¢–ê¬ª,4829,4829,-25000,-25000,980,0,0,1074145,False,41HA-A4TM-BAK7-6P1H
I8GPDTCcPTRp6aH-6A,1722615458,–ü–æ–ø–æ–≤–Ω–µ–Ω–Ω—è ¬´–ó–ë–Ü–† –î–õ–Ø –ë–†–ê–¢–ê¬ª,4829,4829,-35000,-35000,980,0,0,1099145,False,MCT3-XBAX-06E4-5MAX
6pIWlPGZ803efb41hA,1722615440,–ü–æ–ø–æ–≤–Ω–µ–Ω–Ω—è ¬´–ó–ë–Ü–† –î–õ–Ø –ë–†–ê–¢–ê¬ª,4829,4829,-20000,-20000,980,0,0,1134145,False,3459-42X7-0784-ETCP
vbGQ1ez4zGAbMR2kkw,1722615428,–ü–æ–ø–æ–≤–Ω–µ–Ω–Ω—è ¬´–ó–ë–Ü–† –î–õ–Ø –ë–†–ê–¢–ê¬ª,4829,4829,-30000,-30000,980,0,0,1154145,False,A2T2-X93A-3CTX-XKCA
yt6eU_1DvYZpKdYVjw,1722615412,–ü–æ–ø–æ–≤–Ω–µ–Ω–Ω—è ¬´–ó–ë–Ü–† –î–õ–Ø –ë–†–ê–¢–ê¬ª,4829,4829,-40000,-40000,980,0,0,1184145,False,2HCA-CC61-BXPX-K913
mtHsReWkzFwYctgv5g,1722615364,–ü–æ–ø–æ–≤–Ω–µ–Ω–Ω—è ¬´–ó–ë–Ü–† –î–õ–Ø –ë–†–ê–¢–ê¬ª,4829,4829,-65000,-65000,980,0,0,1224145,False,3H71-AB6A-X66E-2T5M
gLgB-6jWQPzikXArtQ,1722615282,–ü–æ–ø–æ–≤–Ω–µ–Ω–Ω—è ¬´–ó–ë–Ü–† –î–õ–Ø –ë–†–ê–¢–ê¬ª,4829,4829,-44400,-44400,980,0,0,1289145,False,A80K-97CH-529A-BM07
sHD8JIEgF_V1toR3_w,1722615174,–ü–æ–ø–æ–≤–Ω–µ–Ω–Ω—è ¬´–ó–ë–Ü–† –î–õ–Ø –ë–†–ê–¢–ê¬ª,4829,4829,-150000,-150000,980,0,0,1333545,False,CTHX-HX4M-0X2B-P333
-pqMzS0dLSS477aCKQ,1722614199,–ü–æ–ø–æ–≤–Ω–µ–Ω–Ω—è ¬´–ó–ë–Ü–† –î–õ–Ø –ë–†–ê–¢–ê¬ª,4829,4829,-90000,-90000,980,0,0,1483545,False,EH56-PTK5-PP40-H083
CsUQzqGtQnWpNAuazg,1722614087,–ü–æ–ø–æ–≤–Ω–µ–Ω–Ω—è ¬´–ó–ë–Ü–† –î–õ–Ø –ë–†–ê–¢–ê¬ª,4829,4829,-55000,-55000,980,0,0,1573545,False,12PE-MBCE-AMK4-B336
HYTn7ATT38j5G72BUQ,1722613992,–ü–æ–ø–æ–≤–Ω–µ–Ω–Ω—è ¬´–ó–ë–Ü–† –î–õ–Ø –ë–†–ê–¢–ê¬ª,4829,4829,-77000,-77000,980,0,0,1628545,False,904X-CHP9-9412-76X7
7GUCThb0Wjshu00h3Q,1722613923,–ü–æ–ø–æ–≤–Ω–µ–Ω–Ω—è ¬´–ó–ë–Ü–† –î–õ–Ø –ë–†–ê–¢–ê¬ª,4829,4829,-100000,-100000,980,0,0,1705545,False,AB5A-3HC3-2T1T-P2K7
nV1qlQW8WjlK4z6HzQ,1722613682,–ü–æ–ø–æ–≤–Ω–µ–Ω–Ω—è ¬´–ó–ë–Ü–† –î–õ–Ø –ë–†–ê–¢–ê¬ª,4829,4829,-165100,-165100,980,0,0,1805545,False,8H37-1M23-XPPE-2PAH
cOTtTO_0V4kzdytYSg,1722613520,–ü–æ–ø–æ–≤–Ω–µ–Ω–Ω—è ¬´–ó–ë–Ü–† –î–õ–Ø –ë–†–ê–¢–ê¬ª,4829,4829,-150000,-150000,980,0,0,1970645,False,C6B0-5B77-M9AM-M067
lFMkjG6K0NTi_KR5mw,1722613425,–ü–æ–ø–æ–≤–Ω–µ–Ω–Ω—è ¬´–ó–ë–Ü–† –î–õ–Ø –ë–†–ê–¢–ê¬ª,4829,4829,-75000,-75000,980,0,0,2120645,False,11AH-B2XA-46CM-66X6
PN00dOAWhki8lQi0_w,1722613300,–í—ñ–¥: –û–ª–µ—Å—è –°–∞—á–µ–Ω–∫–æ,4829,4829,1294069,1294069,980,0,0,2195645,False
SAAV_2NAp6avYM7mtA,1722609572,–ñ–∞–Ω–Ω–∞ –ñ.,4829,4829,-250000,-250000,980,0,0,901576,False,33TC-47PA-BX1E-BTMK
fGl8e81D4V0BNdtcRw,1722501248,–ó —á–æ—Ä–Ω–æ—ó –∫–∞—Ä—Ç–∫–∏,4829,4829,600000,600000,980,0,0,1151576,False
qdDNe2mNMQd88OqKng,1722464968,–ü–æ–ø–æ–≤–Ω–µ–Ω–Ω—è ¬´–ó–ë–Ü–† –î–õ–Ø –ë–†–ê–¢–ê¬ª,4829,4829,-10100,-10100,980,0,0,551576,False,7E27-E145-4XMT-B9BE
6ZyrvqTAoHea3y7qvQ,1727622997,–°—ñ–ª—å–ø–æ,5411,5411,-58917,-58917,980,0,441,311269,False,BTTH-P1E0-8AP3-672K
8s5uVE-aTuwTHNDMCg,1727599349,–ù–æ–≤–∞ –ø–æ—à—Ç–∞,7399,7399,-6200,-6200,980,0,0,370186,False,B8K9-0B4E-A0MC-8MB2
wwaTuwPsdj3A2DnNUQ,1727596840,Best Way To Cup,5814,5814,-42500,-42500,980,0,318,376386,False,CH2X-15ME-967K-4B50
Z22L4b8TRAq9sKhIQA,1727532167,Mutabor Flower Service,5992,5992,-128500,-128500,980,0,0,418886,False,C0CB-AT38-5209-X269
UT9hVqbpaKpRGqepKw,1727530767,–ó–∞–≤–µ—Ä—Ç–∞–π–ª–æ –°–æ—Ñ—ñ—è ,5812,5812,-257400,-257400,980,0,1930,547386,False,16T7-B093-25K6-TX8P
X0AcDmxjqIEB5U6Jpg,1727524951,–ö–∏—ó–≤–ø–∞—Å—Ç—Ä–∞–Ω—Å,4111,4111,-800,-800,980,0,0,804786,False,KHXM-4HH6-CKBM-B7TM
hOYD2P7Ucf82wVrosQ,1727518213,Best Way To Cup,5814,5814,-9000,-9000,980,0,67,805586,False,EP7E-776M-M9K3-7AXM
-PREfL7asKG2LgIgbw,1727516922,Novapay,8999,8999,-7000,-7000,980,0,0,814586,False,HXH6-M5B3-6E2E-1BHE
ByRFNvVfntUU3HOetQ,1727515151,"–ö–∞—Ñ–µ ""–õ–ò–ü–ê""",5812,5812,-37500,-37500,980,0,281,821586,False,KE8M-4PXC-5338-C503
USWOq73sgZMJjgEq7Q,1727511675,PershiyPoverh,5814,5814,-7500,-7500,980,0,56,859086,False,X86X-M83H-5C45-1X0H
2l1ROnoBoi6Nfb8iHQ,1727510605,PershiyPoverh,5814,5814,-23000,-23000,980,0,172,866586,False,P9PK-8PXE-0C1M-5KHT
cMCIeV88mQCgNO3tNg,1727510014,HEJZ,7230,7230,-80000,-80000,980,0,0,889586,False,7M0P-EC4C-XB74-CXT9
X-iVGN5kc16uvGuR9A,1727453789,–°—ñ–ª—å–ø–æ,5411,5411,-90296,-90296,980,0,677,969586,False,37BE-9771-49P3-EBB4
b48RdgozKHotw0-fug,1727438990,Prostor,5977,5977,-18700,-18700,980,0,0,1059882,False,1TCC-A6CB-C521-CA0H
8jOQq4GzQgcFEkfZoQ,1727436742,RIZNI,5812,5812,-8500,-8500,980,0,63,1078582,False,X5KB-KM1H-XKTX-X8BP
JJXBSpxHtnbEneGQeQ,1727436490,SalonkrasiChehovskiy,7230,7230,-45000,-45000,980,0,0,1087082,False,XM9X-K2C0-7MHX-P6MK
2mS-fa1G_16HeENgSQ,1727428971,–íi–¥: –ü–†–ò–•–û–î–¨–ö–û –ï.–í. –§–û–ü,"–î–ª—è –ø–æ–ø–æ–≤–Ω–µ–Ω–Ω—è –∫–∞—Ä—Ç–∫–∏ 5375414101190360, –ü—Ä–∏—Ö–æ–¥—å–∫–æ –ï—Ä–Ω–µ—Å—Ç –íi–∫—Ç–æ—Ä–æ–≤–∏—á, 3487403339",4829,4829,1000000,1000000,980,0,0,1132082,False
mmyc84wgnGnY6OddZA,1727427096,2bfit_fitness_club,7941,7941,-60000,-60000,980,0,0,132082,False,4AE9-CAM0-4K69-XBBK
A7AFR1zANUr1CvDKdA,1727423316,–íi–¥: –Ü–≤–∞–Ω–Ω–∞ –ö–æ–≤–∞–ª—å,4829,4829,115000,115000,980,0,0,192082,False
qpymLO4bPAwzCloJ8A,1727421270,kaviarnia the coffee L,5812,5812,-14000,-14000,980,0,105,77082,False,63A5-MTE3-X148-3CKP
4RkiupM476Ds0Go9jw,1727421198,Rozetka,5399,5399,-40700,-40700,980,0,305,91082,False,3KM7-PA6P-EX5C-A9XP
c_StifDRiW6WUuBvKg,1727421150,Rozetka,5399,5399,-609900,-609900,980,0,4574,131782,False,492M-ME1C-0TH3-CP8E
Aa8DOc_ixrJJZHhyEw,1727420549,–ó –±—ñ–ª–æ—ó –∫–∞—Ä—Ç–∫–∏,4829,4829,150000,150000,980,0,0,741682,False
C_hlRmAhpSoWfqoNaQ,1727420534,FOP Shevchenko,5499,5499,-17500,-17500,980,0,131,591682,False,H6B3-XKMA-00XB-C3AM
1V2teZxvwV2XXmb6Krlgnw,1727393033,Bolt,4121,7999,-2425,-2425,980,0,0,609182,True
cfTFGW16ZChYgfdhTIG20HOJEak,1727393033,–°–∫–∞—Å—É–≤–∞–Ω–Ω—è. Bolt,4121,7999,8000,8000,980,0,0,611607,False
lnV1L8rk1GqOk3CWgQ,1727371956,–ó–∞–≤–µ—Ä—Ç–∞–π–ª–æ –°–æ—Ñ—ñ—è ,5812,5812,-222800,-222800,980,0,1671,603607,False,X461-AMHM-EPB7-5006
JN3OqIuOchyGWRKSBw,1727367432,OK Wine,5411,5411,-5450,-5450,980,0,40,826407,False,59T0-X63B-X984-EKET
9vYjpoxKnVSb2GUYLA,1727363241,–ö–∏—ó–≤–ø–∞—Å—Ç—Ä–∞–Ω—Å,4111,4111,-800,-800,980,0,0,831857,False,TM04-5E16-1C1M-TTE8
5hAUE1LKJHqT0s6L2A,1727355157,Wfp.aquamarket,5499,5499,-126530,-126530,980,0,948,832657,False,8H4T-TH4C-32AH-XC7X
NG4fZTXxFX5NociT5A,1727349583,Novapay,8999,8999,-7700,-7700,980,0,0,959187,False,M5CP-PEK7-HCTA-TH9P
ZLGvpQ3InSWuIqWOGg,1727333137,Kafe Kaviarnia humans,5814,5814,-8500,-8500,980,0,63,966887,False,C82H-EC4E-05T4-42H4
NV8VwWV0cMpGhXPcTg,1727281612,LIQPAY*Pethouse,5995,5995,-72400,-72400,980,0,0,975387,False,E2T8-ATT9-0300-H6AM
5--xvMJeCvf04aQdUg,1727281283,LIQPAY*Simona Ristoran,5812,5812,-83895,-83895,980,0,629,1047787,False,54TE-AT0P-86EE-BXC7
4R5dEgD8yeLKlqJ8iA,1727278583,OK Wine,5411,5411,-26700,-26700,980,0,200,1131682,False,7CP9-EXBC-7MET-2769
MsPzlO4hqhh1_RdV4g,1727278487,–ù–æ–≤–∞ –ø–æ—à—Ç–∞,7399,7399,-13000,-13000,980,0,0,1158382,False,EP3K-0P6H-HXKA-27HK
Ow0T8VWI1AJP8L0qkA,1727277153,magazin775584,5912,5912,-67910,-67910,980,0,0,1171382,False,MHCC-77M8-4KM4-2T56
dGYsQXi-s5EkRy8Dng,1727259177,Bolt,4121,4121,-33200,-33200,980,0,0,1239292,False,21H0-P23M-H951-2E6X
o4UPM8tISCfgZZNxRA,1727245405,Bolt,4121,7999,-8000,-8000,980,0,0,1272492,False
15LeUNMihm5n0WEMzQ,1727240598,–°–∫–∞—Å—É–≤–∞–Ω–Ω—è. Elit Taxi,4121,4121,100,100,980,0,0,1280492,False
6prWRadqW952Z-FhfA,1727240418,elit-taxi.ua1004,4121,4121,-55200,-55200,980,0,0,1280392,False,E32C-3MT7-28A5-H938
ryqfOhFwgoLcZpkj2Q,1727240390,Elit Taxi,4121,4121,-100,-100,980,0,0,1335592,False
NAn-RCsHgJjwvVDt0A,1727196665,Kitaika.Kitchen | –ó–æ–ª–æ—Ç–æ—É—Å—Ç—ñ–≤—Å—å–∫–∞,5812,5812,-71750,-71750,980,0,538,1335692,False,74K7-178H-K3K3-222H
YQbXYHKv0A-KTyCleA,1727190754,OK Wine,5921,5921,-21600,-21600,980,0,162,1407442,False,KXB8-C100-BXT2-7KX3
MNYPiLJtS-rJ6LZ9tw,1727099365,5045Kavjarnja,5814,5814,-13000,-13000,980,0,97,1429042,False,1XA6-9823-7CMH-A7C8
velH8KXHiP5Go84Bsg,1727084643,*=34044,5912,5912,-16022,-16022,980,0,0,1442042,False,X6E8-E69B-K6AX-MK8B
zM2rAlI-fj_tbUItcQ,1727075655,"Lifecell
+380631692598",4814,4814,-25000,-25000,980,0,0,1458064,False,5B64-839X-530X-MX35
u9d0iGoZUMD9lMFjXg,1727075548,Steam,5816,5816,-33800,-33800,980,0,0,1483064,False,3K6H-07X0-X6CM-3413
ubKWCCpfVpALjlc9zA,1727071044,–ê–ø—Ç–µ–∫–∞ ¬´–ë–∞–∂–∞—î–º–æ –∑–¥–æ—Ä–æ–≤'—è¬ª,5912,5399,-17116,-17116,980,0,0,1516864,False,397X-E83C-074X-P7AP
IKzHstd-NY2HintDFw,1727070907,–ö–æ–ª–æ,5411,5499,-9350,-9350,980,0,70,1533980,False,554C-TAXT-54H6-T8BC
UjPmwrFbuFzej4naCA,1727018688,FOPTkachenkoSergiyOlek,5814,5814,-24500,-24500,980,0,183,1543330,False,C21M-6553-TP7C-PEHP
u-FUQtqLyMHp9veS6w,1727017398,Best Way To Cup,5814,5814,-12000,-12000,980,0,90,1567830,False,691B-XA28-KK5E-6098
3vZMoq49ckDun3zX2g,1727006520,Novus,5411,5411,-14408,-14408,980,0,108,1579830,False,7K66-5489-485B-5BTX
yTZKKOgWjY5RflxKmw,1727004465,–û—Ñ—ñ—Å-—á–∞–π,5812,5812,-25800,-25800,980,0,193,1594238,False,98B1-B8E0-H027-CAH1
lPqRp42yRp-rQIgTdQ,1726993389,Best Way To Cup,5814,5814,-31100,-31100,980,0,233,1620038,False,061M-X40H-TM82-5KC6
p39HphwDHAI9AoRJ4Q,1726933272,Zigzag,5814,5814,-10000,-10000,980,0,75,1651138,False,C546-BH01-00BT-M903
WcJjy_QUrkDm1n7yWA,1726933256,Zigzag,5814,5814,-167900,-167900,980,0,1259,1661138,False,3C0C-P026-MM75-161B
H2KR5VUZMk4ILxcbEA,1726921851,Novus,5411,5411,-65589,-65589,980,0,491,1829038,False,7P9T-0TBP-527K-MB23
CYhU2rRYFqJCSgFnzg,1726919396,–ù–æ–≤–∞ –ø–æ—à—Ç–∞,7399,7399,-7000,-7000,980,0,0,1894627,False,TM79-0KC5-MCX7-ACPT
4vBrWLkjLHlqF6MWZQ,1726909614,Novapay,8999,8999,-11500,-11500,980,0,0,1901627,False,3K75-4H10-BK44-0A6B
CY_MzTGPYAa2sB2Xdg,1726897335,–°—ñ–ª—å–ø–æ,5411,5411,-78598,-78598,980,0,589,1913127,False,5485-93PA-B89M-4AM7
yvSIqsb1s1YqQGy4hQ,1726850907,OK Wine,5411,5411,-19300,-19300,980,0,172,1991725,False,P46T-E65H-B5TX-BC2C
JNXSn-NUo-oNm6kJuw,1726818812,–ü–æ–ø–æ–≤–Ω–µ–Ω–Ω—è ¬´–Ω–∞ –¥—Ä—ñ–º –≤–∞–Ω–Ω—É¬ª,4829,4829,-25000,-25000,980,0,0,2011025,False,5B50-09C8-EXH8-3K5H
VctlGRoqBYFTQ3BBUQ,1726817996,AVANGARDEN,5812,5812,-85300,-85300,980,0,1706,2036025,False,5X2P-K06T-PCEP-B6T8
fnDT_FJ-nhQ8PGggXQ,1726754123,–ü–æ–ø–æ–≤–Ω–µ–Ω–Ω—è ¬´–Ω–∞ –¥—Ä—ñ–º –≤–∞–Ω–Ω—É¬ª,4829,4829,-9900,-9900,980,0,0,2121325,False,B2P4-80MM-7113-H9TH
ersiKK_MBoFKBmzbSg,1726754061,–ü–æ–ø–æ–≤–Ω–µ–Ω–Ω—è ¬´–ù–∞ –∫–æ–º–ø—É—Ç—î—Ä –¥–ª—è –≥—Ç–∞6¬ª,4829,4829,-35000,-35000,980,0,0,2131225,False
70qCjX_lB3h7FGFtnw,1726754044,–ü–µ—Ä–µ–∫–∞–∑ –Ω–∞ –∫–∞—Ä—Ç–∫—É,4829,4829,-500000,-500000,980,0,0,2166225,False
UdsLGdMEkhbkBsqLuQ,1726754038,Lesya,4829,4829,-500000,-500000,980,0,0,2666225,False,009E-B2B2-E5HE-BK63
aIJYK5s_A7c2tHaUJg,1726750395,KP SK START,7997,7997,-3000,-3000,980,0,0,3166225,False,12TX-H5MT-B88X-3X03
bWybeisnvI3Pn-gJlg,1726744835,LIQPAY*Pethouse,5995,5995,-153400,-153400,980,0,0,3169225,False,1E29-39E0-4TM8-9E3C
BpIIsuPzVT3-bYx_gQ,1726744701,FOPMuzichukBogdanGenna,742,742,-295000,-295000,980,0,0,3322625,False,9995-A3XX-9EEB-T335
Qh0gC_Bi5yO0HSsQKQ,1726736519,–ö–∏—ó–≤–ø–∞—Å—Ç—Ä–∞–Ω—Å,4111,4111,-800,-800,980,0,0,3617625,False,P384-MA41-7B94-B7MK
vsV0aM16ElCKN35n4g,1726735551,–ö–∏—ó–≤—Å—å–∫–µ –º–µ—Ç—Ä–æ,4111,4111,-800,-800,980,0,0,3618425,False,2P16-318K-THPE-4A3E
z1vfiYQhrJCRM9YlSQ,1726733068,–ö–∏—ó–≤—Å—å–∫–µ –º–µ—Ç—Ä–æ,4111,4111,-800,-800,980,0,0,3619225,False,10K7-19H6-9K98-2XEE
PErNc-SUSt-vI21CxA,1726731374,chizkeikfemel,5814,5814,-15500,-15500,980,0,310,3620025,False,13BT-2EKB-MXTT-P5CX
O9O6-DgLVr_O39Qxow,1726726967,Cheesecake Family,5812,5812,-48900,-48900,980,0,978,3635525,False,MC4T-BMC9-3AB7-X27P
p8sw3YNyjBetST08eQ,1726724964,–ö–∏—ó–≤—Å—å–∫–µ –º–µ—Ç—Ä–æ,4111,4111,-800,-800,980,0,0,3684425,False,P5CH-THT5-C9K2-K48H
iExgy0bpwwW2nwmewg,1726682812,–ö–∏—ó–≤–ø–∞—Å—Ç—Ä–∞–Ω—Å,4111,4111,-800,-800,980,0,0,3685225,False,EX04-8167-9H15-75TP
0ezDJcXptcI9Y_OdoA,1726681400,–ö–∏—ó–≤—Å—å–∫–µ –º–µ—Ç—Ä–æ,4111,4111,-800,-800,980,0,0,3686025,False,4M51-3P9P-EE80-9231
8liOCcG33r91F-WRyA,1726681043,SHIBUYA | –í. –í–∞—Å–∏–ª—å–∫—ñ–≤—Å—å–∫–∞ 111/113,5812,5812,-59300,-59300,980,0,1186,3686825,False,TH2K-5PT0-P43T-9C14
BIYL5V0E_0pm-vUffg,1726674120,METROPOLITEN,4111,4111,-800,-800,980,0,0,3746125,False,H1T3-BXBK-11BT-3HH8
FQFw1wHIMqp3XY15Qw,1726672609,–ö–∏—ó–≤–ø–∞—Å—Ç—Ä–∞–Ω—Å,4111,4111,-800,-800,980,0,0,3746925,False,XA9M-3532-21PT-B7H0
O8tjXpO2JRr6g-l2pg,1726665569,Novus,5411,5411,-8998,-8998,980,0,89,3747725,False,MEH5-2HMK-87CB-3BC5
1DX3r0XLINKBkeUJTQ,1726663784,–ü–æ–ø–æ–≤–Ω–µ–Ω–Ω—è ¬´–ù–∞ –ê–µ—Ä–æ—Å—Ç–∞—Ç –¥–ª—è –°–°–ûüî•¬ª,4829,4829,-100000,-100000,980,0,0,3756723,False,KAHK-M01P-K54H-0203
WCRcG-7868gh7HnH-w,1726660272,KavyarnyaKAShTAN,5812,5812,-10000,-10000,980,0,200,3856723,False,E21C-K5P9-4H6B-HPE6
Fc89w0_CGgKTGPf8Nw,1726655718,–ü–æ–ø–æ–≤–Ω–µ–Ω–Ω—è ¬´–ù–∞ –∫–æ–º–ø—É—Ç—î—Ä –¥–ª—è –≥—Ç–∞6¬ª,4829,4829,-45000,-45000,980,0,0,3866723,False
wquLIAyDariFvWQY7A,1726655708,–ü–æ–ø–æ–≤–Ω–µ–Ω–Ω—è ¬´–Ω–∞ –¥—Ä—ñ–º –≤–∞–Ω–Ω—É¬ª,4829,4829,-60000,-60000,980,0,0,3911723,False,KK10-X7PP-3XBH-69AK
bOhVv8oPeNft81ElXQ,1726649841,–íi–¥: –ü–†–ò–•–û–î–¨–ö–û –ï.–í. –§–û–ü,"–î–ª—è –ø–æ–ø–æ–≤–Ω–µ–Ω–Ω—è –∫–∞—Ä—Ç–∫–∏ 5375414101190360, –ü—Ä–∏—Ö–æ–¥—å–∫–æ –ï—Ä–Ω–µ—Å—Ç –íi–∫—Ç–æ—Ä–æ–≤–∏—á, 3487403339",4829,4829,3500000,3500000,980,0,0,3971723,False
rs8Ud0srH9jkcdpw_A,1726645774,–ü–µ–∫–∞—Ä–Ω—è –í–∏—Ç–∞—á,5814,5814,-19500,-19500,980,0,146,471723,False,A15A-AMHT-HB41-T0E3
k_dx16AP-hNTnCplmA,1726645509,Best Way To Cup,5814,5814,-8000,-8000,980,0,60,491223,False,BPTE-6MC7-05T2-K9KH
qJ6_2bWanSREJLVLGg,1726642034,Bolt,4121,4121,-13300,-13300,980,0,0,499223,False,888T-78MC-K49A-XBH0
8BH1HRrPFvMZrTyrpw,1726639642,Bolt,4121,4121,-10900,-10900,980,0,0,512523,False,5466-M117-XC19-90X5
EhjyVFAgUGPy01FPNA,1726601216,"Lifecell
+380731983817",4814,4814,-10000,-10000,980,0,0,523423,False,HTHM-XC45-EE14-T6MB
l5lp3_gXPEEDuTj5OQ,1726601195,"Lifecell
+380631692598",4814,4814,-26000,-26000,980,0,0,533423,False,KH90-4739-88XT-0K74
tuGi6maSrp6cjuAOsw,1726597702,Vodafone,4814,4814,-20000,-20000,980,0,0,559423,False,9777-P6A8-PKXP-ET42
mxmebcH-6_Dano7d1A,1726588001,Best Way To Cup,5814,5814,-8000,-8000,980,0,60,579423,False,HTPC-HM6B-T91C-B3AB
S1Lu0Xk_s0wCZQH07Q,1726587839,–ù–æ–≤–∞ –ø–æ—à—Ç–∞,7399,7399,-1500,-1500,980,0,0,587423,False,A33M-A83H-7K0H-H77T
sGTAfrjneCRKKO3N9Q,1726582934,Novapay,8999,8999,-7575,-7575,980,0,0,588923,False,1TMA-982T-8CTH-7K0P
BrxH0B5MagFhXSv4pw,1726573206,Fotovramci,5946,5946,-115000,-115000,980,0,0,596498,False,H14K-XPA5-BCAP-CCA8
vx7Mf2ir-PlkwHuTZwUwVA,1726528717,Bolt,4121,7999,-4315,-4315,980,0,0,711498,True
c6RquvdvHAsvdXupKbPPJPIi_tI,1726528717,–°–∫–∞—Å—É–≤–∞–Ω–Ω—è. Bolt,4121,7999,8000,8000,980,0,0,715813,False
JsrWmofdBDKTuNuq1w,1726507725,Wfp.aquamarket,5499,5499,-87140,-87140,980,0,653,707813,False,BC5T-AEME-7E21-PBTB
5R0KRV-2Zz_rfo5yQQ,1726507354,gudfoodhome,5812,5812,-253200,-253200,980,0,1899,794953,False,636K-8X23-7T1P-M27M
KXJL47J2GfRfqLnvLQ,1726505112,–°—ñ–ª—å–ø–æ,5411,5411,-119742,-119742,980,0,898,1048153,False,7TM4-X362-BH2H-34C1
WKCp51itJOM0rnx_Yg,1726486713,Novus,5411,5411,-3999,-3999,980,0,29,1167895,False,5223-M91T-BPPE-391P
tVpfDHdOdqx7ojmcTg,1726467028,Best Way To Cup,5814,5814,-10500,-10500,980,0,78,1171894,False,495T-6C80-3527-6BBK
x-HZ0Y1ttH3L7pfgpQ,1726405475,WineTime,5921,5921,-84900,-84900,980,0,636,1182394,False,BKK3-106T-0999-1CM0
Qic4MYCrbxi04DrfKg,1726404918,Podorozhnyk,5912,5912,-7900,-7900,980,0,0,1267294,False,T30B-20CC-M394-8KB2
UJDlw7jtv0QIV3yD7A,1726404805,Bolt,4121,7999,-8000,-8000,980,0,0,1275194,False
segvxqKck9QFO3NCAA,1726404715,Rybak,5499,5499,-6880,-6880,980,0,51,1283194,False,6HAK-K5PE-6M5T-8CPB
GUhFO5UoMOSInfVV2g,1726404270,STARA VOROKHTA,5812,5812,-75800,-75800,980,0,568,1290074,False,0E09-8T4P-B60M-54P9
6IESVy1U1hnqK4oYqQ,1726395558,–°—ñ–ª—å–ø–æ,5411,5411,-104693,-104693,980,0,785,1365874,False,2607-X7E4-4XKX-E6K0
SJ1p1u4IBxPZJOpImQ,1726384703,TSAR KHLIB KIOSK,5462,5462,-9500,-9500,980,0,71,1470567,False,C91C-TAC2-XEB9-A97E
FhtHcHY2g2aMyr3xGw,1726335523,STARA VOROKHTA,5812,5812,-95000,-95000,980,0,712,1480067,False,8CBM-0AC0-P7XM-44TP
5rQO07W09sCqavpcEQ,1726325963,20/2,5812,5812,-24000,-24000,980,0,180,1575067,False,0MEC-CT0A-P344-3KEM
j2OvT0fi05jy_LLAZw,1726318636,WFP.CONSULT1,7277,7277,-25000,-25000,980,0,0,1599067,False,66P4-HBEC-AC5P-4198
6yYuevE_-ERV_FqjUQ,1726311533,Prostor,5977,5977,-14430,-14430,980,0,0,1624067,False,7H22-P080-7KCA-9H5K
Olof2A7ra0Dcj5FZsw,1726311410,–ö–æ–ø—ñ–π–æ—á–∫–∞,5310,5310,-2990,-2990,980,0,0,1638497,False,AA56-XKP5-3C84-1TBK
lBf_C_VbpMCBasBVqg,1726311299,Novus,5411,5411,-29896,-29896,980,0,224,1641487,False,AT65-95MH-9P25-EC33
_wvEcVT5wJ6ZT8rp7Q,1726309971,PHotosalonMAN,7221,7221,-5000,-5000,980,0,0,1671383,False,3TX7-AP41-1K03-87C9
EIVs3-EH3v4qMBsfBw,1726309765,–ö–æ–ø—ñ–π–æ—á–∫–∞,5399,5399,-22980,-22980,980,0,172,1676383,False,7P64-1BHK-MT6P-6HB7
3NG0ZRU_y-JFV9QJkQ,1726304770,–ê–ª—å—Ç–µ—Ä–Ω–∞—Ç–∏–≤–ê,5812,5812,-9000,-9000,980,0,67,1699363,False,05KE-48KA-5HKP-5E4B
kPcd3_FuXHIsfgNWAQ,1726296539,Best Way To Cup,5814,5814,-13500,-13500,980,0,101,1708363,False,KB5P-XAB4-BB83-4971
oVd1XfSZ4pgdBaS347Fv,1726269982,Bolt,4121,4121,-11900,-11900,980,0,0,1721863,True
ATTyF--NEyB-6tJBNZe2DZGYCYA,1726269982,–°–∫–∞—Å—É–≤–∞–Ω–Ω—è. Bolt,4121,4121,10900,10900,980,0,0,1733763,False
RtmvmlXBBt72hD5Oag,1726229518,Rybak,5499,5499,-4630,-4630,980,0,34,1722863,False,KE10-H952-0K6C-B5B9
_8ugyfO7cV7IXkdj3w,1726228053,STARA VOROKHTA,5812,5812,-88300,-88300,980,0,662,1727493,False,CKAH-AXB4-6905-498H
K0t4ayKblmXA_DdHSw,1726221923,FOPTkachenkoSergiyOlek,5814,5814,-33000,-33000,980,0,247,1815793,False,95PC-EHEC-810C-MB97
b9VT0pjBdPdUVsCzAg,1726221746,WineTime,5921,5921,-52600,-52600,980,0,394,1848793,False,5TEP-3MMH-43EX-3T3K
FhT1j1GjnhH-9EsNvQ,1726212132,Bolt,4121,4121,-10200,-10200,980,0,0,1901393,False,3EX8-3K81-TBP8-K31A
fWYvH77ICvWVQSUUdg,1726207717,Bolt,4121,4121,-10900,-10900,980,0,0,1911593,False
Yj01rb6pXI2JL8hIUg,1726169534,Novapay,8999,8999,-6350,-6350,980,0,0,1922493,False,0548-H987-K3K5-HX34
FeQQhOB4uwQc6t6JOA,1726159232,–ê–ù–¶,5912,5912,-13100,-13100,980,0,0,1928843,False,M7AH-8E1E-8TCC-3AC4
dw4k_nrhfNRldPMlUQ,1726158990,–°—ñ–ª—å–ø–æ,5411,5411,-128539,-128539,980,0,1140,1941943,False,B130-X2M3-8877-0MB5
IREf8s8nTNF-s4lJHQ,1726157477,–ü–µ—Ä–µ–∫–∞–∑ –Ω–∞ –∫–∞—Ä—Ç–∫—É,4829,4829,-500000,-500000,980,0,0,2070482,False
i-MRNTzCPcjJvn0vwg,1726156984,STARA VOROKHTA,5812,5812,-89600,-89600,980,0,1792,2570482,False,EHCE-TE6H-3BPA-78KT
1gvU5RRaXq0s0xOOUw,1726137652,Rybak,5499,5499,-15316,-15316,980,0,153,2660082,False,88B8-1A5P-8APX-EEXH
4pmu_uA0z1OvEjH2qw,1726134598,–ê–ª—å—Ç–µ—Ä–Ω–∞—Ç–∏–≤–ê,5812,5812,-14000,-14000,980,0,280,2675398,False,K15B-23C2-A128-TCK5
KQnjDpC4QE99NkwOgg,1726127984,STARA VOROKHTA,5812,5812,-53300,-53300,980,0,1066,2689398,False,94PP-5CMP-MKEP-6H97
DqNp3UPX9XyGauZ5LA,1726124629,Naturalnakosmetika,5977,5977,-15000,-15000,980,0,0,2742698,False,XTTM-0E89-H4TX-23MK
FfH-3N2dkFk-de_pqA,1726124354,–ö–æ–ø—ñ–π–æ—á–∫–∞,5310,5310,-40400,-40400,980,0,0,2757698,False,PH6E-2CC0-1P42-A85T
muf7JQzqGDkuDYTCoA,1726076979,–ù–æ–≤–∞ –ø–æ—à—Ç–∞,7399,7399,-16500,-16500,980,0,0,2798098,False,TECP-XM9H-7314-TCM5
SaRrcHiMTuHo2HR5OA,1726073748,KAVIARNI,5814,5814,-8500,-8500,980,0,170,2814598,False,KA31-EH86-B304-TH8T
ozG1xyh0lkMcnJhImg,1726072672,OkvajnSichovih,5921,5921,-22500,-22500,980,0,225,2823098,False,B06A-PB33-3T0K-A3EH
fMefhyWgITOWUMOeIg,1726072053,–ê–ø—Ç–µ–∫–∞ ¬´–ë–∞–∂–∞—î–º–æ –∑–¥–æ—Ä–æ–≤'—è¬ª,5912,5399,-43000,-43000,980,0,0,2845598,False,9M00-814E-E56E-C907
v18IU5xumbB-STKRYA,1726068004,KAFE TITKA KLARA,5814,5814,-23100,-23100,980,0,462,2888598,False,H3BP-C849-5CB3-23XB
uUuMhGZTXT6BnWWx7w,1726054396,–ö–ò–á–í–ì–ê–ó,5812,5812,-95200,-95200,980,0,1904,2911698,False,CK1C-XM12-CCBX-T994
sfy4veH6-OTPvaXn7g,1726050928,MasloTOM,5411,5411,-75200,-75200,980,0,752,3006898,False,PC2C-X3TM-K4PP-C742
S1HK3SjoY42G-J9XlA,1726047773,–ü–æ–ø–æ–≤–Ω–µ–Ω–Ω—è ¬´–ù–∞ –∫–æ–º–ø—É–∫—Ç—î—Ä –¥–ª—è –≥—Ç6¬ª,4829,4829,-12500,-12500,980,0,0,3082098,False
K8ZtW3Y8ocFm1AkG-g,1726047758,–ü–æ–ø–æ–≤–Ω–µ–Ω–Ω—è ¬´–Ω–∞ –¥—Ä—ñ–º –≤–∞–Ω–Ω—É¬ª,4829,4829,-10000,-10000,980,0,0,3094598,False,8E0P-E2E2-3HTA-5CPT
SY8YP2m0q5PFbBj_zw,1726045234,–íi–¥: –ü–†–ò–•–û–î–¨–ö–û –ï.–í. –§–û–ü,"–î–ª—è –ø–æ–ø–æ–≤–Ω–µ–Ω–Ω—è –∫–∞—Ä—Ç–∫–∏ 5375414101190360, –ü—Ä–∏—Ö–æ–¥—å–∫–æ –ï—Ä–Ω–µ—Å—Ç –íi–∫—Ç–æ—Ä–æ–≤–∏—á, 3487403339",4829,4829,2800000,2800000,980,0,0,3104598,False
7Zh3_jL6uMcrtD6mlw,1726043384,–°—ñ–ª—å–ø–æ,5411,5411,-16600,-16600,980,0,124,304598,False,B40A-016B-9H9E-600B
osZQUhlwft0Hz0O1Zg,1726036392,–ü–ª–∞—Ç—ñ–∂ svit-matrasiv.com.ua,4829,4829,-335700,-335700,980,0,0,321198,False
_IpeViuOmTPjUXnS1Q,1726034842,Best Way To Cup,5814,5814,-13000,-13000,980,0,97,656898,False,9H54-P7PA-63E1-8BA2
UqLaeRALmyAQlcXaDg,1725997140,LIQPAY*O.TAJE,5621,5621,-299900,-299900,980,0,0,669898,False,XBH6-TK5C-1C2H-5C2H
bfB8YLKFa0iJCCmtEg,1725954753,Novus,5411,5411,-5299,-5299,980,0,39,969798,False,T84M-8CX5-7CTE-2KB1
0fi8aJsqIV-aMhENKQ,1725904918,Novapay,8999,8999,-5000,-5000,980,0,0,975097,False,4M08-65HK-7KX7-7B7C
iDa7wNCycqa4fsv4EA,1725904893,Novapay,8999,8999,-7700,-7700,980,0,0,980097,False,7E57-1C30-1776-X12E
WKWMSFvFb87ZxGPhwQ,1725891833,Novus,5411,5411,-7499,-7499,980,0,56,987797,False,CX9T-0C5H-B9HB-1216
P_RYPZ2GC2uDYz4ZNg,1725891132,magazin 762597,5912,5912,-18142,-18142,980,0,0,995296,False,KXT9-T67T-8C86-P510
viI_2_8y925B6Ia3jQ,1725886855,–û—Ñ—ñ—Å-—á–∞–π,5812,5812,-10500,-10500,980,0,78,1013438,False,AH3K-5M93-966E-055P
Gs0yugbfrPoyH8qG4Q,1725886160,AVANGARDEN,5812,5812,-41800,-41800,980,0,313,1023938,False,C05H-1TPC-XXA0-71AA
pzERqfjyybOXAJnB4w,1725866476,Bolt,4121,4121,-12100,-12100,980,0,0,1065738,False,49EB-AMM9-ACC1-CB03
6ht7X5Pyw1hVP0gQeQ,1725862019,Bolt,4121,4121,-13200,-13200,980,0,0,1077838,False,P9MB-3MM6-31KC-7XBC
0iqD4j_mf7vbO3krIg,1725803373,–ö–æ–ª–æ,5411,5499,-11300,-11300,980,0,84,1091038,False,BAA8-41XB-P925-C80C
y0eS87nGiDAlW0fD-Q,1725802636,–°—ñ–ª—å–ø–æ,5411,5411,-35800,-35800,980,0,268,1102338,False,2XC6-T839-T62X-H239
EIkG9PPVzJA7ERo4wQ,1725800654,–ù–æ–≤–∞ –ø–æ—à—Ç–∞,7399,7399,-16250,-16250,980,0,0,1138138,False,CEHC-64P0-TT0C-P6C1
GcnHvLR_6gBWeA1Z9A,1725788096,Best Way To Cup,5814,5814,-27000,-27000,980,0,202,1154388,False,H1B8-BH82-1X3P-BMXA
hHkMD3suLZCS_H_C3w,1725783766,Novapay,8999,8999,-5000,-5000,980,0,0,1181388,False,E6CK-M02C-THP8-X2K1
NsH3lUwszTdFAJJ9Og,1725780224,–°—ñ–ª—å–ø–æ,5411,5411,-22796,-22796,980,0,170,1186388,False,H8E6-555K-XP2B-00C7
-YGI0H6B4z7h4fKuShel7Q,1725750549,Bolt,4121,7999,-2696,-2696,980,0,0,1209184,True
aKMwth_wQL49aPU9mMnM8ZnY44E,1725750549,–°–∫–∞—Å—É–≤–∞–Ω–Ω—è. Bolt,4121,7999,8000,8000,980,0,0,1211880,False
AhbAx0G3eC5dZ-9FuA,1725729391,Novus,5411,5411,-29844,-29844,980,0,223,1203880,False,6T91-3H91-6M12-BMB1
YMaFSXBUkOgKEZdssQ,1725712763,APTEKA 13,5912,5912,-3560,-3560,980,0,0,1233724,False,TBEC-8AM9-X6P5-X319
mb9itryqZpq0EZplGw,1725712564,OK Wine,5411,5411,-19900,-19900,980,0,149,1237284,False,9822-P255-C981-P5TH
5wMTWy7Gkz5eBHELug,1725706720,–ê–≤—Ç–æ–º–∞–≥–∞–∑–∏–Ω,7542,7542,-170000,-170000,980,0,0,1257184,False,MM8T-5591-KXHH-32E0
pAm75uJwr4y_6WC9Ow,1725702306,WFP.GROCERY1,5499,5499,-76280,-76280,980,0,572,1427184,False,5874-HP88-01M0-0H8M
atDCZaU0PjO5E4-UWw,1725697416,Novapay,8999,8999,-26950,-26950,980,0,0,1503464,False,3B0T-K081-P007-EKAK
mheJxseJP6U6hKFwDDXE,1725663477,Bolt,4121,4121,-12100,-12100,980,0,0,1530414,True
WjVbrfTdJQXwFUxahNCYa4BWCZw,1725663477,–°–∫–∞—Å—É–≤–∞–Ω–Ω—è. Bolt,4121,4121,12000,12000,980,0,0,1542514,False
ikju0P7JW5C6R8Ss-w,1725641100,Prostor,5977,5977,-16920,-16920,980,0,0,1530514,False,3C33-8300-T8CC-8955
FzKLjH_vTTftFPC2dA,1725640794,OK Wine,5411,5411,-30550,-30550,980,0,229,1547434,False,BC7P-3PX8-277E-6B52
IdNY5_0WBehsZt0jBQ,1725640340,Beerplace,5814,5814,-30000,-30000,980,0,225,1577984,False,0602-A19X-BP24-1CK6
s3rkDUM6NaPEP9MPPw,1725640134,–ï–∫–æ-–õ–∞–≤–∫–∞,5411,5499,-27800,-27800,980,0,208,1607984,False,9HKA-32PA-HX41-A4CM
AdfT7Sj9CiUMjwg9YQ,1725639559,Ponchyk Boy | –û–ª–µ—Å—è –ì–æ–Ω—á–∞—Ä–∞,5812,5812,-14500,-14500,980,0,108,1635784,False,2HP1-HX91-MTCK-1734
Q0vZX7p1z53-Vl0vBg,1725637766,Novapay,8999,8999,-5000,-5000,980,0,0,1650284,False,7070-E3K9-XCEH-9B2K
XfawSwtvWTkuqcvT3A,1725622225,Bolt,4121,7999,-8000,-8000,980,0,0,1655284,False
7Jl9svOOJUed-EDGlA,1725609355,Bolt,4121,4121,-11000,-11000,980,0,0,1663284,False,4C03-P4AH-PP1P-H1E7
2ijwd77gEbnzZhxXTw,1725606183,2bfit_fitness_club,7941,7941,-199900,-199900,980,0,0,1674284,False,6A5C-A1B4-P78C-03AB
-InXEHNTO8itgZL-Hw,1725603347,Bolt,4121,4121,-12000,-12000,980,0,0,1874184,False
ZDGf4qRoLVFWI_LSTw,1725603052,FOP Shevchenko,5499,5499,-13500,-13500,980,0,101,1886184,False,3CE1-9E1H-K4X8-15H6
yD-tYNDyhD8YksV1sQ,1725556132,–°–µ—Ä–≥—ñ–π –ü.,4829,4829,-66560,-66560,980,2560,0,1899684,False,3C0H-PA1T-MA5E-6942
8CG5tto4Y8gFAzddsA,1725555193,–°—ñ–ª—å–ø–æ,5411,5411,-48800,-48800,980,0,403,1966244,False,084K-9AMH-074C-6EP9
ygrzgAUtU8Z7yzX9NA,1725527597,–£–∫—Ä–ø–æ—à—Ç–∞,9402,9402,-108899,-108899,980,0,0,2015044,False,958P-9X04-PC4B-X427
b1bt7zSozAJOy2IEwA,1725521568,Bolt,4121,4121,-11000,-11000,980,0,0,2123943,False,CC1M-921T-T052-TAC2
7LdQjh3HNKuu8fUsEw,1725520959,AVANGARDEN,5812,5812,-30300,-30300,980,0,606,2134943,False,H054-7ME9-2746-122B
tpNfxwkEjConvS6ldg,1725517259,Bolt,4121,4121,-12000,-12000,980,0,0,2165243,False,CB9K-9XH8-EM75-489H
eJIiWvJaOAT2R0TjCg,1725517204,–ü–µ—Ä–µ–∫–∞–∑ –Ω–∞ –∫–∞—Ä—Ç–∫—É,4829,4829,-800000,-800000,980,0,0,2177243,False
kDdQhMQS1Ter72WWdA,1725516915,–ü–ª–∞—Ç—ñ–∂ Rozetka,4829,4829,-425800,-425800,980,0,0,2977243,False
Hsnmj2AYGtJy0BMraA,1725457851,–ö–∏—ó–≤ –¶–∏—Ñ—Ä–æ–≤–∏–π,4111,4111,-12250,-12250,980,0,0,3403043,False,58MC-P3CH-BKEK-P5T5
l6uAAaOomaoF0BRw2A,1725456567,Best Way To Cup,5814,5814,-8000,-8000,980,0,160,3415293,False,39B8-1MT0-T602-M3T6
njoeNp5WGfc06kQxmA,1725440650,AVANGARDEN,5812,5812,-33000,-33000,980,0,660,3423293,False,2MT7-0E45-67X4-037E
bQhor9-D_GppyosBIg,1725439598,PetStoriesZootovari,5995,5995,-42400,-42400,980,0,0,3456293,False,1PM5-87HK-C0BK-804K
m0zj-Bxgv-DIqEEYCg,1725438491,Bolt,4121,4121,-10700,-10700,980,0,0,3498693,False,MPK1-A250-KCPX-X05C
1pCaPNXom3ulZy0jDw,1725430105,Bolt,4121,4121,-14400,-14400,980,0,0,3509393,False,K700-9X79-TT5C-T31K
MSHaSiKC2VegvmzoNg,1725371872,Katimo cafe,5814,5814,-11000,-11000,980,0,220,3523793,False,93K3-X400-X667-H56A
6eOH7GqHXtBJcj0IeQ,1725370802,PekarnyaHliBar,5462,5462,-4500,-4500,980,0,45,3534793,False,26MB-5E2X-M63H-EPKC
oJiNYdLeG8HEllfkEA,1725368781,Lesya,4829,4829,-400000,-400000,980,0,0,3539293,False,8X6H-TP41-8EPP-9A4B
KYTmbN1TW0cLtRQCbg,1725367974,Best Way To Cup,5814,5814,-32100,-32100,980,0,642,3939293,False,45HA-C90M-B68E-TEXM
Pe__GZ7jr7kVoXWdLQ,1725366141,–ü–æ–ø–æ–≤–Ω–µ–Ω–Ω—è ¬´–ù–∞ –∫–æ–º–ø—É–∫—Ç—î—Ä –¥–ª—è –≥—Ç6¬ª,4829,4829,-17400,-17400,980,0,0,3971393,False
vgJ0mKhw-I2sQ2bWrw,1725366130,–ü–æ–ø–æ–≤–Ω–µ–Ω–Ω—è ¬´–Ω–∞ –¥—Ä—ñ–º –≤–∞–Ω–Ω—É¬ª,4829,4829,-25000,-25000,980,0,0,3988793,False,3BX8-C8C4-BPCT-PHC0
uxXLgCeDbMxG7u_hcg,1725366086,516875****3207,4829,4829,-125000,-125000,980,0,0,4013793,False,5C91-14XK-61HK-MAB4
aLNDfTr5d_zxrrvTRA,1725348316,–ö–∏—ó–≤ –¶–∏—Ñ—Ä–æ–≤–∏–π,9222,9222,-36750,-36750,980,0,0,4138793,False,276T-18AX-M75E-55KT
2AGfzExbVb_zrKzvWg,1725347391,Bolt,4121,4121,-11400,-11400,980,0,0,4175543,False,X1KT-CT3P-774A-9K33
KnFZjU5zErJKEuww1w,1725343775,Bolt,4121,4121,-13100,-13100,980,0,0,4186943,False,P4AT-8KCP-PTH5-6449
wyhTwXjB9IIHdj8SNg,1725343698,–íi–¥: –ü–†–ò–•–û–î–¨–ö–û –ï.–í. –§–û–ü,"–î–ª—è –ø–æ–ø–æ–≤–Ω–µ–Ω–Ω—è –∫–∞—Ä—Ç–∫–∏ 5375414101190360, –ü—Ä–∏—Ö–æ–¥—å–∫–æ –ï—Ä–Ω–µ—Å—Ç –íi–∫—Ç–æ—Ä–æ–≤–∏—á, 3487403339",4829,4829,4200000,4200000,980,0,0,4200043,False
ozG1xyp5mkEbmp5JnQ,1725176090,–ö–£–ó–Ø,4900,4900,-14000,-14000,980,0,0,43,False,07K3-58PT-67C9-BEPB
jq7RAnMd73z04-YWzA,1727576928,–†–µ–≥—É–ª—è—Ä–Ω–µ –ø–æ–ø–æ–≤–Ω–µ–Ω–Ω—è ¬´–§–æ–Ω–¥ –ü–æ–≤–µ—Ä–Ω–∏—Å—å –∂–∏–≤–∏–º¬ª,4829,4829,-25000,-25000,980,0,0,486292,False,T8XP-KK05-6A3A-CT9B
ovxaK0m4ed9r0awapA,1727420737,–û–ª—å–≥–∞ –î.,4829,4829,-11000,-11000,980,0,0,511292,False,86KH-PC6A-0MX3-1M67
p_x111fmX0yZudVLTg,1727420549,–ü–µ—Ä–µ–∫–∞–∑ –Ω–∞ –∫–∞—Ä—Ç–∫—É,4829,4829,-150000,-150000,980,0,0,522292,False
yR0rQVuX2sno4Jo8Ug,1727420279,414949****2985,4829,4829,-10050,-10050,980,0,0,672292,False,692H-38B2-5761-E339
_sF-2OGp5_VaYhkUoA,1727365187,–ß–∞—Å—Ç–∫–æ–≤–µ –∑–Ω—è—Ç—Ç—è –±–∞–Ω–∫–∏ ¬´–ù–∞ –∫–æ–º–ø—É—Ç—î—Ä –¥–ª—è –≥—Ç–∞6¬ª,4829,4829,400000,400000,980,0,0,682342,False
x2gj3NJovDuk3wu5yg,1727365138,431414****7562,4829,4829,-150000,-150000,980,0,0,282342,False,9CKK-B53C-79EP-C82B
T5iqQ23KxY4nqFPmOg,1727293791,–ê–Ω–Ω–∞ –ö.,4829,4829,-138500,-138500,980,0,0,432342,False,5C0X-81KK-7AKM-40KC
pLCf8eSbOtVbSLFBKw,1726972143,–†–µ–≥—É–ª—è—Ä–Ω–µ –ø–æ–ø–æ–≤–Ω–µ–Ω–Ω—è ¬´–§–æ–Ω–¥ –ü–æ–≤–µ—Ä–Ω–∏—Å—å –∂–∏–≤–∏–º¬ª,4829,4829,-25000,-25000,980,0,0,570842,False,7E1K-H0P5-CH27-MTEM
gzjbFzqjCUkAbTavaw,1726953140,–ü–æ–ø–æ–≤–Ω–µ–Ω–Ω—è ¬´–Ω–∞ –¥—Ä—ñ–º –≤–∞–Ω–Ω—É¬ª,4829,4829,-32800,-32800,980,0,0,595842,False,X0K4-48T2-5PH6-TXC3
WPU8OE1P__w9Jn3Oqw,1726833412,–î–æ—Å—Ç—Ä–æ–∫–æ–≤–µ –ø–æ–≥–∞—à–µ–Ω–Ω—è Rozetka,4829,4829,-851600,-851600,980,0,0,628642,False
fsNEM92fJZpufYt6cw,1726833380,–í—ñ–¥: –û–ª–µ—Å—è –°–∞—á–µ–Ω–∫–æ,4829,4829,850000,850000,980,0,0,1480242,False
J5pQMjtotE6Ue5PK_Q,1726819722,–ù–∞—Ç–∞–ª—ñ—è –ì.,4829,4829,-10000,-10000,980,0,0,630242,False,X8AH-21PB-PHCA-H5A5
QqcEXH2ZyCT4uberdg,1726819530,–û–ª—å–≥–∞ –î.,4829,4829,-20000,-20000,980,0,0,640242,False,BC3P-E146-X3CM-B845
lpMUBOKAcXLZDIlAbw,1726819283,414949****2985,4829,4829,-10050,-10050,980,0,0,660242,False,KA7C-E721-MT40-C3HC
uMkHoIGRE2Hi97Mw8g,1726754045,–ó —á–æ—Ä–Ω–æ—ó –∫–∞—Ä—Ç–∫–∏,4829,4829,500000,500000,980,0,0,670292,False
lCGAzrpwQ1-ttktn9w,1726407097,–ü–æ–ø–æ–≤–Ω–µ–Ω–Ω—è ¬´–æ–±–µ—Ä–µ–º–∫–∏ 1.0¬ª,4829,4829,-80000,-80000,980,0,0,170292,False,7C0H-EXC0-17A8-25AT
g6B0TRUSvmwkOmjlJQ,1726367527,–†–µ–≥—É–ª—è—Ä–Ω–µ –ø–æ–ø–æ–≤–Ω–µ–Ω–Ω—è ¬´–§–æ–Ω–¥ –ü–æ–≤–µ—Ä–Ω–∏—Å—å –∂–∏–≤–∏–º¬ª,4829,4829,-25000,-25000,980,0,0,250292,False,2XX1-X39B-30H7-TA8P
-AqMABu38yZ_5h0Hfw,1726222050,414949****2985,4829,4829,-10000,-10000,980,0,0,275292,False,0EXX-2H7X-2421-C1CX
ImuSWwrqm_6Saa8b4w,1726218722,–ü–æ–ø–æ–≤–Ω–µ–Ω–Ω—è ¬´–ß–∞–π–æ–≤—ñ –∫–æ–º–∞–Ω–¥—ñ bwtc¬ª,4829,4829,-10000,-10000,980,0,0,285292,False,2684-CH87-H8X0-PXT6
kGQbHwLKTiDP6lhTTQ,1726215409,–ú–ê–öI–ô–ß–£–ö –ê.–í. –§–û–ü,4829,4829,-482500,-482500,980,0,0,295292,False,5KPC-T9A2-BB14-0255
FqM5yADCCnWBgXPEiw,1726157477,–ó —á–æ—Ä–Ω–æ—ó –∫–∞—Ä—Ç–∫–∏,4829,4829,500000,500000,980,0,0,777792,False
tT4_3WTOiPBpEClrbg,1725784561,414949****9510,4829,4829,-120603,-120603,980,0,0,277792,False,5K3T-E2TB-2EH8-H9HB
udQmo3yZwYvNqoU3mg,1725762539,–†–µ–≥—É–ª—è—Ä–Ω–µ –ø–æ–ø–æ–≤–Ω–µ–Ω–Ω—è ¬´–§–æ–Ω–¥ –ü–æ–≤–µ—Ä–Ω–∏—Å—å –∂–∏–≤–∏–º¬ª,4829,4829,-25000,-25000,980,0,0,398395,False,5714-37XK-BECA-6CXA
v90qmuMqBT0eJFQSaw,1725721228,Lesya,4829,4829,-300000,-300000,980,0,0,423395,False,6A34-K26H-XK3X-TA2H
TpB9RCP8dEodxErJ1Q,1725708951,414960****1035,4829,4829,-86000,-86000,980,0,0,723395,False,6X4M-4K5M-6T7K-94M3
2eSbZeJPCuMPZ_uAMg,1725517205,–ó —á–æ—Ä–Ω–æ—ó –∫–∞—Ä—Ç–∫–∏,4829,4829,800000,800000,980,0,0,809395,False
v7NzEsJRTtR8wHpMpQ,1725188341,EasyPay,5411,5411,-315300,-315300,980,0,2364,9395,False,31PT-65HC-CH23-6CT6
mPydhrCJS5VXQDWIxg,1725188198,–í—ñ–¥: –û–ª–µ—Å—è –°–∞—á–µ–Ω–∫–æ,4829,4829,320000,320000,980,0,0,324695,False
oN55QDvDlh6PUCx1bg,1730313878,REMI,5812,5812,-102500,-102500,980,0,0,33842,False,BM91-289E-1925-8652
AiDqKXi2T-Nsp3DVWQ,1730307585,–ü–∞—Ä–∫–æ–≤–∫–∞,7523,7523,-16000,-16000,980,0,0,136342,False,K9M4-A7KB-9524-24TH
qH6OQXMgyKlL2ERPvg,1730282562,Bolt,4121,7999,-8000,-8000,980,0,0,152342,False
ZZ38gi7u6FmkE8aL1g,1730278841,2bfit_fitness_club,7941,7941,-80000,-80000,980,0,0,160342,False,1794-EX29-0X04-1CTC
FAtXEZ8HGu-VvdfA4g,1730227482,–°—ñ–ª—å–ø–æ,5411,5411,-4398,-4398,980,0,32,240342,False,49M6-958H-E6HT-9ATX
Mg6BB0gQ8VWqARM76A,1730227436,–°—ñ–ª—å–ø–æ,5411,5411,-69790,-69790,980,0,523,244740,False,7HBT-H266-K801-MM45
Q8Daoiqn4f-4LWigRA,1730227382,iPay.ua,7399,7399,-2500,-2500,980,0,0,314530,False,818A-E86A-HC1A-P66E
j8CYN-qRgRDUpCkI1g,1730224798,WOG,5541,5541,-110007,-110007,980,0,5500,317030,False,0334-A3BK-35EM-H148
KL37ASPZItry3K9u2A,1730223501,Pekarnia KhliBar,5462,5462,-16500,-16500,980,0,123,427037,False,H1C0-3X18-P35K-M728
PoWCA70jfsmQBBl5BQ,1730214254,KvitkarnyaYu,5992,5992,-87000,-87000,980,0,652,443537,False,KCBK-A8X6-9X66-2ME7
UN_oqVNYi5kvV6c8DA,1730213214,Ukrkhalial,5499,5499,-58852,-58852,980,0,441,530537,False,EABA-0PP2-5HK5-0BXP
tH5vwpX3dwott9zalA,1730212839,–ü–æ–ø–æ–≤–Ω–µ–Ω–Ω—è –ü—Ä–∏–≤–∞—Ç24,6536,6536,500000,500000,980,0,0,589389,False
1VNIC1na2oQWZVYCyg,1730184693,–ü–∞—Ä–∫ ¬´–ú—É—Ä–æ–º–µ—Ü—å¬ª,7523,7523,-4000,-4000,980,0,0,89389,False,8868-H313-EKP5-P57T
1LRydCxPGHUGec_3-g,1730135144,JYSK,5200,5712,-185000,-185000,980,0,0,93389,False,P9A9-5PAP-E3KH-HXE8
F5W9vJxUpJlalBmKEg,1730134757,–ó –±—ñ–ª–æ—ó –∫–∞—Ä—Ç–∫–∏,4829,4829,50000,50000,980,0,0,278389,False
6KeAvOseFB_lEJAH7A,1730107983,Mates,5812,5812,-17400,-17400,980,0,0,228389,False,8MK6-10P4-BBMC-6BEP
S1Lu0HI6tEgKaw7-4g,1730107222,2bfit_fitness_club,7941,7941,-219900,-219900,980,0,0,245789,False,676T-1M32-BB77-M656
kb_7nPPCW3psyobebg,1730101098,–ó –±—ñ–ª–æ—ó –∫–∞—Ä—Ç–∫–∏,4829,4829,300000,300000,980,0,0,465689,False
8ygT4lAOf5OqgpV9xA,1730052067,Fresh Dzhus end Babl T,5814,5814,-15000,-15000,980,0,0,165689,False,P48P-5821-P3C1-84HX
9TaTmqU2d0qm5F2RuA,1730051788,ITIS CAFE,5814,5814,-17700,-17700,980,0,0,180689,False,4E4X-MXP8-EA4E-C7EB
aAELtsU2lPZJW_r_XA,1730037246,WFP.GROCERY1,5499,5499,-34580,-34580,980,0,259,198389,False,B1HE-PK7P-1516-TKMA
vq78ShfPSgRqyHacYA,1730027759,–ö–£–ó–Ø,4900,4900,-45000,-45000,980,0,0,232969,False,50XB-0XK1-81H4-65B1
eMImnAGeHm_qLZGgqA,1730020119,Best Way To Cup,5814,5814,-8000,-8000,980,0,0,277969,False,0AXC-73K6-4T1C-PH8M
UFWNN3a4N3UC3uxo7g,1730015563,Novapay,8999,8999,-7300,-7300,980,0,0,285969,False,10CT-X0T6-9BAC-0K96
6MfDfwiTf_kgKfWaGQ,1730015530,Novapay,8999,8999,-8000,-8000,980,0,0,293269,False,TPP0-4EPK-KB58-EEHH
2Dj6GvmDyn31XJiqEQ,1729958101,LIQPAY*Food Spot Corp.,5812,5812,-83300,-83300,980,0,0,301269,False,ET9M-H641-3EB7-9X63
fp6jL8JBKAEWP7HSXA,1729954355,WFP.CONSULT1,7277,7277,-75000,-75000,980,0,0,384569,False,7AXB-A2MK-K9C8-375H
JnS2_mqQ9MsNMM09pg,1729947212,WOG,5541,5541,-215964,-215964,980,0,10798,459569,False,6M42-TXTT-H59K-49E1
wZ0sWXRNzFPjirPT6Q,1729941034,AZS TIK,5541,5541,-1700,-1700,980,0,0,675533,False,8AHP-X7E8-8PXH-9BHC
LEJPjGmLAlV9KngT2w,1729933913,kafeDolcheFektori,5812,5812,-22000,-22000,980,0,0,677233,False,02HT-48MK-1441-EKCB
HeeBkIH4QXHy0-zR0Q,1729933647,kafeDolcheFektori,5812,5812,-11000,-11000,980,0,0,699233,False,8H2K-KKE1-EBT7-A0CT
SCEiTvREB76-mEna4Q,1729875762,Novapay,8999,8999,-6000,-6000,980,0,0,710233,False,M9B5-3761-H1TH-XAEX
1I_KAvdUvpV_hdjI_Q,1729869221,SADYBA KAZKA,7011,7011,-10000,-10000,980,0,0,716233,False,KC29-X3KB-K7A0-25X3
609-2-05G5RplTbQag,1729857963,SADYBA KAZKA,7011,7011,-130000,-130000,980,0,0,726233,False,E5KK-69K5-7A45-1K8C
DoAFahl1Uy149Ya-Zg,1729839286,Steam,5816,5816,-25500,-25500,980,0,0,856233,False,M65C-8M0H-1C5C-H8KE
wEQCWAOYldkBp2ypqw,1729775220,Restoran Kupalysyka ni,5812,5812,-9500,-9500,980,0,0,881733,False,A2BA-7K0K-72X0-MA4A
jeV6Ns0iSMr--P7PRA,1729775197,Restoran Kupalysyka ni,5812,5812,-25500,-25500,980,0,0,891233,False,X59X-PTME-X00H-6B5P
ewaRR_hJiMOqCCcigA,1729770642,Kopiiochka,5399,5399,-3470,-3470,980,0,26,916733,False,0CK2-B9P2-PK4B-KTEE
QRg6xqwGxasU7l3H0A,1729770325,–ê–¢–ë,5411,5411,-135155,-135155,980,0,1013,920203,False,1461-484A-P4T6-60E7
MV0HNhksY10RHHaF9Q,1729764209,MARKET 100,5499,5499,-4666,-4666,980,0,34,1055358,False,A9K8-03M5-11XM-4HC5
59lJ1qAbze5h8m6Wuw,1729586298,–°—ñ–ª—å–ø–æ,5411,5411,-60100,-60100,980,0,450,1060024,False,4814-72TT-K88M-086K
nLX4xQJySLO3kZqliA,1729511703,–ê–¢–ë,5499,5499,-77851,-77851,980,0,583,1120124,False,H116-074A-P789-AM97
LR_rldfmEHMuuzcBEQ,1729509744,AZSIspas,5541,5541,-49980,-49980,980,0,0,1197975,False,1H41-72B2-4666-PTM1
OVfcsRpgl6FVEw1VQg,1729503857,WOG,5541,5541,-16900,-16900,980,0,845,1247955,False,684T-TPTT-EABB-92PE
T0wxgOGNJZN38FZoxw,1729502565,–°—ñ–ª—å–ø–æ,5411,5411,-270200,-270200,980,0,2026,1264855,False,MATK-87T8-6K16-8236
QPtvFWrI-m7WTVN-jA,1729499177,GotelVIKTORIADELUXE,7011,7011,-10000,-10000,980,0,0,1535055,False,603E-KC0H-7039-T964
p29GcmIwqFPo73SuGA,1729493760,–ú–µ—Ä–µ–∂–∞ –∞–ø—Ç–µ–∫ D.S.,5912,5912,-15000,-15000,980,0,0,1545055,False,7028-03AX-B4B6-P656
oXp5ZJAwwEBhu4QAvA,1729493081,"Lifecell
+380631692598",4814,4814,-26000,-26000,980,0,0,1560055,False,89H6-3AEX-9M2T-XM89
m8L9xsfZ3TDDbIjqIw,1729492983,–ö–∞—Ñ–µ –ú–∞—Ç—å—î,5812,5812,-32100,-32100,980,0,0,1586055,False,M711-B2BB-TXHE-5E28
J8W_ccZJEhv3RoHzNw,1729490496,–ö–∞—Ñ–µ –ú–∞—Ç—å—î,5812,5812,-51000,-51000,980,0,0,1618155,False,54AM-TEM9-BKMK-6169
Lwn9jE2lct1sHS19og,1729446666,Daddy Cool,5812,5812,-108100,-108100,980,0,0,1669155,False,2T7K-M5BE-67MC-K87K
6hZVMJoo1_B6oA4dgA,1729441348,–î—ñ–º 18,5812,5812,-55000,-55000,980,0,0,1777255,False,E85T-8BEC-19T1-3EPM
I7txyiSamlBWoh83fg,1729430032,WineTime,5921,5921,-29900,-29900,980,0,224,1832255,False,3880-E1MP-PT1B-TKH4
Gx25IYX-Cz975cMBDQ,1729429114,MY CAKE,5814,5814,-24000,-24000,980,0,0,1862155,False,KPKB-092P-6342-6KBB
0M-R1dWP2_B6s4xSGA,1729428330,Room Room,5812,5812,-85300,-85300,980,0,0,1886155,False,T2KP-XX5M-M598-9PBT
BuksYMZgkHkNyu4eDA,1729424832,SHOP ZHYVYY KUTOK,5995,5995,-36080,-36080,980,0,0,1971455,False,ATBP-BK3E-831E-17K5
2MooWrv0YWwPfvYE8A,1729421477,EVA,5977,5977,-21700,-21700,980,0,0,2007535,False,E0M4-248B-9079-0C2E
y7xxUV4inOxB4pippw,1729418569,Literaturbank,5814,5814,-25000,-25000,980,0,0,2029235,False,AE5A-16PX-M575-BB7T
PS8YDlwXu20crtFckw,1729408315,BROYT un tsu BROYT,5812,5812,-78700,-78700,980,0,0,2054235,False,BM5C-26H1-TH82-X9M6
AhOlAWNw-eeDbg--bXMqWP63QPo,1729382147,–°–∫–∞—Å—É–≤–∞–Ω–Ω—è. MauDau,5331,5411,32400,32400,980,0,-243,2132935,False
-G0poCQSPCrQl1xJew,1729362053,ProduktoviyRay,5499,5499,-4200,-4200,980,0,42,2100535,False,H5HT-B6TH-XA1T-MXHP
7DNxRtPyIsj1QXFlqw,1729361136,Restoran,5814,5814,-129270,-129270,980,0,0,2104735,False,K692-1P04-4H3M-2B4E
uyBo64Ty2DqGFd8niQ,1729361114,Restoran,5814,5814,-43000,-43000,980,0,0,2234005,False,1C75-43M0-8CE2-K4XA
x9B028O4Vvz1gPpZqQ,1729356955,GotelVIKTORIADELUXE,7011,7011,-513000,-513000,980,0,0,2277005,False,7M0C-6X11-1B16-64B1
WJ6Z5bndhDNfKAEO8A,1729350698,POBUTKOMBUDSERVIS,4784,4784,-1000,-1000,980,0,0,2790005,False,3E49-1976-3455-CP5C
Ax2RP3NkpNoe_Z-kFQ,1729346041,BRSM RUZHYCHANSKA,5541,5541,-16198,-16198,980,0,0,2791005,False,7141-2T8T-XMK3-8644
jMOwYzLy_T-DJHospQ,1729345252,WOG,5541,5541,-93483,-93483,980,0,4674,2807203,False,577A-X751-ABEM-MTKX
Sl5m_9xI9zGzBx8kSg,1729334258,Kafe Bar,5814,5814,-50200,-50200,980,0,0,2900686,False,AXH0-8K72-7H12-31BT
a6g8oJi28TgjwEbZvg,1729327022,WOG,5541,5541,-149975,-149975,980,0,7498,2950886,False,29M0-45M4-2MP3-BPBB
KW8CnTP_znGYp_kBGA,1729320960,–ê–ù–¶,5912,5912,-44829,-44829,980,0,0,3100861,False,83X9-2763-2TXP-9H26
rfU2HnKzws1WpcrYCA,1729319846,Best Way To Cup,5814,5814,-34000,-34000,980,0,0,3145690,False,HTE8-0B25-ACEH-5423
jyXaWFbjxj3dJ6MeRu-2nw,1729293609,Bolt,4121,7999,-4889,-4889,980,0,0,3179690,True
FDvmTgEdFJytNfCj7YNwVxYl4jQ,1729293609,–°–∫–∞—Å—É–≤–∞–Ω–Ω—è. Bolt,4121,7999,8000,8000,980,0,0,3184579,False
cKtrQPy1AMWrod70qg,1729269998,SHOP SHKARPETOCHKA,5949,5949,-40500,-40500,980,0,0,3176579,False,HT9A-24K5-MP57-MB4K
UgmL3lF_GDxpRun34w,1729269881,Novus,5411,5411,-5097,-5097,980,0,50,3217079,False,BT4M-5T0T-X4PT-9579
A3OBnDHU92d5wL8msA,1729269701,Novus,5411,5411,-68993,-68993,980,0,689,3222176,False,5M1B-C6BT-X51E-5674
Y4JXpsEv7UixiQ7VrQ,1729268450,–ù–æ–≤–∞ –ø–æ—à—Ç–∞,7399,7399,-43000,-43000,980,0,0,3291169,False,K040-B44C-3095-EE8P
9R9k9eLlsbOsX19_MA,1729266678,Ninja Sushi,5814,5814,-70000,-70000,980,0,0,3334169,False,5T35-BT25-1PK4-0M93
33U7r_kA_akof2c9Qg,1729244847,Best Way To Cup,5814,5814,-40500,-40500,980,0,0,3404169,False,0TX0-97KH-303E-77CE
0CdGK1XMu5cDBcFqGg,1729244660,Novus,5411,5411,-15400,-15400,980,0,154,3444669,False,HM9T-TC6P-HPX2-8B7B
LENobEAkshwaGI6fNg,1729243141,2bfit_fitness_club,7941,7941,-80000,-80000,980,0,0,3460069,False,TKM2-K152-2EX2-013P
LRvVKNF2EgjDYNQu1g,1729236575,deeply,5977,5977,-104000,-104000,980,0,0,3540069,False,X288-8H5X-B7PX-P067
kjIvxPEuxe_W8Hzj8A,1729165332,–°—ñ–ª—å–ø–æ,5411,5411,-100,-100,980,0,1,3644069,False,1131-EEXK-79MM-TX18
eXmgF3a0Sldn5QWWcQ,1729164147,Goodwine,5411,5411,-136400,-136400,980,0,1364,3644169,False,23K1-82M5-M30E-TBP2
qnW3AbKlGycMZQuCyQ,1729162004,Novapay,8999,8999,-8000,-8000,980,0,0,3780569,False,A15E-62EK-0642-4389
6vWKnWzGxVdIOMVQ4g,1729160122,–ü–æ–ø–æ–≤–Ω–µ–Ω–Ω—è ¬´–ù–∞ —Ö–æ—Ä–æ—à–µ¬ª,4829,4829,-150000,-150000,980,0,0,3788569,False,9T2C-AT82-6T09-8AA5
Rwab_KSI3-eeotuJJw,1729158847,–ü–æ–ø–æ–≤–Ω–µ–Ω–Ω—è ¬´MPB BANK 118 –ë–†–ò–ì–ê–î–ê¬ª,4829,4829,-50000,-50000,980,0,0,3938569,False,8A6E-KCTP-8BM2-9BT2
pbozPkGB3KWbTNkd2A,1729143547,Bolt,4121,7999,-8000,-8000,980,0,0,3988569,False
tE1BR5D2el7clWXmtQ,1729096782,–§–ö –ï–í–û,5399,5399,-3000,-3000,980,0,30,3996569,False,AT84-18KP-A55E-349K
THZMN-bjVBhb2xYaWA,1729096098,Novus,5411,5411,-18397,-18397,980,0,183,3999569,False,HHKM-466B-9457-KB06
Lbw_GAxMh68IoocAXg,1729068460,–°—ñ–ª—å–ø–æ,5411,5411,-9674,-9674,980,0,96,4017966,False,AEA7-116P-6A5H-5B5X
lk3ooKWAcZL2Rpdzqw,1729066602,2bfit_fitness_club,7941,7941,-79000,-79000,980,0,0,4027640,False,102H-KKAP-CC16-617X
lBrSurttZr_9zmb29g,1729066218,kafeLAYBA,5814,5814,-7000,-7000,980,0,0,4106640,False,P6TE-0C38-B00T-M2P9
Hd3hj2a5AZdNgMbBbw,1729057170,Bolt,4121,4121,-13100,-13100,980,0,0,4113640,False,6CC2-EBBB-4T39-3288
Y126paA7mNTGTiA6fA,1729013035,Doggeriz | –ì–æ–≥–æ–ª—ñ–≤—Å—å–∫–∞,5812,5812,-42900,-42900,980,0,0,4126740,False,MP3A-51A6-1C9K-HM5X
ee8bRM54IbkoW-Qcfg,1728998214,–ù–æ–≤–∞ –ø–æ—à—Ç–∞,7399,7399,-14500,-14500,980,0,0,4169640,False,00BA-BK8E-B67B-XX4X
_68bX39CjQVbh4GlPA,1728997675,Novus,5411,5411,-13594,-13594,980,0,135,4184140,False,2B2E-56T1-TTCX-9TPP
TjaGh9i5Pm2omXxYVA,1728935616,Novapay,8999,8999,-11000,-11000,980,0,0,4197734,False,5H6B-K86T-EBPB-3616
9pAVH7VfvITtLHK9AQ,1728931536,–û–ª–µ–∫—Å—ñ–π –•.,4829,4829,-70000,-70000,980,0,0,4208734,False,XC7H-C73E-6TH4-1640
SN01AeDyVAEi-g-0jw,1728921629,Produktoviymagazin,5499,5499,-2100,-2100,980,0,21,4278734,False,PE51-KT5C-7T30-1B7H
SQNJgZmjU02hMmO3kQ,1728912721,Cheesecake Family,5812,5812,-29500,-29500,980,0,0,4280834,False,0A5A-1BT1-36AB-4K6T
Y44u4A61JtogRGlg-Q,1728911342,–°—ñ–ª—å–ø–æ,5411,5411,-5900,-5900,980,0,59,4310334,False,9C93-75H7-0AM4-EAA2
54iqsePDy74mdIVDFg,1728908841,StomatologiyaFdclinic,8021,8021,-39000,-39000,980,0,0,4316234,False,CM20-X4E5-HTXX-T7BC
8kUzkahi5xaduGfjuQ,1728898308,–ü–æ–ø–æ–≤–Ω–µ–Ω–Ω—è ¬´puppy¬ª,4829,4829,-90000,-90000,980,0,0,4355234,False,1K8E-64KP-T6E9-ME80
HIud9TZVaAeRcf4L4g,1728898246,–íi–¥: –ü–†–ò–•–û–î–¨–ö–û –ï.–í. –§–û–ü,"–î–ª—è –ø–æ–ø–æ–≤–Ω–µ–Ω–Ω—è –∫–∞—Ä—Ç–∫–∏ 5375414101190360, –ü—Ä–∏—Ö–æ–¥—å–∫–æ –ï—Ä–Ω–µ—Å—Ç –íi–∫—Ç–æ—Ä–æ–≤–∏—á, 3487403339",4829,4829,4000000,4000000,980,0,0,4445234,False
xHqLCRtc8Jlcpu1QkA,1728893331,2bfit_fitness_club,7941,7941,-80000,-80000,980,0,0,445234,False,1C4B-H16M-5EXK-2H68
R54WQ74zTTz6XmWQyQ,1728826169,–°—ñ–ª—å–ø–æ,5411,5411,-64999,-64999,980,0,487,525234,False,K1KK-EA98-5K0H-E4XE
hKIPYMSuogpKzlEFtQ,1728810243,Best Way To Cup,5814,5814,-17800,-17800,980,0,0,590233,False,TMXT-P2BM-A24P-T6K0
juSsJvQo3u_wTA8BmhljRA,1728774139,Bolt,4121,4121,-23400,-23400,980,0,0,608033,True
JhCEUx709we5V3m9U5ZAsrSUuIY,1728774139,–°–∫–∞—Å—É–≤–∞–Ω–Ω—è. Bolt,4121,4121,20900,20900,980,0,0,631433,False
klwgz6pe33v9EVcrDg,1728745409,–ó –±—ñ–ª–æ—ó –∫–∞—Ä—Ç–∫–∏,4829,4829,200000,200000,980,0,0,610533,False
n7_A0Me3dsNLhboPZw,1728745348,LIQPAY*FOP Koval O.Yu.,8299,8299,-47500,-47500,980,0,0,410533,False,9A5X-EA43-11KH-6525
AxzNNuzfuRSs4MTZjg,1728745328,LIQPAY*FOP Koval O.Yu.,8299,8299,-32500,-32500,980,0,0,458033,False,A5C3-B1P2-BBHX-AA75
mUFUeUuyHAUXAoWiIw,1728736314,WFP.GROCERY1,5499,5499,-56285,-56285,980,0,422,490533,False,EE7K-TTA0-11X6-383P
gogkaYFhH6GNQn1x3g,1728733504,–§–ö –ï–í–û,5399,5399,-4000,-4000,980,0,30,546818,False,K0C9-4XX7-MK31-3THK
C2SgLJsMlIdfqWGIMQ,1728733472,–§–ö –ï–í–û,5399,5399,-43400,-43400,980,0,325,550818,False,57P8-1XCA-9MHX-1K39
P56ZJiBHeU5WrYUScg,1728733397,–ê–ø—Ç–µ–∫–∞ –î–æ–±—Ä–æ–≥–æ –î–Ω—è,5912,5912,-5070,-5070,980,0,0,594218,False,EK49-50TB-8K09-T2E9
7EISWoM0ROQ1ncpMzg,1728732836,MasterZoo,5995,5995,-94300,-94300,980,0,0,599288,False,27H2-K3MX-M3C9-4731
xUmuPD_Ou3ePh4-VGA,1728732584,Apteka,5912,5912,-12400,-12400,980,0,0,693588,False,15AE-B7H4-M65B-B6KK
j4rFY55Z0WMqBWQFOg,1728731258,KAVA NA DVOKH,5814,5814,-18000,-18000,980,0,0,705988,False,6BAH-7X16-HPMX-9408
hYF1ujexVWkJdvmnqQ,1728726028,–£–∫—Ä–∞—ó–Ω—Å—å–∫–∏–π –¥—ñ–º,7399,7399,-20000,-20000,980,0,0,723988,False,A870-2E7M-3HH1-23CH
yBDv1aeP1eWTxIfwMQ,1728724996,–ö–∏—ó–≤–ø–∞—Å—Ç—Ä–∞–Ω—Å,4111,4111,-800,-800,980,0,0,743988,False,PM50-PK0K-T6K4-B0H4
UUpOenkmMn6bLfBlrA,1728724951,–ö–∏—ó–≤–ø–∞—Å—Ç—Ä–∞–Ω—Å,4111,4111,-800,-800,980,0,0,744788,False,86BH-3MK7-CC2P-1E20
2CIl19tFn0Xji3g8QQ,1728722303,WOG,5541,5541,-239960,-239960,980,0,11998,745588,False,M009-0M0K-3203-HBEE
zrL-lVe4IXxo7U13nw,1728719748,FIRST POINT Espresso Bar,5812,5812,-32800,-32800,980,0,0,985548,False,8C80-H0E6-H3A5-03BH
E1PiFqc6MeN8lQ1rhA,1728719406,–°–ü√â–õ–¨–¢–ê,5812,5812,-74400,-74400,980,0,0,1018348,False,097C-TM15-0A16-CEX3
FZsCy0jzIuyx0-MVyQ,1728676367,Bolt,4121,4121,-20900,-20900,980,0,0,1092748,False
7GlzpvbgglkRPFpESg,1728663133,Novapay,8999,8999,-8000,-8000,980,0,0,1113648,False,7MHB-X3HA-PEP4-XPK4
eo1LjgsSsNZwX8xnZQ,1728662486,GelatoMama,5814,5814,-32000,-32000,980,0,0,1121648,False,MMB6-CP78-1C59-E654
Uz4tska1r56gySzu9g,1728650816,Novus,5411,5411,-2999,-2999,980,0,22,1153648,False,9AM5-H2C9-3015-E51E
us3sLOmucw_l0uInww,1728646791,Fresh Dzhus end Babl T,5814,5814,-22500,-22500,980,0,0,1156647,False,CTCP-P607-BA5H-M664
F1LczuUCP5Q4mkz7Aw,1728638774,–°—ñ–ª—å–ø–æ,5411,5411,-9400,-9400,980,0,70,1179147,False,6HC6-H1BA-24CT-M5M1
bt7lQjG8isj318bZNQ,1728637472,2bfit_fitness_club,7941,7941,-80000,-80000,980,0,0,1188547,False,3X65-TC2M-B776-64A7
YFnfNQv35DPjmr9-2Q,1728631423,Ukrkhalial,5499,5499,-80355,-80355,980,0,602,1268547,False,1APX-ME6E-06CH-P652
K8pgEsOpRvpDINGFFg,1728629899,Novapay,8999,8999,-6590,-6590,980,0,0,1348902,False,P4XT-CKK0-477X-H39A
U1uAifKC7573KbQlVA,1728629302,Best Way To Cup,5814,5814,-32000,-32000,980,0,0,1355492,False,MMKH-HX62-CEMM-AXHA
5HNcc42f_PQGJIJrhQ,1728626303,Bolt,4121,4121,-10500,-10500,980,0,0,1387492,False,9M3P-A69T-7640-XK99
JlctvlrFvzuCU2UYOA,1728583270,–°—ñ–ª—å–ø–æ,5411,5411,-38700,-38700,980,0,290,1397992,False,C49H-AP9A-KX4P-A95T
2BxtYglqVXzm0ZvFGg,1728572777,NUNU | –Ø—Ä–æ—Å–ª–∞–≤—ñ–≤ –í–∞–ª,5812,5812,-68000,-68000,980,0,0,1436692,False,8H1P-P967-BM7H-3A46
5rX3H44OObxL5ivhWg,1728556526,EasyPay,5411,5411,-299822,-299822,980,0,2248,1504692,False,2H61-B872-3TC6-TMT8
zFVOdNBmlfMhNs1WiQ,1728545608,–ö–∏—ó–≤—Å—å–∫–µ –º–µ—Ç—Ä–æ,4111,4111,-800,-800,980,0,0,1804514,False,E280-5H19-TK55-8CB7
J-4rWx0Y6Ksb12Io6w,1728540466,Cheesecake Family,5812,5812,-62500,-62500,980,0,0,1805314,False,E1C6-C127-16PM-0KEC
S5jrCUG0vsASBlzCTw,1728539242,–ö–∏—ó–≤—Å—å–∫–µ –º–µ—Ç—Ä–æ,4111,4111,-800,-800,980,0,0,1867814,False,KB82-TP7P-PXAC-1A95
-t_cXrimj2UR8q_xow,1728539006,–ö–∏—ó–≤ –¶–∏—Ñ—Ä–æ–≤–∏–π,7523,7523,-12250,-12250,980,0,0,1868614,False,2H3B-96H0-MTKM-PT01
1KpwPsZgfgi8_h_FagYgcQ,1728515852,Bolt,4121,7999,-4816,-4816,980,0,0,1880864,True
jkon3FuPwBjGbyFYSF9ZLjjpupo,1728515852,–°–∫–∞—Å—É–≤–∞–Ω–Ω—è. Bolt,4121,7999,8000,8000,980,0,0,1885680,False
Cs9y_VWKbAzQ2hMMiA,1728496675,Novapay,8999,8999,-8000,-8000,980,0,0,1877680,False,919K-5K1B-30H3-K1T6
aAL8SBiHlpkrO0yJow,1728490152,MauDau,5331,5411,-32400,-32400,980,0,243,1885680,False
hEwlQjHscEjSWfM-jg,1728487956,–ù–æ–≤–∞ –ø–æ—à—Ç–∞,7399,7399,-6300,-6300,980,0,0,1918080,False,E5AC-4957-1T2M-0AKT
cHZlmycQwSL-nePZsg,1728487816,Novapay,8999,8999,-6000,-6000,980,0,0,1924380,False,1BX1-CA21-C7KK-7XM4
HDDa0jCHcGGGfNe6PQ,1728486601,–°—ñ–ª—å–ø–æ,5411,5411,-70700,-70700,980,0,532,1930380,False,5CXE-1XPA-X86P-60PB
9EIj1CzcQYGaUCO4HQ,1728485524,–ü–µ—Ä–µ–∫–∞–∑ –Ω–∞ –∫–∞—Ä—Ç–∫—É,4829,4829,-700000,-700000,980,0,0,2001080,False
T6ilJ923TCk9TAaKYg,1728485459,Lesya,4829,4829,-100000,-100000,980,0,0,2701080,False,BH2M-129X-4A70-2P73
2JQiEcc5lhOAtiCYgg,1728478018,Best Way To Cup,5814,5814,-13500,-13500,980,0,0,2801080,False,28B9-HMK9-APX7-HB33
Sr9ud8FmNh-a5T8a-g,1728477900,Best Way To Cup,5814,5814,-27500,-27500,980,0,0,2814580,False,H2B1-HAK7-XBM7-M1KK
lz-j5xwXqfDUuW46oA,1728476795,–ú—ñ—Å—å–∫–∞ –∫–∞–≤'—è—Ä–Ω—è,5812,5812,-51000,-51000,980,0,0,2842080,False,09MC-79K6-6HTB-1K06
CC4K8u7dzp3Uw_5yqA,1728469600,414960****3309,4829,4829,-420000,-420000,980,0,0,2893080,False,5CHK-98TX-6A21-P0TK
-LA5lPq-KgvRMBfoNA,1728462588,–•–ª—ñ–±–Ω–∞ –ö–∞–≤–∞,5462,5462,-5200,-5200,980,0,52,3313080,False,K9X6-9151-A3CX-7HAC
LUU1eU-R-6-cLtdC-w,1728462563,–•–ª—ñ–±–Ω–∞ –ö–∞–≤–∞,5462,5462,-8290,-8290,980,0,82,3318280,False,BXK0-P3K9-3121-95TB
FRRYf2mwCPw3RlfdhQ,1728462436,–ó–æ–æ–º–∞–≥–∞–∑–∏–Ω,742,742,-13000,-13000,980,0,0,3326570,False,PT5X-PPX8-B2BP-BP00
icfMSSWug3f9ESUdMQ,1728461902,2bfit_fitness_club,7941,7941,-80000,-80000,980,0,0,3339570,False,9TCK-KHH5-KET2-62T9
pjHMQuiC_GJn6Wdt9A,1728415520,Steam,5816,5816,-3200,-3200,980,0,0,3419570,False,K8XM-C2ET-8X56-877C
Ai81G7pxEqEaS0gJew,1728414382,–ü–æ–ø–æ–≤–Ω–µ–Ω–Ω—è Vinyla.com,5735,5735,140000,140000,980,0,0,3422770,False
9P4-aV4ExhGHXUjrVg,1728413444,–ö–ò–á–í–ì–ê–ó,5812,5812,-73000,-73000,980,0,0,3282770,False,MMBX-T921-17HE-2BT0
p_C9nTKVXM9iJsdEQg,1728396437,Best Way To Cup,5814,5814,-33500,-33500,980,0,0,3355770,False,HPXM-570X-685H-3765
ag6JG8Gxu9mClVdysw,1728390243,Kavyarnya,5812,5812,-18900,-18900,980,0,0,3389270,False,X02K-KAMT-M707-3T54
jGyxvUrqOBJap1_3Aw,1728389316,Kavyarnya,5812,5812,-18000,-18000,980,0,0,3408170,False,HTTE-T758-B5A6-8733
4v-yEz1PBKxL3sAXlA,1728375489,Novus,5411,5411,-7499,-7499,980,0,74,3426170,False,026H-1PT4-CH62-7EM3
pi7dZQUJ7eOijuZaTQ,1728374337,–§–ö –ï–í–û,5399,5399,-645200,-645200,980,0,6452,3433669,False,T1T0-KT5T-48PX-71B0
Dht4zMJb5yN3mAsw7A,1728372117,–ú—ñ—Å—å–∫–µ –∫–∞—Ñ–µ –•–∞—Ä–º—Å,5812,5812,-26200,-26200,980,0,0,4078869,False,63X4-KT93-HA22-4047
Nduj6LnWXBVfGP-r3w,1728369934,–ö–∞—Å–∞ –£–Ωi–≤–µ—Ä—Å–∞–ª –ë–∞–Ω–∫—É,6010,6010,-2000000,-2000000,980,0,0,4105069,False,T71M-KK20-PPE0-AB8K
03GcyPqtltvpt1mPEQ,1728369273,Bolt,4121,7999,-8000,-8000,980,0,0,6105069,False
z_iPKJcq5rvkSmC6zw,1728365127,KAFE TITKA KLARA,5814,5814,-10400,-10400,980,0,0,6113069,False,B37X-5PTH-AT32-MMAT
aval_OTsOYHMRk2wYiQo2Q,1728344211,Bolt,4121,7999,-5951,-5951,980,0,0,6123469,True
FBWAKOrB7Dhs_YgEoq6pYA2aYnE,1728344211,–°–∫–∞—Å—É–≤–∞–Ω–Ω—è. Bolt,4121,7999,8000,8000,980,0,0,6129420,False
q_TSo9-B8yeN4ntktw,1728335516,2085,5921,5921,-47500,-47500,980,0,475,6121420,False,16K5-597H-H16K-5M34
nUR8b1r16GLBExpSNQ,1728320075,Novapay,8999,8999,-100,-100,980,0,0,6168920,False,EB0B-K2P3-5AHB-XH6E
AxTbFm-pSA2s0B7yxw,1728315387,KitayskiPelmeni,5812,5812,-152160,-152160,980,0,0,6169020,False,0189-XK3P-K8C3-KPAK
8rNC5C_GEBJTHXJDiQ,1728315369,KitayskiPelmeni,5812,5812,-19000,-19000,980,0,0,6321180,False,0H94-362X-5M78-K0CH
QpatKw6zUJs2eZUaGg,1728311498,–ö–∏—ó–≤ –¶–∏—Ñ—Ä–æ–≤–∏–π,7523,7523,-21000,-21000,980,0,0,6340180,False,HT84-E6XC-489A-X8B6
O7qLk899xPsAC12tIw,1728310294,Vinyla,5733,5733,-189000,-189000,980,0,0,6361180,False,6EPP-3CT9-KK70-HPHX
yzM4DRYo-uNAmi9WuA,1728309419,–ü–æ–ø–æ–≤–Ω–µ–Ω–Ω—è ¬´–ù–∞ —Ç–∫–∞–Ω–∏–Ω—É –¥–ª—è —Å—ñ—Ç–æ–∫¬ª,4829,4829,-50000,-50000,980,0,0,6550180,False,PM01-68M5-9PBE-B29M
6L-6RQWru2WPYfvXtQ,1728298729,–ü–æ–ø–æ–≤–Ω–µ–Ω–Ω—è ¬´–ù–∞ –±—Ä–æ–Ω—é & Starlink¬ª,4829,4829,-50000,-50000,980,0,0,6600180,False,9C47-HT14-8P6K-1APP
LzKIHiDBcIrrZpd0uA,1728298527,–ü–æ–ø–æ–≤–Ω–µ–Ω–Ω—è ¬´puppy¬ª,4829,4829,-50000,-50000,980,0,0,6650180,False,BT19-3TAA-MM2K-5MMK
TYwh2DFqJRWdxXX6kw,1728298363,Lesya,4829,4829,-600000,-600000,980,0,0,6700180,False,XM7B-1C13-B5EH-7HA7
DiE0XBmSHxgOje03zA,1728297284,–íi–¥: –ü–†–ò–•–û–î–¨–ö–û –ï.–í. –§–û–ü,"–î–ª—è –ø–æ–ø–æ–≤–Ω–µ–Ω–Ω—è –∫–∞—Ä—Ç–∫–∏ 5375414101190360, –ü—Ä–∏—Ö–æ–¥—å–∫–æ –ï—Ä–Ω–µ—Å—Ç –íi–∫—Ç–æ—Ä–æ–≤–∏—á, 3487403339",4829,4829,4200000,4200000,980,0,0,7300180,False
cU17V_1XeBAydN4aGQ,1728294254,WFP.GROCERY1,5499,5499,-191630,-191630,980,0,1916,3100180,False,4K0X-6A4C-AP4T-P28H
4KFlloIk6b_cNkHVfQ,1728293029,E-ZOO,5995,5995,-31400,-31400,980,0,0,3291810,False,P73E-B5MK-83M8-17HP
_g-Iz2V5hY5ApZR3eg,1728289686,–ù–æ–≤–∞ –ø–æ—à—Ç–∞,7399,7399,-6700,-6700,980,0,0,3323210,False,PB0T-X1M6-KHT4-2EC4
hy6C1m30I7-AXyf0DQ,1728288688,2bfit_fitness_club,7941,7941,-80000,-80000,980,0,0,3329910,False,00AM-7B6C-9TC3-XKB6
JKUE1Uh4Ec15SbOMfw,1728288618,KHLIBNA KAVA,5462,5462,-2700,-2700,980,0,27,3409910,False,1MC9-96K6-3969-KT3A
eXe0k_eVD-ZAn3yExQ,1728284333,2bfit_fitness_club,7941,7941,-139900,-139900,980,0,0,3412610,False,A2XK-M8AB-17B6-7K2M
-AGYiiowT6TIIQofBA,1728280749,ONE SPACE TAX*APGP,9311,9311,-58058,-58058,980,0,0,3552510,False,M1KP-4T60-54MP-3H1K
WnCG1cOzx0cImHxHCw,1728228172,–ü–æ–ø–æ–≤–Ω–µ–Ω–Ω—è ¬´–ù–∞ —à–∏–Ω–∏ –¥–ª—è –ø—Ä–∞–ª—å–Ω–æ—ó¬ª,4829,4829,-100000,-100000,980,0,0,3610568,False,7671-K48M-7EA7-T0MX
CqyAUfqzFkYiRU_TFw,1728227167,Ponchyk Boy | –û–ª–µ—Å—è –ì–æ–Ω—á–∞—Ä–∞,5812,5812,-33600,-33600,980,0,0,3710568,False,B1K7-612H-9M31-82B5
jxIZQ2rQmRSA09Wk-Q,1728224415,Bolt,4121,7999,-8000,-8000,980,0,0,3744168,False
TBws0rAU6EF-Q8FuPw,1728214906,LIQPAY*Poster QR,5812,5812,-45800,-45800,980,0,0,3752168,False,8E0C-H4AC-8K9A-T42E
2kCJ4UfILZ3JNW5AAg,1728214064,Food Spot,5812,5812,-62200,-62200,980,0,0,3797968,False,1PM8-B353-84K2-M7CM
g7xiKfr3VNgp7E8Ssw,1728203648,Best Way To Cup,5814,5814,-8000,-8000,980,0,0,3860168,False,7BB5-23KB-9MB8-6HCB
bamRuCvvSWv3_wFgCA,1728203106,–ù–æ–≤–∞ –ø–æ—à—Ç–∞,7399,7399,-100,-100,980,0,0,3868168,False,124P-XTBA-70T1-K0EH
aB3CiKqgCn4ve8ZEEA,1728197004,REMI,5812,5812,-96000,-96000,980,0,0,3868268,False,654B-4H4E-E4TX-217E
QWgEFzPraWnl3fY2Kk-vdg,1728171842,Bolt,4121,4121,-13800,-13800,980,0,0,3964268,True
Y4UYoQAI0vfpIKLzADQwE0X5MQc,1728171842,–°–∫–∞—Å—É–≤–∞–Ω–Ω—è. Bolt,4121,4121,12800,12800,980,0,0,3978068,False
NIcYExP3GRS-qmvy2w,1728155775,20/2,5812,5812,-116000,-116000,980,0,0,3965268,False,XAH1-KTMM-C2K1-9E3H
YEle9kBM9kVPuWR21g,1728145171,LIQPAY*Pethouse,5995,5995,-199200,-199200,980,0,0,4081268,False,T1XB-3A21-0529-XPTB
MsXoJWo2PtSdsNtfRA,1728141102,–§–ö –ï–í–û,5399,5399,-71800,-71800,980,0,718,4280468,False,CK4H-2H5K-94KC-PP32
DV7x02JNG4dsIFSYpA,1728138521,Novapay,8999,8999,-8000,-8000,980,0,0,4352268,False,84EB-5E82-BT7K-A34M
z7iO-xSfbTJdUznsHA,1728123165,–û–ª–µ–∫—Å–∞–Ω–¥—Ä –ö.,4829,4829,-87000,-87000,980,0,0,4360268,False,06XM-84PT-073C-774T
OFRFQ5JGe4r8NQgfPg,1728120826,–ê–ø—Ç–µ–∫–∞ –î–æ–±—Ä–æ–≥–æ –î–Ω—è,5912,5912,-7800,-7800,980,0,0,4447268,False,TK8E-7426-82TH-CMH1
r9keRBbAVcorfgZMOA,1728119272,Coffeelatmykilskoslobi,5814,5814,-18500,-18500,980,0,0,4455068,False,9E51-51AC-XTMB-2HCT
AyDaNoere7_mCEE7rA,1728117515,WFP.CHARITY,8398,8398,-50000,-50000,980,0,0,4473568,False,K078-544X-M7A0-XT9E
dazVlUkSs3WwSkLw9g,1728109484,Best Way To Cup,5814,5814,-16000,-16000,980,0,0,4523568,False,9T6P-T7XX-0PKH-9K5C
Pusz-z7YZ-3H3NDUDg,1728072791,Zoocomplex,5995,5995,-13800,-13800,980,0,0,4539568,False,K5PX-1H24-8CKM-25HE
uRJJDAFMfZFGSv6Wjw,1728064524,PieddePoule,7230,7230,-120000,-120000,980,0,0,4553368,False,XEK5-K9KP-EK24-1571
u2kLPJQ5ZKyWTql_4A,1728056070,–°—ñ–ª—å–ø–æ,5411,5411,-91100,-91100,980,0,911,4673368,False,TAH5-5P73-P5P2-ME17
2LyUz8b6EIZ9VOmdtw,1728055116,Ukrkhalial,5499,5499,-43744,-43744,980,0,437,4764468,False,B3M0-6AMP-86XP-PK35
1_PXJsWvVbTqVwCB5g,1728047732,magazin Biotus,5499,5499,-129800,-129800,980,0,1298,4808212,False,XTBB-TEKB-03HE-H095
O2P3Y7SJalaoNH8x6w,1728045737,Best Way To Cup,5814,5814,-18500,-18500,980,0,0,4938012,False,TB00-65B0-3243-0P58
HU9rU5VVqMnXZQhTZA,1728044579,Bolt,4121,4121,-12800,-12800,980,0,0,4956512,False
GQFLZe0TjKf9TTC3eg,1728040570,Bolt,4121,4121,-13300,-13300,980,0,0,4969312,False,40TT-T0BP-X9K8-8P14
2nLzftlIA7cwvLwQVw,1728038534,–ü–æ–ø–æ–≤–Ω–µ–Ω–Ω—è ¬´puppy¬ª,4829,4829,-100100,-100100,980,0,0,4982612,False,X13K-E5XX-PBA1-33K8
uOlc74cGFVt_1Xw7HQ,1728037224,–íi–¥: –ü–†–ò–•–û–î–¨–ö–û –ï.–í. –§–û–ü,"–î–ª—è –ø–æ–ø–æ–≤–Ω–µ–Ω–Ω—è –∫–∞—Ä—Ç–∫–∏ 5375414101190360, –ü—Ä–∏—Ö–æ–¥—å–∫–æ –ï—Ä–Ω–µ—Å—Ç –íi–∫—Ç–æ—Ä–æ–≤–∏—á, 3487403339",4829,4829,4300000,4300000,980,0,0,5082712,False
1lrW2iQ9ukXmzIhHLA,1728032483,FOP Shevchenko,5499,5499,-12000,-12000,980,0,90,782712,False,XM73-KAT8-T2C5-9M4K
6tqSp1K_jBFMfWFUvA,1728029433,KHLIBNA KAVA,5462,5462,-2500,-2500,980,0,18,794712,False,0592-A295-77AC-T53X
h_KY90V_VG3Udo2hvA,1727984749,Steam,5816,5816,-5300,-5300,980,0,0,797212,False,86H2-5P9B-HEMH-8A2C
btQ5_0_5vRWupdu-vQ,1727972362,–°—ñ–ª—å–ø–æ,5411,5411,-43700,-43700,980,0,327,802512,False,9CMC-EPM9-7TBK-KHPP
oMZyd7s8ZrHh_QUCwg,1727966312,STYLUS,5722,5722,-560500,-560500,980,0,0,846212,False,10MK-95C5-9E43-X555
d7K7y0-8IrBmq4rsLg,1727957345,–ö–æ–ª–æ,5411,5499,-2950,-2950,980,0,22,1406712,False,8H12-9ET0-6P28-PEM0
s5FOZpz11-YeknY0lA,1727945598,Best Way To Cup,5814,5814,-31000,-31000,980,0,0,1409662,False,0C9B-X803-424K-0C9P
Q-y36YmDBdovHCrMVA,1727945149,Novus,5411,5411,-29198,-29198,980,0,218,1440662,False,5X4A-8627-56MP-A8HX
ljOT9ws1a4Fn7VVxuQ,1727944151,KHLIBNA KAVA,5462,5462,-2500,-2500,980,0,18,1469860,False,K3C4-5K9P-34BB-ATA0
hWwEKJxmhhdiRPqtxQ,1727898639,Vinyla.com,5735,5735,-140000,-140000,980,0,0,1472360,False,CEM8-AEPX-CX56-XK14
HojfKHu0kq3UEgjqMQ,1727889090,–°—ñ–ª—å–ø–æ,5411,5411,-33162,-33162,980,0,248,1612360,False,0X58-P3BA-50AC-875K
-Xv2qIgm4qcwrMm6RA,1727881317,–ö–æ–ª–æ,5411,5499,-2950,-2950,980,0,22,1645522,False,A7K0-M4TC-96AP-K76C
Zw4M-bxkZwBLtm6gXw,1727879637,5045Kavjarnja,5814,5814,-11500,-11500,980,0,0,1648472,False,68MA-8P4K-H30T-0MKC
4doxYb6ilJoRZIND2w,1727871906,LIQPAY*FOP Koval O.Yu.,8299,8299,-47500,-47500,980,0,0,1659972,False,86HH-867B-BE71-K65T
ejWdh0uHHVVFmidAkg,1727871887,LIQPAY*FOP Koval O.Yu.,8299,8299,-47500,-47500,980,0,0,1707472,False,276T-K580-0B98-9PK1
2i-8Sl2Jj573WrcPAw,1727851096,UNIVERSUM CLINIC,8099,8099,-89000,-89000,980,0,0,1754972,False,79ET-516X-841P-HC7K
cLsfi6mzm2tqEE3aAA,1727851072,UNIVERSUM CLINIC,8099,8099,-89000,-89000,980,0,0,1843972,False,XP8X-045H-0E19-MC27
_8EsMLS0KJQc-uTBSQ,1727851032,UNIVERSUM CLINIC,8099,8099,-105000,-105000,980,0,0,1932972,False,TMBM-A1EP-67P1-M65X
uwfGEzbxobmgHJVRzA,1727851010,UNIVERSUM CLINIC,8099,8099,-105000,-105000,980,0,0,2037972,False,B7CH-A5K0-E94A-EA0H
hqfFYdZ1xz8uBmO9wQ,1727801948,–ü–µ—Ä–µ–∫–∞–∑ –Ω–∞ –∫–∞—Ä—Ç–∫—É,4829,4829,-800000,-800000,980,0,0,2142972,False
KbSSfDHx6FGDi6bXoA,1727801898,–î–æ—Å—Ç—Ä–æ–∫–æ–≤–µ –ø–æ–≥–∞—à–µ–Ω–Ω—è svit-matrasiv.com.ua,4829,4829,-335700,-335700,980,0,0,2942972,False
2ztBpPVgfRjs9QwBXw,1727788117,Novus,5411,5411,-18497,-18497,980,0,184,3278672,False,96XM-0704-140K-M5B9
hj24W7iEAoc6pDSAHw,1727787870,magazin Biotus,5499,5499,-50400,-50400,980,0,504,3297169,False,1X1P-C6H3-1MB0-8MK9
lutZOri3MfgRzqwM7Q,1727787373,20/2,5812,5812,-26000,-26000,980,0,0,3347569,False,4AK7-72H1-XX7H-MK64
NAX5d9vuwfEH5XWh5Q,1727783044,TSUM,7523,7523,-10000,-10000,980,0,0,3373569,False,42XP-HB7E-EX6A-94X6
dTRz4TdQLwbzkiSUlQ,1727782324,Milk Bar | –¶–£–ú,5812,5812,-157800,-157800,980,0,0,3383569,False,PEX0-3H1B-BMPB-K15M
ENeEtWJpF7NbTMrnUw,1727780569,–íi–¥: –ü–†–ò–•–û–î–¨–ö–û –ï.–í. –§–û–ü,"–î–ª—è –ø–æ–ø–æ–≤–Ω–µ–Ω–Ω—è –∫–∞—Ä—Ç–∫–∏ 5375414101190360, –ü—Ä–∏—Ö–æ–¥—å–∫–æ –ï—Ä–Ω–µ—Å—Ç –íi–∫—Ç–æ—Ä–æ–≤–∏—á, 3487403339",4829,4829,3500000,3500000,980,0,0,3541369,False
XVJw7QHkqbMBVa0lLw,1727771135,–ö–£–ó–Ø,4900,4900,-35000,-35000,980,0,0,41369,False,A1HB-X35M-BX94-2X53
aC6TtWruQ75zJ3WXMQ,1727762768,FLAVORKAVA,5812,5812,-6200,-6200,980,0,0,76369,False,1M6M-8X9P-9X04-94P6
iKpqnHgqBvHccNTYoQ,1730212399,Bolt,4121,7999,-8000,-8000,980,0,0,139042,False
iWTTEs_4CTcBiv_Vxg,1730134758,–í—ñ–¥: –û–ª–µ—Å—è –°–∞—á–µ–Ω–∫–æ,4829,4829,95000,95000,980,0,0,147042,False
sVPueTjI-bs5OzKrQg,1730134757,–ü–µ—Ä–µ–∫–∞–∑ –Ω–∞ –∫–∞—Ä—Ç–∫—É,4829,4829,-50000,-50000,980,0,0,52042,False
8XgmviMR1mbtYmiKGA,1730101097,–ü–µ—Ä–µ–∫–∞–∑ –Ω–∞ –∫–∞—Ä—Ç–∫—É,4829,4829,-300000,-300000,980,0,0,102042,False
P6jfr5R01wp1VDy9rw,1730101084,Lesya,4829,4829,-60000,-60000,980,0,0,402042,False,BH92-50H4-1PE5-4K83
KeILmwf1MbVszTmSrw,1730014919,–ö–∞—Ñ–µ –ú–∞—Ä—ñ—è,5812,5812,-86300,-86300,980,0,0,462042,False,CPC3-0876-8BK9-P0AH
HNY_ZrVRRZIwAeQjdA,1729999789,–†–µ–≥—É–ª—è—Ä–Ω–µ –ø–æ–ø–æ–≤–Ω–µ–Ω–Ω—è ¬´–§–æ–Ω–¥ –ü–æ–≤–µ—Ä–Ω–∏—Å—å –∂–∏–≤–∏–º¬ª,4829,4829,-25000,-25000,980,0,0,548342,False,7T58-8CT8-5AKX-16H0
DYEwWbWhHkuWSTKW6g,1729869284,516780****8286,4829,4829,-25000,-25000,980,0,0,573342,False,A8C4-TP86-4TXK-0MCK
UheXEglxWniNPiuP1Q,1729849636,–í–∞–ª–µ–Ω—Ç–∏–Ω–∞ –ö.,–û–ª–µ—Å—è,4829,4829,-130000,-130000,980,0,0,598342,False,PXP0-B866-5KTA-65AH
7S1bCfaYch7vZ_f6-g,1729849582,–¢–µ—Ç—è–Ω–∞ –ü.,2 —Ç—Ä–µ–Ω—É–≤–∞–Ω–Ω—è,4829,4829,-80000,-80000,980,0,0,728342,False,8T68-TX03-X573-T550
C18P0iJCCgNHt6WXQw,1729581906,–¢–µ—Ç—è–Ω–∞ –ü.,2 —Ç—Ä–µ–Ω—É–≤–∞–Ω–Ω—è,4829,4829,-80000,-80000,980,0,0,808342,False,X7B3-6MEA-45HH-TA78
vC3hIZ_7maTspac2WQ,1729391537,–†–µ–≥—É–ª—è—Ä–Ω–µ –ø–æ–ø–æ–≤–Ω–µ–Ω–Ω—è ¬´–§–æ–Ω–¥ –ü–æ–≤–µ—Ä–Ω–∏—Å—å –∂–∏–≤–∏–º¬ª,4829,4829,-25000,-25000,980,0,0,888342,False,PH34-8HM2-P522-B814
vw46z9fmAGevk445Pg,1729333958,414949****2985,4829,4829,-10050,-10050,980,0,0,913342,False,HMT8-953K-BEKT-9KM7
D3Lrl_HqSissEpJ9Og,1728897942,–ü–æ–ø–æ–≤–Ω–µ–Ω–Ω—è ¬´–ù–∞ –≥–µ–Ω–µ—Ä–∞—Ç–æ—Ä¬ª,4829,4829,-75000,-75000,980,0,0,923392,False,2C58-6110-2MB6-PE4K
67KalnuEVnV9pWCUeQ,1728786638,–†–µ–≥—É–ª—è—Ä–Ω–µ –ø–æ–ø–æ–≤–Ω–µ–Ω–Ω—è ¬´–§–æ–Ω–¥ –ü–æ–≤–µ—Ä–Ω–∏—Å—å –∂–∏–≤–∏–º¬ª,4829,4829,-25000,-25000,980,0,0,998392,False,8HH7-94H2-AP39-E35K
Am1JTA0xV4nbwBEiCA,1728745409,–ü–µ—Ä–µ–∫–∞–∑ –Ω–∞ –∫–∞—Ä—Ç–∫—É,4829,4829,-200000,-200000,980,0,0,1023392,False
ahjVSvftSvRdmRgWdA,1728658227,–ñ–∞–Ω–Ω–∞ –ñ.,4829,4829,-250000,-250000,980,0,0,1223392,False,P835-61P9-1CEK-1453
2swFbZ1PP4jV01DYVA,1728630662,516780****2561,4829,4829,-50000,-50000,980,0,0,1473392,False,BTA2-K6AK-8BB7-82AK
ozo_pLFl1TaeNupZjA,1728630308,414949****2985,4829,4829,-10000,-10000,980,0,0,1523392,False,E59E-6TM1-09ME-X6B1
2fy69MJoHMG5yAzUvA,1728626478,–ü–æ–ø–æ–≤–Ω–µ–Ω–Ω—è ¬´20 FPV –¥–ª—è –ê—Ö—ñ–ª–ª–µ—Å¬ª,4829,4829,-50000,-50000,980,0,0,1533392,False,5B66-1C5X-8MP5-EH03
Sx3RmNwxitoj0Z7cOQ,1728576660,"""–ì—ñ–ª—å–¥–∞"" –≤–µ—Ä–º—É—Ç–µ—Ä—ñ—è –Ω–∞ –ó–æ–ª–æ—Ç–∏—Ö",5812,5812,-46200,-46200,980,0,0,1583392,False,XXTM-E930-8HP5-07BK
x_A5ubimESkxrqOY3A,1728575659,–¢–µ—Ç—è–Ω–∞ –°.,4829,4829,-400000,-400000,980,0,0,1629592,False,P103-9HKP-210H-XMB1
5m8yNSU-pKKMku5Qow,1728574509,–¢–µ—Ä–º—ñ–Ω–∞–ª City24,4829,4829,400000,400000,980,0,0,2029592,False
TBYji3tFYz1YSAViyw,1728485546,–ü–æ–ø–æ–≤–Ω–µ–Ω–Ω—è ¬´puppy¬ª,4829,4829,-50000,-50000,980,0,0,1629592,False,CH34-3003-0T92-TP9P
9xKYOKflHQPXwGmIig,1728485524,–ó —á–æ—Ä–Ω–æ—ó –∫–∞—Ä—Ç–∫–∏,4829,4829,700000,700000,980,0,0,1679592,False
RVNjeQ9Z4SEJRl3Keg,1728181796,–†–µ–≥—É–ª—è—Ä–Ω–µ –ø–æ–ø–æ–≤–Ω–µ–Ω–Ω—è ¬´–§–æ–Ω–¥ –ü–æ–≤–µ—Ä–Ω–∏—Å—å –∂–∏–≤–∏–º¬ª,4829,4829,-25000,-25000,980,0,0,979592,False,X585-95CA-BX3T-EBAM
fyToFG_c0Nk9DmLU5w,1727864402,–ü–æ–ø–æ–≤–Ω–µ–Ω–Ω—è ¬´puppy¬ª,4829,4829,-45000,-45000,980,0,0,1004592,False,AMM2-9XM2-C938-KAM1
DVjgBj9aAuy2VQbHFA,1727857778,KvitkarnyaYu,5992,5992,-136700,-136700,980,0,1025,1049592,False,T45M-XPK0-412T-0HC0
tNWUjgO24pL2AHGTkQ,1727801948,–ó —á–æ—Ä–Ω–æ—ó –∫–∞—Ä—Ç–∫–∏,4829,4829,800000,800000,980,0,0,1186292,False
AA7jmIxD_sW-Lq1Dnw,1732908631,Food Spot,5812,5812,-9300,-9300,980,0,69,1029281,False,CM40-H66T-E0P5-51T0
_UC9x3PzXgyaCwe_Mg,1732904446,LIQPAY*Food Spot Corp.,5812,5812,-87890,-87890,980,0,659,1038581,False,EX02-TAKA-P923-MMB8
wXhvZ0Yaj5kXks_oTQ,1732892607,–°—ñ–ª—å–ø–æ,5411,5411,-113643,-113643,980,0,852,1126471,False,KKX5-8379-1AX5-44E1
ME02jq5_0zgTEuO2gQ,1732890960,Novapay,8999,8999,-29550,-29550,980,0,0,1240114,False,6PTM-9H98-ME05-2X31
6tqSp1q4jRpHeGRRvg,1732890934,Novapay,8999,8999,-29250,-29250,980,0,0,1269664,False,XTX7-B16A-8BP7-HB9X
9NRIQ2-nRcZsG5LeTQ,1732885301,SP TAYLOR SWIFT,5733,5733,-314967,-7094,978,0,0,1298914,False,BK73-M3KB-1BMH-026X
f9_EJs_lr7aVBcg-CQ,1732875295,Fitnes klub 2BFIT,7941,7941,-100000,-100000,980,0,0,1613881,False,348H-ECH6-T7CH-P3CC
tUh4Nwhq0ALuHfZpOw,1732872382,Novapay,8999,8999,-100,-100,980,0,0,1713881,False,K6P3-KE73-B18E-C131
HRJty9U_HE_qYRRuSA,1732813160,Novapay,8999,8999,-28150,-28150,980,0,0,1713981,False,BTH2-CT57-9840-EAT3
pfWNr5j5YXJKWsZ8FA,1732800973,Steam,5816,5816,-86882,-86200,980,0,0,1742131,False,9TA5-B6P7-8C80-BBE2
ri6MN-jb82egY7nrJg,1732800524,Best Way To Cup,5814,5814,-17000,-17000,980,0,127,1829013,False,HM36-656M-E552-55K4
1v8Le5mb6tQPxoDysw,1732786935,–ö–£–ó–Ø,4900,4900,-45000,-45000,980,0,0,1846013,False,6A1B-CM27-6BM4-6CA2
iPNU1o2Lb26w2sfWTw,1732732855,–°—ñ–ª—å–ø–æ,5411,5411,-159300,-159300,980,0,1320,1891013,False,7M2C-9APA-H905-BBT0
T7oHnsmsFlqthUePWw,1732730503,Mates,5812,5812,-139700,-139700,980,0,2794,2050313,False,K8X3-7EB3-96P3-XE7B
qk6WmhbEFzHPLw0JVg,1732717094,Best Way To Cup,5814,5814,-11000,-11000,980,0,220,2190013,False,X3M7-K15C-9008-9PA7
Y3vdBQ0tgtyhEM-YRw,1732715904,readellion,5942,5942,-70000,-70000,980,0,0,2201013,False,TA4B-AMA0-C526-P9K5
OM053gYBfyKHVMa3Lg,1732704386,–ü–µ—Ä–µ–∫–∞–∑ –Ω–∞ –∫–∞—Ä—Ç–∫—É,4829,4829,-1000000,-1000000,980,0,0,2271013,False
ZcdeuSqiOEs_EweRaQ,1732704329,–ü–æ–ø–æ–≤–Ω–µ–Ω–Ω—è ¬´puppy¬ª,4829,4829,-100000,-100000,980,0,0,3271013,False,XTPP-E5TP-75ET-8KA1
mLUxYEDjz_53SRcnVA,1732704313,–¢–µ—Ç—è–Ω–∞ –°.,4829,4829,-500000,-500000,980,0,0,3371013,False,TE5A-454A-K5TA-2CB5
pziuUZzsojNC1QllEw,1732703857,–íi–¥: –ü–†–ò–•–û–î–¨–ö–û –ï.–í. –§–û–ü,"–î–ª—è –ø–æ–ø–æ–≤–Ω–µ–Ω–Ω—è –∫–∞—Ä—Ç–∫–∏ 5375414101190360, –ü—Ä–∏—Ö–æ–¥—å–∫–æ –ï—Ä–Ω–µ—Å—Ç –íi–∫—Ç–æ—Ä–æ–≤–∏—á, 3487403339",4829,4829,2400000,2400000,980,0,0,3871013,False
nLlA9ZCSUswlqUbjDw,1732700661,Promn,5651,5651,-102000,-102000,980,0,0,1471013,False,83C6-TEBC-CCPE-5CA9
Uetc3kC07K3qviW61g,1732699747,Mates,5812,5812,-9000,-9000,980,0,67,1573013,False,AA7M-59B6-93XC-6018
rI1hcrFWEIKCnlwZKg,1732699386,Fitnes klub 2BFIT,7941,7941,-100000,-100000,980,0,0,1582013,False,34PT-PM84-6HA9-55E0
c1GpDn40C-eE3krAPw,1732643750,Epic Games,5816,5816,-7990,-7990,980,0,0,1682013,False,X06H-4ACK-9677-B8AA
19Vuz0Sfd0aKGdYoOQ,1732638720,magazin 762597,5912,5912,-10940,-10940,980,0,0,1690003,False,6CM1-04HM-5973-3E73
ucj3GneRhWcVpSsOuw,1732638034,TUTMARKET,5499,5499,-5300,-5300,980,0,39,1700943,False,8B1C-B193-09KB-7C65
0v_z295KVEUodJnK-Q,1732637846,PonchykBoy Honcha,5814,5814,-32800,-32800,980,0,246,1706243,False,422H-A6K0-40K1-P5BM
rVtxlY2rzFI7ssPNGA,1732630371,Steam,5816,5816,-60392,-59900,980,0,0,1739043,False,HPXP-K191-CXMM-P5B7
7d0nbcvu4GsVURvPtQ,1732617280,–°—ñ–ª—å–ø–æ,5411,5411,-63054,-63054,980,0,472,1799435,False,7H6E-BP69-B83E-00P6
aJy4IYmBqqCKu1k2AQ,1732611922,LIQPAY*FOP Derevyanko,5949,5949,-890,-890,980,0,0,1862489,False,TPPE-7P1K-9C9M-E1X6
Pl_aa4HMsNU4qtSNdw,1732607456,Uklon,4121,4121,-14900,-14900,980,0,0,1863379,False,T9PB-B33E-BB42-0624
YiBGDmA9BFfOaniWMg,1732604490,Uklon,4121,4121,-100,-100,980,0,0,1878279,False,PX94-593M-P627-E077
bDDw-3tEqbaO7k1hNw,1732602943,Uklon,4121,4121,-17600,-17600,980,0,0,1878379,False,54MP-CME7-2H9M-9545
kEVmAjPP6cTlIKfnWA,1732573168,LIQPAY*FOP Derevyanko,5949,5949,-104610,-104610,980,0,0,1895979,False,416M-0949-APXH-372E
jA5VZTswUWgiak_C9g,1732546975,–ü–æ–ø–æ–≤–Ω–µ–Ω–Ω—è ¬´puppy¬ª,4829,4829,-70000,-70000,980,0,0,2000589,False,XB95-P96X-48KK-P878
rF2RYyDlhrF9iBvlHQ,1732546963,–ü–µ—Ä–µ–∫–∞–∑ –Ω–∞ –∫–∞—Ä—Ç–∫—É,4829,4829,-400000,-400000,980,0,0,2070589,False
FeoNBKAzMNlRj90UtA,1732546954,–ü–µ—Ä–µ–∫–∞–∑ –Ω–∞ –∫–∞—Ä—Ç–∫—É,4829,4829,-45000,-45000,980,0,0,2470589,False
8Aw1SQ-drZdfQCCJ6w,1732546943,–ü–æ–ø–æ–≤–Ω–µ–Ω–Ω—è ¬´–ê–≤—Ç–æ –¥–ª—è 77 –±—Ä–∏–≥–∞–¥–∏¬ª,4829,4829,-50000,-50000,980,0,0,2515589,False,EE0C-ET0K-ACP3-C153
_2-UiJ9alS9iDlwcog,1732533442,–íi–¥: –ü–†–ò–•–û–î–¨–ö–û –ï.–í. –§–û–ü,"–î–ª—è –ø–æ–ø–æ–≤–Ω–µ–Ω–Ω—è –∫–∞—Ä—Ç–∫–∏ 5375414101190360, –ü—Ä–∏—Ö–æ–¥—å–∫–æ –ï—Ä–Ω–µ—Å—Ç –íi–∫—Ç–æ—Ä–æ–≤–∏—á, 3487403339",4829,4829,2500000,2500000,980,0,0,2565589,False
QJ3HwDeWoaQuwwE7Zw,1732527294,*=34044,5912,5912,-10940,-10940,980,0,0,65589,False,8H45-8H11-MM43-0382
akrFKy3x4PTNlSx7Gg,1732474791,LIQPAY*Pethouse,5995,5995,-171700,-171700,980,0,0,76529,False,76H5-XBA9-X21T-TKH0
lvGh_GieV11Tad1pGA,1732469011,KatArtSys,8999,8999,-100000,-100000,980,0,0,248229,False,1T8X-BEM8-8AE1-2MKE
Bc1Trdh26SGTn8mLLw,1732459013,P24 *Prykhodko Ernest,6012,6012,300000,300000,980,0,0,348229,False
LYRjDb1hqcuPnIBomg,1732458544,chizkeikfemel,5814,5814,-13500,-13500,980,0,101,48229,False,B294-KX90-TPT6-85M5
rr0YYouFqT03FqYWgg,1732456316,–í–µ—Ç–µ—Ä–∏–Ω–∞—Ä–Ω–∞ –∞–ø—Ç–µ–∫–∞,742,742,-191200,-191200,980,0,0,61729,False,12K0-XKK7-EPK0-TH9C
cSEMwtKJoXVyXfAXgg,1732451073,Epic Games,5816,5816,-121283,-120205,980,0,0,252929,False,B2T1-TB67-1C09-25MP
sijAPoc3o6wiLwW4xg,1732450376,Wfp.aquamarket,5499,5499,-137600,-137600,980,0,1032,374212,False,02K8-241H-E7T0-6X0K
iGsfc8igHzQUDEgStg,1732442254,5045Kavjarnja,5814,5814,-6000,-6000,980,0,45,511812,False,T1B0-X5K3-HK5K-X7K6
LLRPKNZ7hgmzDJDYZw,1732441889,–°—ñ–ª—å–ø–æ,5411,5411,-16075,-16075,980,0,120,517812,False,MC35-5507-P046-0E39
VhSoJyC7QJv0uhS4FQ,1732441099,Fitnes klub 2BFIT,7941,7941,-70000,-70000,980,0,0,533887,False,HB1M-HK82-02C3-T8C5
YuGoAbWsVJe02Z5-Jw,1732367817,Zhilyova.ua,5621,5621,-93000,-93000,980,0,0,603887,False,10P5-K11X-41MM-MCEH
x2o9AACl_Unga04YrQ,1732360500,KAVA NA DVOKH,5814,5814,-27000,-27000,980,0,202,696887,False,KKA0-6CTT-KC24-27KA
2swFbZtIOIfQ2VHeVg,1732351566,Ukrkhalial,5499,5499,-26550,-26550,980,0,199,723887,False,M31H-1P93-0C3H-P77P
X5jwdfaj8WnNvf5FJw,1732299860,Yaroslaviv Val 37-1,5921,5921,-5900,-5900,980,0,44,750437,False,0K29-4EXA-H1KC-B39M
fUiD4SGt_pdZ6hySVA,1732297817,NUNU | –Ø—Ä–æ—Å–ª–∞–≤—ñ–≤ –í–∞–ª,5812,5812,-65500,-65500,980,0,491,756337,False,EXA9-H62T-M9KX-6BM2
VSRAkambvZhUOWCmBQ,1732296596,PINA,5812,5812,-18000,-18000,980,0,135,821837,False,A56C-146C-7967-31M6
ng_N_jgFLHfMIlEwcA,1732279051,EasyPay,5411,5411,-287178,-287178,980,0,2153,839837,False,MA31-932C-PE2X-HXXK
1U-VEgZOG0EDijb1HA,1732271704,Ukrkhalial,5499,5499,-87133,-87133,980,0,653,1127015,False,KPC5-6HTC-K02X-57PE
fs33ianmcPVjoQXZ1w,1732271396,–°—ñ–ª—å–ø–æ,5411,5411,-7000,-7000,980,0,52,1214148,False,EE4A-9TCH-28T2-4HK9
ByLWF_mVkbr4HkO8WQ,1732271196,KHLIBNA KAVA,5462,5462,-5300,-5300,980,0,39,1221148,False,6XCC-8BMT-4EBH-ECTA
VDP47xEstzTMvBSFmg,1732205685,Novus,5411,5411,-23096,-23096,980,0,173,1226448,False,44XP-6T9P-70B3-089M
Irh6mxU192l-vbosDA,1732195898,WOG,5541,5541,-113981,-113981,980,0,0,1249544,False,H7A6-131T-PK8M-T7X3
Q8Z4NmfkgAQ3S659MA,1732189674,BHL BIUVET,8099,8099,-1600,-1600,980,0,0,1363525,False,6K95-EMAM-5H0A-C1HC
7ys3MONw3j2JEywO_A,1732187956,–ó–µ–Ω –ó–æ–Ω–∞ –ë–∞—Ä,5812,5812,-8800,-8800,980,0,66,1365125,False,E9PC-0656-P85E-3AHB
wyyQ1QRMfaQAugAaGw,1732187162,"Vodafone
+380978495150",4814,4814,-20200,-20200,980,0,0,1373925,False,6488-77KA-PT2H-20E4
CDwcWXOY-g9XUmJbjA,1732170243,KITCHEN,5812,5812,-38500,-38500,980,0,288,1394125,False,EEXC-BHA1-16HP-BB3C
n6aYFHmlBnW9kl4qLA,1732113803,KITCHEN,5812,5812,-83100,-83100,980,0,623,1432625,False,EACT-0P3C-60KC-8MH7
ngLCySZxVYTd4GlR-w,1732104734,Steam,5816,5816,-34300,-34300,980,0,0,1515725,False,1655-P26P-2B6E-ACE9
3mF_2_C2ENRTMknYQg,1732085084,KITCHEN,5812,5812,-38300,-38300,980,0,287,1550025,False,C34T-86A2-X446-PA66
vSKN1d8X3XRbcLpIrw,1732026065,KITCHEN,5812,5812,-68000,-68000,980,0,510,1588325,False,0ETT-3149-X49X-0C5A
9VzjBdUSeGOMxT3xwg,1732017428,Kurkuma,5921,5921,-7280,-7280,980,0,54,1656325,False,0662-E5AK-4PEK-2X6C
MeI8BKcyVMKVBJt7Zg,1732017170,WineTime,5921,5921,-116190,-116190,980,0,871,1663605,False,32C5-4EH3-11E1-ETC3
E-Q4DXujt89czLXFGg,1732014819,Kavun,5814,5814,-22000,-22000,980,0,165,1779795,False,AP37-21P6-23MH-5345
5AC0m2ZMVPQy0D243w,1732011699,Kafe Komora persha gal,5814,5814,-41000,-41000,980,0,307,1801795,False,4EP7-A65T-H3BH-79KP
O3HJKvQS_4_FNIFzQA,1732009255,Shell,5541,5541,-241960,-241960,980,0,0,1842795,False,EC41-233X-PEAP-7K0A
csvGsn3wvtTFic8f0w,1732001128,Shell,5541,5541,-17900,-17900,980,0,0,2084755,False,8842-0A1T-B66P-1XH3
i0GjuJqdT9ijle0h-g,1732001018,Shell,5541,5541,-144725,-144725,980,0,0,2102655,False,B6P3-4241-458K-8PH6
xK9PgGzwD2eHArf-lA,1731953064,Vodafone,4814,4814,-200,-200,980,0,0,2247380,False,5AEX-EA30-767B-TAKP
wK9mFaMPFFw_BaXVmw,1731924763,–ü–æ–ø–æ–≤–Ω–µ–Ω–Ω—è ¬´(–ù–ï)–û–°–û–ë–õ–ò–í–ò–ô –ó–ë–Ü–†¬ª,4829,4829,-25000,-25000,980,0,0,2247580,False,457C-PEP2-CP57-34C4
OKj0sJuyR7allLL86A,1731924051,–°—ñ–ª—å–ø–æ,5411,5411,-91600,-91600,980,0,916,2272580,False,2M85-0BK5-E223-88T7
BfbCE8yJ1MFTGxLd2A,1731921995,MIKSMART,5499,5499,-7800,-7800,980,0,78,2364180,False,14H6-C32A-9CKB-MCX7
UPfuwhSFyr1Uhrq93Q,1731921109,Fitnes klub 2BFIT,7941,7941,-100000,-100000,980,0,0,2371980,False,9H92-6B02-9TA0-AHMM
sZsRN1Cfc7lm6mfwLg,1731920986,IPAY   *SILPO FOOD2,5411,5411,-35200,-35200,980,0,3520,2471980,False,2P13-3676-6008-67T1
FKOpTFvlEn_wI7GIVQ,1731919348,Novapay,8999,8999,-8425,-8425,980,0,0,2507180,False,X948-4X9P-1AAA-7305
CofrO6khW4e2B9-HHA,1731913645,OKKO,5541,5541,-9290,-9290,980,0,0,2515605,False,AX3X-68XX-ET17-7M61
9Mzj8MUP8mtyxx9_gA,1731911019,Kus  Kus,5814,5814,-9000,-9000,980,0,180,2524895,False,7841-T3M6-034M-0KA8
YZlPOAZacDPyHsdWXQ,1731910185,Kus  Kus,5814,5814,-28500,-28500,980,0,570,2533895,False,CB7B-K9MX-351C-6XE6
m4VonAWpvR7Z-JCd0w,1731849450,Bolt,4121,4121,-19200,-19200,980,0,0,2562395,False,337B-TT80-T31C-472K
0PbPSaaDZqnrt5C6mw,1731845106,Lesya,4829,4829,-400000,-400000,980,0,0,2581595,False,290A-39BP-047A-M7BM
L2BoCWLy_7IxfgREqQ,1731844183,Best Way To Cup,5814,5814,-22500,-22500,980,0,450,2981595,False,6CP6-63KC-M2B3-M332
o0otgVBqD2JSHmZyBQ,1731836352,FOP VIKHROVA O.M.,742,742,-17500,-17500,980,0,0,3004095,False,6MBC-M2X6-0X8M-K859
51dHCFiNPVIk7F-6Hw,1731833068,Samsara,5812,5812,-10500,-10500,980,0,210,3021595,False,3ETP-M5BH-0A55-8286
uAWF6j_YTPBDrwpWQg,1731794101,LIQPAY*Pethouse,5995,5995,-121800,-121800,980,0,0,3032095,False,HEE7-5PHX-A73B-11XC
HXvgYwGDvzi5D7ySNw,1731781319,Uklon,4121,4121,-9500,-9500,980,0,0,3153895,False,XCTX-B9X2-2A3C-5B92
o5QU9X-441xtIPjQwg,1731771106,–ó–æ–æ–º–∞–≥–∞–∑–∏–Ω –õ—é–±–∏–º—ã–π,5995,5995,-45700,-45700,980,0,0,3163395,False,B5E8-P48T-B3CK-PEP4
hBUz-rtlEwLGy_1UDQ,1731758755,–ü–∞—Ä–∫–æ–≤–∫–∞,7523,7523,-8000,-8000,980,0,0,3209095,False,7HEP-PM7A-TXTM-XB81
NmoyVAe0A6pFtAwYOA,1731758134,Magazin GEEKACH Nastil,5942,5942,-199900,-199900,980,0,0,3217095,False,E586-3PC4-XA4T-095B
QmCowFmCcKJ0XatLNA,1731756172,Fresh Dzhus end Babl T,5814,5814,-21000,-21000,980,0,420,3416995,False,8432-90X9-PC5C-EATC
iI0lsebL6lqQkathNQ,1731755861,MIRATON,5661,5661,-59900,-59900,980,0,0,3437995,False,K3B5-A5B6-910B-P6P2
BnHN7p2Sqex6fjwiDQ,1731750760,Good Bread,5462,5462,-8500,-8500,980,0,85,3497895,False,APC9-HBB1-891E-9903
Xhf4Dj16UsCBQOP3Iw,1731750502,AVANGARDEN,5812,5812,-35000,-35000,980,0,700,3506395,False,66XA-EX75-1X15-07C0
slrA3gZSvvLpS5N9Tg,1731750102,SCHOP-BAR,5813,5813,-27400,-27400,980,0,548,3541395,False,B836-M54C-HE3C-CAP8
VCiAYBg_q5gs2l7NyQ,1731749084,"–ü–æ–ø–æ–≤–Ω–µ–Ω–Ω—è ¬´–º–∞—Ä–∫–µ—Ç –≤–∏–ø—ñ—á–∫–∏, pate¬ª",4829,4829,-30000,-30000,980,0,0,3568795,False,ME77-6MH7-3A05-1P12
6eXWhb5KWBZgV5Dolg,1731747483,Novapay,8999,8999,-8000,-8000,980,0,0,3598795,False,4PK0-EHEA-B9M1-4581
kpOM4g80l9j6NwCW1g,1731687434,–í–∞–ª–µ–Ω—Ç–∏–Ω–∞ –ö.,4829,4829,-130000,-130000,980,0,0,3606795,False,43K2-0CC8-09A0-K2A2
e-mUgdhOzfXBKoc3gw,1731674619,Novapay,8999,8999,-6000,-6000,980,0,0,3736795,False,HK1K-332P-XAEB-PBH0
i64PJx9yaB3n6gkaUg,1731672772,Novapay,8999,8999,-8600,-8600,980,0,0,3742795,False,8HCT-3KKH-7PC4-6809
JCOjwOvZQpl5ZTJ0sg,1731668823,–°—ñ–ª—å–ø–æ,5411,5411,-2000,-2000,980,0,20,3751395,False,2C12-EPMA-AX60-ACEC
eKl005MNr67ZP-ddRg,1731668787,–°—ñ–ª—å–ø–æ,5411,5411,-219265,-219265,980,0,2192,3753395,False,191E-K1HP-KTAB-9C38
oXFApqbYFbv-qtnd8w,1731665703,Fitnes klub 2BFIT,7941,7941,-100000,-100000,980,0,0,3972660,False,2X52-17CA-7E1M-T9E3
gcEuu725dTPSPbIhoA,1731658753,–§–ö –ï–í–û,5399,5399,-3000,-3000,980,0,30,4072660,False,B23M-CTP6-84B7-C598
7f7-oDMWBJYQB7tNuw,1731658416,FOP Shevchenko,5499,5499,-15400,-15400,980,0,154,4075660,False,C22K-H3P3-92A5-MX59
owSy-tlXf-pWJlZl9Q,1731654721,WFP.GROCERY1,5499,5499,-87140,-87140,980,0,871,4091060,False,EX3B-H9PP-92H4-7P0P
7FzXo7MQbhKmxrYOfg,1731617521,Novapay,8999,8999,-8100,-8100,980,0,0,4178200,False,AK5M-0B8X-BB8P-P5EH
D5MPvfqH6lS2_aXeZA,1731609026,PINA,5812,5812,-12000,-12000,980,0,240,4186300,False,X458-36M9-25KX-9EE9
InSCtaOGsB47ignLJA,1731606827,KAFE NU NU,5812,5812,-9900,-9900,980,0,198,4198300,False,C6E2-CC2A-1C7B-X48K
bOtadst3xeFgUolv5Q,1731606114,NUNU | –Ø—Ä–æ—Å–ª–∞–≤—ñ–≤ –í–∞–ª,5812,5812,-57400,-57400,980,0,1148,4208200,False,A85H-HA0A-EA3X-C60E
8Qm92ujOowNwt-PVBw,1731605149,WineTime,5921,5921,-23200,-23200,980,0,232,4265600,False,5BBK-PX14-HXX3-K32P
-tXqXBg_zBA2lUCznQ,1731588367,Bolt,4121,4121,-9400,-9400,980,0,0,4288800,False,TM8H-BH03-1317-A207
PCrp4QLgAuZk9dj_Sw,1731580986,–ú–∞—Ä—á—É–∫ –•–ª—ñ–±,5812,5812,-19200,-19200,980,0,384,4298200,False,TXT6-48MP-1XT9-2C22
ixEBsTxW1DRIKykWeg,1731576878,MIKSMART,5499,5499,-13600,-13600,980,0,136,4317400,False,AT2X-TM51-5TA1-EK14
Wv3MQFzIpoY0lKpI2A,1731576385,MARCHUK KHLIB CAFE,5814,5814,-20900,-20900,980,0,418,4331000,False,A9K9-5AM9-7899-MC92
qvt7AwEr-FDXaj0K4g,1731576367,Fitnes klub 2BFIT,7941,7941,-70000,-70000,980,0,0,4351900,False,6C7T-838P-320H-E6KH
N5GuWHiJOyxU6sfmuQ,1731575063,–ö–∏—ó–≤—Å—å–∫–µ –º–µ—Ç—Ä–æ,4111,4111,-800,-800,980,0,0,4421900,False,57X7-7XBX-KX46-603K
sfPVSFcsV8Gky8pv_g,1731525910,–§–û–ü –ú–∞—Ç–≤—î—î–≤–∞ –í–∞–ª–µ–Ω—Ç–∏–Ω–∞ –û–ª–µ–∫—Å–∞–Ω–¥—Ä—ñ–≤–Ω–∞,4829,4829,-200000,-200000,980,0,0,4422700,False,P87E-TBK9-9CM9-K9KT
5O3ynQ3h7gzG9y9Dvw,1731516650,LIQPAY*RISO SUSHI DELI,5812,5812,-80000,-80000,980,0,1600,4622700,False,3KPM-HAM1-K1P2-AT6B
_5KAnaz4xhpRdj_vHA,1731503479,Best Way To Cup,5814,5814,-15000,-15000,980,0,300,4702700,False,A5M0-H7AP-3H10-4044
QfP-q3tZT-kfWZX_Ow,1731498479,–ü–æ–ø–æ–≤–Ω–µ–Ω–Ω—è ¬´–ù–∞ –†–ï–ë–∏ –¥–ª—è –º–µ–¥–∏–∫—ñ–≤¬ª,4829,4829,-150000,-150000,980,0,0,4717700,False,9AXM-8TH6-BXXT-6C6M
M2oVYG87WfR3Et2dKw,1731490736,–ü—Ä–æ–¥—É–∫—Ç–∏,5499,5499,-1400,-1400,980,0,14,4867700,False,HM6X-H5K6-K984-55A9
DFzni6hywuQwW_Za7w,1731431264,Rozetka,5722,5732,-173700,-173700,980,0,0,4869100,False,7520-1H92-4XEX-TT5M
I7Um3QSKYI1Y4pSlhA,1731427588,Novapay,8999,8999,-6000,-6000,980,0,0,5042800,False,A144-36CA-27C8-HE35
5pHVOoifEpBynMekjA,1731422476,–ü–µ—Ä–µ–∫–∞–∑ –Ω–∞ –∫–∞—Ä—Ç–∫—É,4829,4829,-600000,-600000,980,0,0,5048800,False
9tJI0ebkcp23Rc3t3Q,1731404777,–ü–æ–ø–æ–≤–Ω–µ–Ω–Ω—è ¬´–ó–ë–Ü–† –î–õ–Ø –ë–†–ê–¢–ê vol.2¬ª,4829,4829,-500000,-500000,980,0,0,5648800,False,E5CP-336E-H1C4-22A4
31GJkAOBSxbbAdB5SA,1731402563,–íi–¥: –ü–†–ò–•–û–î–¨–ö–û –ï.–í. –§–û–ü,"–î–ª—è –ø–æ–ø–æ–≤–Ω–µ–Ω–Ω—è –∫–∞—Ä—Ç–∫–∏ 5375414101190360, –ü—Ä–∏—Ö–æ–¥—å–∫–æ –ï—Ä–Ω–µ—Å—Ç –íi–∫—Ç–æ—Ä–æ–≤–∏—á, 3487403339",4829,4829,6100000,6100000,980,0,0,6148800,False
Kj6gEnrOEIf4UjfTxA,1731398374,Best Way To Cup,5814,5814,-27500,-27500,980,0,206,48800,False,529H-K3KE-X100-9K70
enHkEoe8qRcaJJhXeg,1731396855,Best Way To Cup,5814,5814,-8500,-8500,980,0,63,76300,False,2A9B-16MH-4646-8K46
2YaiWWVMVNxRzG5KIQ,1731333737,5045Kavjarnja,5814,5814,-6000,-6000,980,0,45,84800,False,4M64-4EHT-M87B-MAPB
fSJYCnlnRTQc0t51iw,1731333483,Ukrkhalial,5499,5499,-32042,-32042,980,0,240,90800,False,KE2C-8864-P573-KCKA
ZZLzExRnVoKz_HuzcQ,1731331514,Bolt,4121,4121,-13200,-13200,980,0,0,122842,False,EH3X-3PC5-8M9A-9EM1
UKAcyyzTl-pYKj0A8w,1731323995,–°—ñ–ª—å–ø–æ,5411,5411,-28296,-28296,980,0,212,136042,False,B547-2TEK-000P-KXK0
uubcXXWFbRMMLLO3Bg,1731323240,Ukrkhalial,5499,5499,-17460,-17460,980,0,130,164338,False,94EM-P7T5-710P-0T8A
qb6OyFXeq_htpIxQTw,1731322771,–°–∫–∞—Å—É–≤–∞–Ω–Ω—è. Bolt,4121,4121,28800,28800,980,0,0,181798,False
9Q6C3PWTe0Qrw_mOYA,1731322725,Bolt,4121,4121,-36800,-36800,980,0,0,152998,False,C16P-E419-25K4-1K8A
LAE8x6eFSlTdiZgWHg,1731319470,Bolt,4121,4121,-28800,-28800,980,0,0,189798,False
_JkgDATmkStDTrDgVw,1731316555,Novapay,8999,8999,-8000,-8000,980,0,0,218598,False,79HB-K57K-338T-XT3P
wyhTwHvF84wPfDoRNw,1731311885,2Bfit,7941,7941,-239900,-239900,980,0,0,226598,False,CECT-C78K-B2TC-27B6
5iKmE8HtMfYjT-ZEYw,1731306541,Novapay,8999,8999,-6000,-6000,980,0,0,466498,False,595A-CP42-T0PC-C85T
ZpKl0abKjJphuWNfsg,1731269989,LIQPAY*Pethouse,5995,5995,-146200,-146200,980,0,0,472498,False,56HC-K8EP-A595-731E
93b5ndr7T3U_7YA9Rg,1731249447,TSUM,7523,7523,-10000,-10000,980,0,0,618698,False,KAA6-BBE9-354B-89X8
PIFdsDjOeLCgtLGGFg,1731249003,–°–µ–Ω—Å,5942,5942,-5000,-5000,980,0,0,628698,False,4T49-P7P1-A6H9-EMPP
leVuSx_JNaBSMySFrg,1731248864,–°–µ–Ω—Å,5942,5942,-160000,-160000,980,0,0,633698,False,56H5-6M7P-62A0-700T
2nZ5SwOhnxeYaruSbQ,1731237295,BARMAGAZiN,5814,5814,-77000,-77000,980,0,577,793698,False,1HX1-H636-1T4P-6TM7
F5GSCP4xuK-BznaVeQ,1731236901,MasterZoo,5995,5995,-5100,-5100,980,0,0,870698,False,0AKT-C6CA-H4M4-C83A
dgdAxSafhnrZTNqfGA,1731236622,FOP VIKHROVA O.M.,742,742,-17500,-17500,980,0,0,875798,False,65EB-KBHX-EB6B-H080
PtvTm-AlONQLFeJ3LA,1731229892,A2068,5912,5912,-67045,-67045,980,0,0,893298,False,CX18-P35A-KB59-PA9A
k_lHtbExAlH3BGEkYg,1731228907,Novus,5411,5411,-35093,-35093,980,0,263,960343,False,5EC3-PA2M-B6PC-3T0K
JUXM7-KKUv2xVhqOpQ,1731227164,Bestwaytocup,5814,5814,-205500,-205500,980,0,1541,995436,False,5722-K124-851H-X728
ifaGptJgM6XXhjlyqg,1731185340,CRUMB.UKRAINE,5977,5977,-49000,-49000,980,0,0,1200936,False,8527-PXM9-BA46-1K5B
HBPnkuY2gm59Nltk7g,1731179128,Funtcoffee,5311,5311,-57000,-57000,980,0,427,1249936,False,BBXC-E219-C64X-4293
mwkRF3g2SBEWWBrNjA,1731161059,–í–µ—Ç–µ—Ä–∏–Ω–∞—Ä–Ω–∞ –∞–ø—Ç–µ–∫–∞,742,742,-342000,-342000,980,0,0,1306936,False,K113-AHX2-15TT-1B0B
XCBMwnpEa873TFvSrQ,1731139502,Steam,5816,5816,-14900,-14900,980,0,0,1648936,False,1459-602M-E4C6-P8AB
Fb2llobXjBjOYkfZ5w,1731137782,–ü–æ–ø–æ–≤–Ω–µ–Ω–Ω—è ¬´–ß–∞–π–æ–≤—ñ –∫–æ–º–∞–Ω–¥—ñ bwtc¬ª,4829,4829,-10400,-10400,980,400,0,1663836,False,59M7-P9BK-ETX1-911B
5XsXX_aMzvlfgwWHIA,1731137760,Bestwaytocup,5814,5814,-22500,-22500,980,0,168,1674236,False,MAT6-4620-8PE0-6C7C
6AFXfxcNnPDcqVUUzA,1731083853,WineTime,5921,5921,-49600,-49600,980,0,372,1696736,False,B3TX-AT15-CXH0-XP23
PmhCmS9CtLChfy5vRA,1731074741,Novapay,8999,8999,-8000,-8000,980,0,0,1746336,False,ET9B-3H6M-6P8E-AHK3
1zcBUhGfPVDHV5uoDw,1731074694,–ù–æ–≤–∞ –ø–æ—à—Ç–∞,7399,7399,-8000,-8000,980,0,0,1754336,False,2173-0PEC-C8TX-EHB1
RVNjeQpc4CgLQlTCdQ,1731061848,–°—ñ–ª—å–ø–æ,5411,5411,-32562,-32562,980,0,244,1762336,False,95TA-E1P9-963B-3M39
7R2Xzs5odm7wj4JNeg,1731060790,2Bfit,7941,7941,-70000,-70000,980,0,0,1794898,False,8T6P-XBM6-B2CP-B641
h7v749JGjKodC82Obw,1731052004,516780****2561,4829,4829,-26000,-26000,980,1000,0,1864898,False,863K-2518-4P4H-1H70
YSGM8zALXdv-7JhCWA,1731051613,—è–π—Ü—è –º–µ–¥,4829,4829,-20905,-20905,980,804,0,1890898,False,E4EC-39MH-BB45-AET8
vv1Y2-v91pF8-NOV8A,1731051556,414962****9534,4829,4829,-22568,-22568,980,868,0,1911803,False,8MX6-HK9M-5AEM-XH16
aDdXqsarDy-Hu6-xFg,1731051128,Best Way To Cup,5814,5814,-8500,-8500,980,0,63,1934371,False,MC64-T5EP-P4C9-0A1C
VFAascHgvG4eRTKsww,1731004870,Portmone,7011,7011,-634200,-634200,980,0,0,1942871,False,14TA-8680-BAXK-B0H6
OyjRqx-YVjvGEKtcdw,1731003016,Novapay,8999,8999,-10500,-10500,980,0,0,2577071,False,069X-15T0-X060-E7E7
XI0CifKAK9qWGRwxiQ,1730999025,–ê–ø—Ç–µ–∫–∞ –î–æ–±—Ä–æ–≥–æ –î–Ω—è,5912,5912,-960,-960,980,0,0,2587571,False,6984-T02T-XE5P-K622
Y0QRRzEnbqRGdK46zg,1730998884,MasterZoo,5995,5995,-21200,-21200,980,0,0,2588531,False,ME51-C01H-1PH1-7E98
TmIDdFnlG1nKv5-9fg,1730997602,PINA,5812,5812,-105000,-105000,980,0,2100,2609731,False,11E7-B3MX-3833-A629
PlzVeTagy0O8N3P8GQ,1730994961,LIQPAY*TOV Hab Vet,742,742,-50000,-50000,980,0,0,2714731,False,178M-MBB3-2H36-8385
fgaBzZZ4WRBrBW0j9g,1730985613,"–ü–æ–ø–æ–≤–Ω–µ–Ω–Ω—è ¬´—Ä–µ—Ç—Ä—ñ–∫,–±–∞—Ç–∫–∏,–ø–ª–∞–Ω—à–µ—Ç¬ª",4829,4829,-100000,-100000,980,0,0,2764731,False,94BC-69TP-BEM3-87TH
UYGp916qG2tukVgZRQ,1730981298,Steam,5816,5816,-5600,-5600,980,0,0,2864731,False,2CE3-925C-B0BP-A1EH
owNDyCuOF9xeV_2FEg,1730970089,Novus,5411,5411,-29297,-29297,980,0,292,2870331,False,TK1H-78H7-9820-BP06
VFLII08vXKZRWWJ1JA,1730921101,–°—ñ–ª—å–ø–æ,5411,5411,-45500,-45500,980,0,455,2899628,False,M1CE-X71M-BBT9-44TP
KO4lW0AcW8RX0zW4aA,1730914235,JYSK,5200,5712,-52500,-52500,980,0,0,2945128,False,THKM-MB57-75KA-MH39
wsOD5GRXEfZ4MDHD3Q,1730911975,Novapay,8999,8999,-6495,-6495,980,0,0,2997628,False,8HAP-9A75-36EK-AK1A
j7CWLGGt8u94q8-aEQ,1730911916,Novapay,8999,8999,-6000,-6000,980,0,0,3004123,False,3C3A-H647-464T-1T8H
Q1TOLxzHIgQFwxyVdg,1730905770,–°–∫–∞—Å—É–≤–∞–Ω–Ω—è. Novapay,8999,8999,9495,9495,980,0,0,3010123,False
xKWAPWg70RkNAgYIjQ,1730905553,Novapay,8999,8999,-9495,-9495,980,0,0,3000628,False
PXVRWJdxdIZlGrRxkw,1730904964,Novapay,8999,8999,-6000,-6000,980,0,0,3010123,False,0CAK-A1C2-M93H-KCE6
9X5uas2EvRkewJc4AA,1730897531,Steam,5816,5816,-38900,-38900,980,0,0,3016123,False,007A-6EX2-KX61-61T6
l264AVWzkY605D6ULQ,1730892735,LIQPAY*Pethouse,5995,5995,-205300,-205300,980,0,0,3055023,False,35P9-EEKM-0E59-7K2E
Dv63WbI3XDzzuR37sg,1730889002,WFP.GROCERY1,5499,5499,-213140,-213140,980,0,2131,3260323,False,2E39-KT83-0E6X-K7EC
Vg8D1oq0vHQE-a7jDQ,1730888110,–¢–µ—Ç—è–Ω–∞ –ü.,4829,4829,-70000,-70000,980,0,0,3473463,False,TA83-695K-91BP-0HPX
syzAihzZp84i_SvSTA,1730885893,–°—ñ–ª—å–ø–æ,5411,5411,-38379,-38379,980,0,383,3543463,False,BCXX-H3BE-T96T-8H5K
2a0EOsel7PrpYiLnDw,1730878051,–ü–æ–ø–æ–≤–Ω–µ–Ω–Ω—è ¬´–ù–∞ –†–ï–ë –¥–ª—è 71 –æ—î–±—Ä¬ª,4829,4829,-100000,-100000,980,0,0,3581842,False,9A6A-0B4M-K7MH-5XBC
6bhMKBOt2Ah47DpDAw,1730878018,–ü–æ–ø–æ–≤–Ω–µ–Ω–Ω—è ¬´–ù–∞ –¥—Ä–æ–Ω–∏ –¥–ª—è –ó–°–£¬ª,4829,4829,-50000,-50000,980,0,0,3681842,False,BP03-XC3E-BX5X-04E0
AYJ3gPMFvaqi6BDZbw,1730848938,Steam,5816,5816,-28000,-28000,980,0,0,3731842,False,076X-E7P0-0185-65C6
3k9zy5RiRNuH-RTtTg,1730830427,MasterZoo,5995,5995,-5900,-5900,980,0,0,3759842,False,M32A-96EB-1BTB-BHBE
pacylng8W0-mcTA9Fg,1730830178,LIQPAY*Simona Ristoran,5812,5812,-32500,-32500,980,0,650,3765742,False,PH0M-ME44-2687-7A5C
_2zvCotmzN1wwvvUbw,1730810720,–°—ñ–ª—å–ø–æ,5411,5411,-24493,-24493,980,0,244,3798242,False,KX4H-T7CC-3C4K-577A
tZMHrGnaSFOKXAmIiQ,1730802484,Lesya,4829,4829,-100000,-100000,980,0,0,3822735,False,3BAC-E3X1-BXMH-P6XP
NdRI9-elyRb91Mwq1w,1730800623,MasloTOM,5411,5411,-139200,-139200,980,0,1392,3922735,False,AKB2-KE1A-2EP5-M6XK
DFmZswX4AjCsE3gTDw,1730798455,UNIVERSUM CLINIC,8099,8099,-260000,-260000,980,0,0,4061935,False,A938-4527-XHA4-PX5B
iKPm0yr2AeroYS0CCw,1730797122,Novapay,8999,8999,-20292,-20292,980,0,0,4321935,False,T8C4-E68H-K421-P9TA
6XsErdhoNFax0WtKvQ,1730743046,LIQPAY*Simona Ristoran,5812,5812,-37400,-37400,980,0,748,4342227,False,T94C-PE96-X6M7-716H
QoxrkyCT_FGTbG537g,1730728452,Kafe Kharms,5814,5814,-6400,-6400,980,0,128,4379627,False,99XC-P9K1-X4EX-TP9K
F-ZFC_9NHo6zcMVP6w,1730726510,Zigzag,5812,5812,-141800,-141800,980,0,2836,4386027,False,BB4B-2TBX-BH89-8B4H
u5FUh8zji92yxbqCOQ,1730717831,–ú—ñ—Å—å–∫–µ –∫–∞—Ñ–µ –•–∞—Ä–º—Å,5812,5812,-8000,-8000,980,0,160,4527827,False,E7CP-K5B9-B4A8-0H1H
2bzzeGfShxGKCbGMvg,1730714636,–ü–æ–ø–æ–≤–Ω–µ–Ω–Ω—è ¬´puppy¬ª,4829,4829,-2100000,-2100000,980,0,0,4535827,False,K9B3-CBX3-0AAA-396H
YK0NV0q1E6YU-Tpw4A,1730714475,–íi–¥: –ü–†–ò–•–û–î–¨–ö–û –ï.–í. –§–û–ü,"–î–ª—è –ø–æ–ø–æ–≤–Ω–µ–Ω–Ω—è –∫–∞—Ä—Ç–∫–∏ 5375414101190360, –ü—Ä–∏—Ö–æ–¥—å–∫–æ –ï—Ä–Ω–µ—Å—Ç –íi–∫—Ç–æ—Ä–æ–≤–∏—á, 3487403339",4829,4829,6500000,6500000,980,0,0,6635827,False
5NzqQX1zFah0uXAK6A,1730711469,Apteka Mirra,5912,5912,-10940,-10940,980,0,0,135827,False,X174-587A-9MC1-T1M2
AWN7AFwcQ1yrUm_PAA,1730711438,Apteka Mirra,5912,5912,-6597,-6597,980,0,0,146767,False,P565-5B3M-2BK0-0AT9
b0XxSwvX6UpQ07JfVQ,1730653624,Barbershop,7230,7230,-75000,-75000,980,0,0,153364,False,8KHT-M20M-0M21-1P27
QcNJ-8dawNMjuNq5dw,1730625107,–û—Ñ—ñ—Å-—á–∞–π,5812,5812,-10000,-10000,980,0,75,228364,False,ATB1-M3K4-KB7X-69MC
MBmclWHd83LgGK4b3g,1730625017,–ß–∞—Å—Ç–∫–æ–≤–µ –∑–Ω—è—Ç—Ç—è –±–∞–Ω–∫–∏ ¬´–ù–∞ –∫–æ–º–ø—É—Ç—î—Ä –¥–ª—è –≥—Ç–∞6¬ª,4829,4829,199900,199900,980,0,0,238364,False
Ndq4r2uonBve6bcl8A,1730579692,Apteka,5912,5912,-9600,-9600,980,0,0,38464,False,8812-XTKM-06A9-1H51
rfRm9otxJZsFwK39rQ,1730552195,–ö–æ–ª–æ,5411,5814,-4500,-4500,980,0,33,48064,False,1XH1-PATC-9EA2-18MB
Mvm0Yj_6ta89UP6aKQ,1730533071,Novapay,8999,8999,-6600,-6600,980,0,0,52564,False,3466-KBXC-53CP-488P
E4Vl0sDEQf2mhwHR9A,1730484130,KAFE TITKA KLARA,5814,5814,-8000,-8000,980,0,60,59164,False,KH3X-718T-B9E6-MMXC
guOYNEcCd0SsOiiyIw,1730482932,LIQPAY*Simona Ristoran,5812,5812,-70400,-70400,980,0,528,67164,False,5H32-26XB-864A-3T49
boXP7rxJ8h3FkpVJbQ,1730482814,–í–∏–≤–µ–¥–µ–Ω–Ω—è –∫–µ—à–±–µ–∫—É 1257.92‚Ç¥,4829,4829,101262,101262,980,0,0,137564,False
et8QsLZqP5xprNKUkA,1730479410,WOG,5541,5541,-80000,-80000,980,0,0,36302,False,KBX6-XE6E-E03A-M6K1
eQRhlvv0KHY97EGfEA,1730474807,MEDICHNIY ZAKLAD HAB V,742,742,-7000,-7000,980,0,0,116302,False,AMTH-063E-1C66-288M
T0Q2iK0o2UiFCt9rRQ,1730455931,2bfit_fitness_club,7941,7941,-70000,-70000,980,0,0,123302,False,7A0A-49HC-E1P4-H918
gtPiGqKFVF22KfJuSA,1730450512,–ê–ø—Ç–µ–∫–∞ ¬´–ë–∞–∂–∞—î–º–æ –∑–¥–æ—Ä–æ–≤'—è¬ª,5912,5399,-7962,-7962,980,0,0,193302,False,PM5B-8PT1-2XP6-KAE1
C-YJQMv29ZccuUOrxw,1730446283,FOP Shevchenko,5499,5499,-11000,-11000,980,0,0,201264,False,21P4-T56E-P3TB-T347
zo7YsyrPH9mRQc6pkQ,1730445900,–ê–ø—Ç–µ–∫–∞ ¬´–ë–∞–∂–∞—î–º–æ –∑–¥–æ—Ä–æ–≤'—è¬ª,5912,5399,-6315,-6315,980,0,0,212264,False,HK61-9EHM-3H1P-1180
wmSZgnaeYTxYcqwxSQ,1730445844,–ê–ø—Ç–µ–∫–∞ ¬´–ë–∞–∂–∞—î–º–æ –∑–¥–æ—Ä–æ–≤'—è¬ª,5912,5399,-21660,-21660,980,0,0,218579,False,48E7-X5P3-280X-KHH8
2Pzcl1fA8VmCDt-W6w,1730445511,–ü–æ–ø–æ–≤–Ω–µ–Ω–Ω—è –ü—Ä–∏–≤–∞—Ç24,6536,6536,200000,200000,980,0,0,240239,False
xypIe5Od2wy_loum8pFZdw,1730419509,Bolt,4121,7999,-3803,-3803,980,0,0,40239,True
xb8HltmlIb8iy6G2AHOWW4raTKI,1730419509,–°–∫–∞—Å—É–≤–∞–Ω–Ω—è. Bolt,4121,7999,8000,8000,980,0,0,44042,False
J17JSPNnVO8aFu1WjQ,1732885695,–í—ñ–¥: –û–ª–µ—Å—è –°–∞—á–µ–Ω–∫–æ,4829,4829,300000,300000,980,0,0,436143,False
we8s2Ge_1275thoyig,1732884943,Lesya,4829,4829,-400000,-400000,980,0,0,136143,False,02BT-3XKT-41PB-AB1P
NOWF3_ne97nnRKampQ,1732868477,414962****9534,4829,4829,-37000,-37000,980,0,0,536143,False,24K9-4HBT-MP9C-7PC8
TJSrG6ZlRMaOCOnsPg,1732868224,–í–∞–¥–∏–º –û.,4829,4829,-11000,-11000,980,0,0,573143,False,5EX8-BC55-XMM3-5AXX
SCJgFTzt2I4HAju9gA,1732868060,—è–π—Ü—è –º–µ–¥,4829,4829,-17085,-17085,980,0,0,584143,False,2571-2301-AK34-0K24
sLwrQwWGaZelEFb5oQ,1732786826,–ü–æ–ø–æ–≤–Ω–µ–Ω–Ω—è ¬´puppy¬ª,–ü–æ–ø–æ–≤–Ω–µ–Ω–Ω—è —Ä–∞—Ö—É–Ω–∫—É –±–∞–Ω–∫–∏,4829,4829,-120000,-120000,980,0,0,601228,False,7020-1T4C-CM0P-BX3C
hUuMbt2NpsdXFR1RNA,1732786807,Lesya,4829,4829,-200000,-200000,980,0,0,721228,False,EK7E-9XEH-PT10-EEAT
ClylKVQQZE95beYf_A,1732741922,–ü–æ–ø–æ–≤–Ω–µ–Ω–Ω—è ¬´Autel EVO Max 4N –¥–ª—è 138 –±–∞—Ç–∞–ª—å–æ–π–æ–Ω—É –¢–†–û¬ª,8398,8398,-150000,-150000,980,0,0,921228,False,BHB3-0X21-9145-EA28
_NW5yRj882fNAi_UbQ,1732722687,–§–û–ü –Æ—Ä—á–µ–Ω–∫–æ –û–∫—Å–∞–Ω–∞ –í–æ–ª–æ–¥–∏–º–∏—Ä—ñ–≤–Ω–∞,4829,4829,-60000,-60000,980,0,0,1071228,False,2PB5-8KA9-7A4P-8T5K
WFy1ZxM-Q_8-GVFx3w,1732704386,–ó —á–æ—Ä–Ω–æ—ó –∫–∞—Ä—Ç–∫–∏,4829,4829,1000000,1000000,980,0,0,1131228,False
MKjFGFuF0AxjNmDWKg,1732704355,–í–∏–ø–ª–∞—Ç–∞ –±–∞–Ω–∫–∏ ¬´–ù–∞ –∫–æ–º–ø—É—Ç—î—Ä –¥–ª—è –≥—Ç–∞6¬ª,4829,4829,14101,14101,980,0,0,131228,False
aLlHSrPgSpUe5I1eNQ,1732550047,Lesya,4829,4829,-200000,-200000,980,0,0,117127,False,3MMP-XK70-X227-5M4A
H2QiVYEwvRdfmPQFqA,1732547101,–ü–æ–ø–æ–≤–Ω–µ–Ω–Ω—è ¬´–ù–∞ –ª—ñ—Ö—Ç–∞—Ä–∏–∫–∏¬ª,4829,4829,-150000,-150000,980,0,0,317127,False,94CB-61XA-T7XK-HH1K
Ocx_ih91T5ujA-PYyw,1732546963,–ó —á–æ—Ä–Ω–æ—ó –∫–∞—Ä—Ç–∫–∏,4829,4829,400000,400000,980,0,0,467127,False
dJ6mNsrP4-G9VnVPtQ,1732546955,–ó —á–æ—Ä–Ω–æ—ó –∫–∞—Ä—Ç–∫–∏,4829,4829,45000,45000,980,0,0,67127,False
Pc_aORHzJXnPJBAnpQ,1732221879,Lesya,4829,4829,-110000,-110000,980,0,0,22127,False,P6C6-4K49-92A2-30E7
25lqZSsBwPhenDdoiw,1732194229,–§–û–ü –°–¢–ï–ü–ê–ù–ö–û –¢–ï–¢–Ø–ù–ê –ú–ò–•–ê–ô–õ–Ü–í–ù–ê,4829,4829,-208000,-208000,980,0,0,132127,False,B5EP-BXT9-TCMB-M698
lvcGifMHNVQyUFrspg,1732193956,P24 *Prykhodko Ernest,6012,6012,170000,170000,980,0,0,340127,False
e5SzjZf41X-QtMJN-g,1732192958,–ñ–∞–Ω–Ω–∞ –ñ.,üêà‚Äç‚¨õüêà,4829,4829,-150000,-150000,980,0,0,170127,False,B19P-BH3M-M8CM-A60E
8r-KfejAQ1xYz7FUGQ,1731814260,–†–µ–≥—É–ª—è—Ä–Ω–µ –ø–æ–ø–æ–≤–Ω–µ–Ω–Ω—è ¬´–§–æ–Ω–¥ –ü–æ–≤–µ—Ä–Ω–∏—Å—å –∂–∏–≤–∏–º¬ª,4829,4829,-25000,-25000,980,0,0,320127,False,M99P-P9K8-48C8-2255
VubPmUZCB5MUUo7cLg,1731658250,414949****2985,4829,4829,-10101,-10101,980,0,0,345127,False,9A93-HT9P-AC9M-4082
BLXI1srSLEJswPp-Qw,1731422504,–ñ–∞–Ω–Ω–∞ –ñ.,4829,4829,-250000,-250000,980,0,0,355228,False,X53K-EB54-E09E-KXC6
1pa5dBt3GuWsmBj60g,1731422476,–ó —á–æ—Ä–Ω–æ—ó –∫–∞—Ä—Ç–∫–∏,4829,4829,600000,600000,980,0,0,605228,False
QLaSYAj5zpbvMausiA,1735581586,–ö–£–ó–Ø,4900,4900,-45000,-45000,980,0,0,402779,False,86TH-5H31-C9MP-CP98
xRlQoLb6Ft4b2tFO0g,1735573515,Cheesecake Family,5812,5812,-20500,-20500,980,0,0,447779,False,T0CH-K627-C4ET-KK43
lHaybnX6gwFd4hNzyg,1735569968,–Ü–Ω—Ç–µ—Ä—Å–ø–æ—Ä—Ç,5655,5941,-199800,-199800,980,0,0,468279,False,1K71-5H5A-9E9T-HM1X
bCyJwW9ncnSaqnIKOA,1735569176,–ï–ø—ñ—Ü–µ–Ω—Ç—Ä,5200,5200,-8699,-8699,980,0,0,668079,False,0C09-3CX5-1B19-9932
sjkaoksdggVSUIJyfA,1735550274,Novapay,8999,8999,-8000,-8000,980,0,0,676778,False,C22T-HKK1-88X1-TH7E
5H-HlvoTLk9irgzxDg,1735548647,2bfit_fitness_club,7941,7941,-100000,-100000,980,0,0,684778,False,H864-A2TE-EAX2-2783
cPiqsalFT7fw5Gjb0g,1735544045,–ü–ª–∞—Ç—ñ–∂ MOYO,4829,4829,-49983,-49983,980,0,0,784778,False
-KmH4guFHGpI4P4QEw,1735496546,–°—ñ–ª—å–ø–æ,5411,5411,-30638,-30638,980,0,136,834761,False,X88X-0267-7MAB-KE16
Zae8nK5W2v4Q0XPkEw,1735496336,SECHST,5912,5912,-1833,-1833,980,0,0,865399,False,6M5C-B5TH-74C9-K6KT
92mQxY44VpnTq7gqwA,1735494686,StomatologiyaFdclinic,8021,8021,-32500,-32500,980,0,0,867232,False,P18H-A0KA-9467-37C9
Rl1F0RU4CAaKzssHtA,1735484019,Bestwaytocup,5814,5814,-38000,-38000,980,0,285,899732,False,X2K9-5T68-492A-2MX1
MyyJFpZrSIhF-7rWIw,1735469920,2bfit_fitness_club,7941,7941,-70000,-70000,980,0,0,937732,False,20H1-X539-0XET-0M0E
nhqgXgnL1TSGef0Brw,1735462905,2bfit_fitness_club,7941,7941,-70000,-70000,980,0,0,1007732,False,9856-9C90-MKCP-E78P
HbLtX-9LfVxWIRtBpg,1735401500,La Fabrique,5814,5814,-10500,-10500,980,0,78,1077732,False,925H-HXH4-6B89-6BH2
bGQiPVXwbOkWc3OZrA,1735401391,magazin 762597,5912,5912,-9800,-9800,980,0,0,1088232,False,T7XP-M133-TXME-28BX
U6cfvnyERmdB5RjemQ,1735388466,–°—ñ–ª—å–ø–æ,5411,5411,-23700,-23700,980,0,177,1098032,False,7B5B-XA50-3E53-09HA
TnAaqH1HeQFkNLzoeA,1735387827,SALON KRASY BACKSTAGE,7230,7230,-100000,-100000,980,0,0,1121732,False,M268-1EHT-1K0B-AHA3
P871t9zlD8hgs5Kvng,1735375090,Portmone,7011,7011,-7000,-7000,980,0,0,1221732,False,PXP4-9702-20TB-H5X3
XCH4wfZB7l-pSokvsQ,1735368961,ULIS,5812,5812,-50600,-50600,980,0,379,1228732,False,8H2E-HXA5-KX17-T1M5
CbZ871P7llSVLt2WLw,1735301492,WFP.CLOTHIING,5651,5651,-151000,-151000,980,0,0,1279332,False,E0M3-E726-BPAH-650M
RrqA7Gue8YKTaBC1tw,1735296502,ULIS,5812,5812,-18700,-18700,980,0,140,1430332,False,T4EA-7P4C-HK2H-TTE9
4FGdOyTbFIih54-fuA,1735289636,LIQPAY*Pethouse,5995,5995,-104600,-104600,980,0,0,1449032,False,7AK4-X59P-6PB0-2CX1
byLci_9KytkDPpbVmA,1735232975,ULIS,5999,5999,-30000,-30000,980,0,0,1553632,False,H8PK-K5HM-TP2X-T812
JAnwxlaw8xyWntkU6Q,1735231165,EasyPay,5411,5411,-221316,-221316,980,0,1659,1583632,False,A8PX-KCA7-PB5B-EMB4
QAqHpfVzjvAKJLiYmg,1735216048,ULIS,5812,5812,-89500,-89500,980,0,671,1804948,False,AH38-E8PC-3MH8-TBB6
9QcgSNLYHWb4E6zBBw,1735210319,WOG,5541,5541,-149975,-149975,980,0,4499,1894448,False,9B70-82C4-1TC0-1M33
-pSAyp_q2oW8q9Uraw,1735207177,–ü–µ—Ä–µ–∫–∞–∑ –Ω–∞ –∫–∞—Ä—Ç–∫—É,4829,4829,-800000,-800000,980,0,0,2044423,False
XGg70Xw8fN1cMMJmKg,1735206954,CEH,7216,7216,-52910,-52910,980,0,0,2844423,False,M7BK-212B-53EP-B2B8
1qh8L932ev3WZ7LCOg,1735204496,–ù–æ–≤–∞ –ø–æ—à—Ç–∞,7399,7399,-13550,-13550,980,0,0,2897333,False,638P-448B-4E7H-HHXE
YGWxQCTbHwvB0ML-CA,1735204167,–íi–¥: –ü–†–ò–•–û–î–¨–ö–û –ï.–í. –§–û–ü,"–î–ª—è –ø–æ–ø–æ–≤–Ω–µ–Ω–Ω—è –∫–∞—Ä—Ç–∫–∏ 5375414101190360, –ü—Ä–∏—Ö–æ–¥—å–∫–æ –ï—Ä–Ω–µ—Å—Ç –íi–∫—Ç–æ—Ä–æ–≤–∏—á, 3487403339",4829,4829,2200000,2200000,980,0,0,2910883,False
fp3lro9yEriI3S4fig,1735203614,–°—ñ–ª—å–ø–æ,5411,5411,-61400,-61400,980,0,460,710883,False,8X13-X5X0-H68P-E88B
U7Rc0ZlXOjDPq9PliA,1735200426,Best Way To Cup,5814,5814,-126000,-126000,980,0,945,772283,False,6C2X-T6HA-5320-XT14
cfyA4cgc6GwTcAAR1Q,1735199196,Best Way To Cup,5814,5814,-29000,-29000,980,0,217,898283,False,XHKT-41HX-1146-A100
VOB80dXIXWonV0RH9w,1735149274,Steam,5816,5816,-41700,-41700,980,0,0,927283,False,0PE9-396C-PPXE-2MEE
m71AW5m9fCoLQpmXjg,1735134657,OkvajnSichovih,5921,5921,-81000,-81000,980,0,607,968983,False,T1T1-0EP1-8CT4-5E6E
Qr4MvvSWapvcl0bMPA,1735134007,Ukrkhalial,5499,5499,-26937,-26937,980,0,202,1049983,False,6X54-X153-B1A9-P513
D-CndrwwExZYWV-r0A,1735133684,–°—ñ–ª—å–ø–æ,5411,5411,-58048,-58048,980,0,435,1076920,False,85PP-1EA0-5BM8-XTCE
L3WgCu8ZtDR-2CY1PA,1735132606,–°—ñ–ª—å–ø–æ,5411,5411,-154900,-154900,980,0,1161,1134968,False,PMA2-8X38-M05E-3E97
GSe7hqKOBlTgT67pcw,1735132397,2bfit_fitness_club,7941,7941,-140000,-140000,980,0,0,1289868,False,85T0-B9A8-4EBH-M333
rdiCead3CydgNnWD8A,1735122515,KATSURINA,5651,5651,-1565000,-1565000,980,0,0,1429868,False,P771-X267-A97C-13BA
jWaCyTUvjLSbG67ZbQ,1735121157,TSUM,7523,7523,-10000,-10000,980,0,0,2994868,False,EMA2-CX2X-32AT-3CE7
9SIL595jPirSJq5_6g,1735120938,Egersund Seafood,5411,5411,-28710,-28710,980,0,287,3004868,False,M3BA-88T1-E7A8-CB63
DJbBTzrbQWp2KSmbYw,1735062289,Novapay,8999,8999,-8515,-8515,980,0,0,3033578,False,H7E2-23P6-22KX-97E1
9agpmOwM8L2335TMEg,1735062268,Novapay,8999,8999,-10025,-10025,980,0,0,3042093,False,93BE-03X4-E4A1-578C
wvW0V9cCpx_z35sCjw,1735056712,–ù–æ–≤–∞ –ø–æ—à—Ç–∞,7399,7399,-14000,-14000,980,0,0,3052118,False,06B5-1MA8-K9PP-TM2E
-2ZMUhx_Xw9WRIJxCA,1735039921,Novapay,8999,8999,-3000,-3000,980,0,0,3066118,False,C6C4-1T2K-15M6-22A2
juwrRvI222QDXNjlaA,1735038334,–ê–í–†–û–†–ê,5331,5310,-7800,-7800,980,0,78,3069118,False,2PMX-12AC-7C22-3H7E
HHegr5N4VO-d0o8KNA,1735037906,SALON KRASY BACKSTAGE,7230,7230,-75000,-75000,980,0,0,3076918,False,1H02-8X4P-5M60-6B83
rUx4d4-ZWsg3niJSVw,1735028949,Novus,5411,5411,-15597,-15597,980,0,155,3151918,False,XBEE-771E-TBP2-8KTP
qUqJQoIJR0ffehoI4A,1735028354,LayrelLav,8099,8099,-200000,-200000,980,0,0,3167515,False,B2ET-HA7H-TKKH-978X
jDyu8Xzdn__vhZLcZg,1735026185,LIQPAY*Pethouse,5995,5995,-99900,-99900,980,0,0,3367515,False,H1AE-8203-61P7-87EX
osEp42JMnQ-78MAQCw,1735022588,Novapay,8999,8999,-49150,-49150,980,0,0,3467415,False,CCE6-MP64-B9AE-X8E1
KCYTN0qbgvHkt15tIg,1734975683,Novapay,8999,8999,-6451,-6451,980,0,0,3516565,False,HA6H-KCEC-1T1E-MC33
pqHwuPg_uahpNyqrjQ,1734975654,Novapay,8999,8999,-11000,-11000,980,0,0,3523016,False,9B13-CMT2-3HKH-1XP0
cn-PKz-KCKLqDTgpSw,1734974989,LIQPAY*Simona Ristoran,5812,5812,-64000,-64000,980,0,1280,3534016,False,K9BK-E8HC-5435-XTB0
R9cMNfNDL_St7wgimw,1734961282,Uklon,4121,4121,-19000,-19000,980,0,0,3598016,False,A764-2AB5-TPCX-C74X
M7JmhZ1xqoGTDGBIOQ,1734957942,Uklon,4121,4121,-26700,-26700,980,0,0,3617016,False,8K77-80A1-E0H5-34M3
rnBZD-0CqZqy5wChPw,1734951744,ISEI,5977,5977,-43900,-43900,980,0,0,3643716,False,CM6X-246B-B9A1-B9PH
bQ9VtONYVZScMUATMQ,1734951509,Novus,5499,5499,-58098,-58098,980,0,580,3687616,False,9THX-167B-KX7B-4PHP
8qqehUXeWTZHZfNGrw,1734945527,2bfit_fitness_club,7941,7941,-70000,-70000,980,0,0,3745714,False,A410-X4C0-PA6B-HP92
l9W5_Isr8zb4sxx5Zg,1734943290,LIQPAY*Shine Bright,5977,5977,-90200,-90200,980,0,0,3815714,False,0P89-88EA-6MK9-352A
GcxwEFgJkudY9RswaA,1734896577,Wfp.aquamarket,5411,5411,-150110,-150110,980,0,1501,3905914,False,ETT5-T264-2B90-H7T4
tnGOa6ov7HLisDfVrQ,1734880551,–ê–ø—Ç–µ–∫–∞ ¬´–ë–∞–∂–∞—î–º–æ –∑–¥–æ—Ä–æ–≤'—è¬ª,5912,5912,-14530,-14530,980,0,0,4056024,False,BPEX-KXCT-TTC5-7K07
gVgzeMWIvloYAcrr4w,1734879996,MasterZoo,5995,5995,-49976,-49976,980,0,0,4070554,False,KM41-6664-6T51-59CM
_sCqV6j_gm7w49sbfA,1734878567,novorichniprikrasi,5945,5945,-22000,-22000,980,0,0,4120530,False,8ATT-XAXM-6C32-P16K
CSBULuo3Q_tBYUds_w,1734878435,Kitty Ceramic,8299,8299,-40000,-40000,980,0,0,4142530,False,K81C-5159-9T8C-B5HC
O32rvOxSQ3zDdtuwqw,1734875909,–ü–æ–ø–æ–≤–Ω–µ–Ω–Ω—è ¬´puppy¬ª,–ü–æ–ø–æ–≤–Ω–µ–Ω–Ω—è —Ä–∞—Ö—É–Ω–∫—É –±–∞–Ω–∫–∏,4829,4829,-100000,-100000,980,0,0,4182530,False,9EHC-TA26-T405-EEP5
Og6nJaxyuo5mu2L_oQ,1734875895,–ü–æ–ø–æ–≤–Ω–µ–Ω–Ω—è ¬´–ù–∞ —Ç–∫–∞–Ω–∏–Ω—É –¥–ª—è —Å—ñ—Ç–æ–∫¬ª,–ü–æ–ø–æ–≤–Ω–µ–Ω–Ω—è —Ä–∞—Ö—É–Ω–∫—É –±–∞–Ω–∫–∏,4829,4829,-100000,-100000,980,0,0,4282530,False,AK17-EC56-B6E9-291C
gdaWQnomM1HAxxpCGg,1734874722,SHOP TISSUE,5949,5949,-40000,-40000,980,0,0,4382530,False,B7XT-5TTT-289P-75HB
dEA5sgoIlojljjoaVQ,1734861559,Best Way To Cup,5814,5814,-25700,-25700,980,0,514,4422530,False,9H3B-E8CB-861T-705T
QrzOqS2PE0hg5QV0RA,1734858341,Best Way To Cup,5814,5814,-13500,-13500,980,0,270,4448230,False,0914-5MTB-88A5-1HBE
kgGe2B5mU8-mBkR4CA,1734855865,Best Way To Cup,5814,5814,-16700,-16700,980,0,334,4461730,False,TH25-P4PH-BH9T-6M3H
gQY2j1p7nVxg7faLvQ,1734788945,MasterZoo,5995,5995,-88371,-88371,980,0,0,4478430,False,KHA6-XKP0-9TM7-KP2X
ts5WmaQ5l2R5gmE-2g,1734788174,FOP VIKHROVA O.M.,742,742,-85500,-85500,980,0,0,4566801,False,1MTT-760B-33H1-B36T
5bLesQeToiuIEGmk2A,1734781646,–ù–æ–≤–∞ –ø–æ—à—Ç–∞,7399,7399,-10300,-10300,980,0,0,4652301,False,4P3P-235X-15A1-KHBA
d6DvmrrIIMbIjwH5-Q,1734781520,magazin 762597,5912,5912,-18120,-18120,980,0,0,4662601,False,XE38-4A70-E44C-57TA
HoAs6AIkS5HuQXu09g,1734768782,–°–∫–∞—Å—É–≤–∞–Ω–Ω—è. WOG,5541,5541,26849,26849,980,0,-805,4680721,False
vryvcIxy7Ym_5vXBDA,1734768727,WOG,5541,5541,-39900,-39900,980,0,1197,4653872,False,XBBX-9CBH-75TT-9B59
TpSgC8N3DWyqz_77zQ,1734768618,WOG,5541,5541,-231960,-231960,980,0,6958,4693772,False
JXfrspFLPBTMFGLCKg,1734767092,Best Way To Cup,5814,5814,-20500,-20500,980,0,410,4925732,False,P31A-48TX-64KP-3639
83ePNxmGSDp-dTDSlQ,1734761486,–ö–∏—ó–≤ –¶–∏—Ñ—Ä–æ–≤–∏–π,9222,9222,-36750,-36750,980,0,0,4946232,False,E6XT-T3AP-9747-P5C8
0N31Sx3tYiBcWiS5Mg,1734717830,–ü–æ–ø–æ–≤–Ω–µ–Ω–Ω—è ¬´–ù–∞ —Ç–µ–ø–ª–∏–π –¥—Ä–æ–Ω¬ª,–ü–æ–ø–æ–≤–Ω–µ–Ω–Ω—è —Ä–∞—Ö—É–Ω–∫—É –±–∞–Ω–∫–∏,4829,4829,-1850000,-1850000,980,0,0,4982982,False,E8MC-8021-18TT-8HP4
0hoDYy5xx8x6ViRQxQ,1734697547,–ü–æ–ø–æ–≤–Ω–µ–Ω–Ω—è ¬´puppy¬ª,–ü–æ–ø–æ–≤–Ω–µ–Ω–Ω—è —Ä–∞—Ö—É–Ω–∫—É –±–∞–Ω–∫–∏,4829,4829,-200000,-200000,980,0,0,6832982,False,0KH1-1E13-M05C-HK1M
je2KIDlHmC6hRR1yvA,1734697345,Best Way To Cup,5814,5814,-17000,-17000,980,0,340,7032982,False,3P12-3HH5-HK54-C6BP
nIejd4xSnJvDjk4nzg,1734697173,OK Wine,5411,5411,-49500,-49500,980,0,495,7049982,False,HM57-X6P5-A6MC-8EXC
UmnFGTfRT3W5tHQecQ,1734696887,Pekarnia KhliBar,5462,5462,-6500,-6500,980,0,65,7099482,False,1PX3-0B9B-776H-AMXT
5smTvSTM0O2b97mdaw,1734692122,–íi–¥: –ü–†–ò–•–û–î–¨–ö–û –ï.–í. –§–û–ü,"–î–ª—è –ø–æ–ø–æ–≤–Ω–µ–Ω–Ω—è –∫–∞—Ä—Ç–∫–∏ 5375414101190360, –ü—Ä–∏—Ö–æ–¥—å–∫–æ –ï—Ä–Ω–µ—Å—Ç –íi–∫—Ç–æ—Ä–æ–≤–∏—á, 3487403339",4829,4829,7000000,7000000,980,0,0,7105982,False
j85m3LVMHAytWwa9Sw,1734689105,2bfit_fitness_club,7941,7941,-100000,-100000,980,0,0,105982,False,9TA6-B0HP-4P33-AHM6
NI7VH-OphbjE-i3R1Q,1734685264,–ó –±—ñ–ª–æ—ó –∫–∞—Ä—Ç–∫–∏,4829,4829,100000,100000,980,0,0,205982,False
iHG8Bv0hIjwLRRYX_A,1734680562,Novapay,8999,8999,-10250,-10250,980,0,0,105982,False,002H-8T4A-TXTE-03KM
sZ1Uv_E7kW10_cLMpQ,1734650472,Steam,5816,5816,-61295,-60900,980,0,0,116232,False,A974-9P3K-H327-KPX3
jYu6I_wNVnFntxVvKw,1734649084,RPAY*Prom Service,4215,4215,-1099,-1099,980,0,0,177527,False,2K1P-04B6-E6C7-E373
IunHVHswopMw7z13xA,1734649076,RPAY*BUSINESS,5399,5399,-59900,-59900,980,0,449,178626,False,8A0X-X7E5-30AE-T4MX
jbBqnq-gJ0btPmR_kg,1734634774,Vodafone,4814,4814,-20000,-20000,980,0,0,238526,False,70AP-B2P3-AMKB-0XTM
1RpXvMIoJFTqf0EesQ,1734620691,LIQPAY*Pethouse,5995,5995,-216000,-216000,980,0,0,258526,False,6279-144E-30T5-589E
pKNlJ_t-YwYYZqC8xg,1734620612,–ó –±—ñ–ª–æ—ó –∫–∞—Ä—Ç–∫–∏,4829,4829,400000,400000,980,0,0,474526,False
9zAPXnKP4fT5XHCDnA,1734599157,Best Way To Cup,5814,5814,-46600,-46600,980,0,349,74526,False,5HEA-KH3C-BPE2-XCT6
qwBj0DRT99FfRr0XhA,1734595642,Novapay,8999,8999,-8646,-8646,980,0,0,121126,False,A3HH-4TX3-HXHK-BXAM
Do_gogD7dLm1W-8m7Q,1734526254,Steam,5816,5816,-14800,-14800,980,0,0,129772,False,KMKM-T25E-KK5M-ABTA
lH9gB1uWenocyLpfQQ,1734515161,–°—ñ–ª—å–ø–æ,5411,5411,-18100,-18100,980,0,135,144572,False,K1H3-8T47-0XPC-XP49
fFtUqvzFq63LT8XBKA,1734512931,2bfit_fitness_club,7941,7941,-100000,-100000,980,0,0,162672,False,C16X-23M2-X5PP-26KC
_uFRsIjBX4pkyYRhew,1734508037,"Lifecell
+380631692598",4814,4814,-26000,-26000,980,0,0,262672,False,2A11-7M86-534P-9M58
w4cIflUXF3070H07rA,1734429794,Tkanini,5949,5949,-36000,-36000,980,0,0,288672,False,T92P-K4A9-C4T8-1XA4
em5q0eRqXKTNp7V3NQ,1734428926,Novapay,8999,8999,-6000,-6000,980,0,0,324672,False,1421-42H5-HC7T-T1CA
d2IxYDQjAmWKy-_Yuw,1734424603,Novus,5411,5411,-7498,-7498,980,0,56,330672,False,0E28-7PT6-8XHK-6XE4
__VtBlClIi-hp-HXVg,1734423664,–ó –±—ñ–ª–æ—ó –∫–∞—Ä—Ç–∫–∏,4829,4829,250000,250000,980,0,0,338170,False
M_ZkDgbu3XJKy-rikA,1734421393,Kaviarnia Peremoga,5814,5814,-9000,-9000,980,0,67,88170,False,KKPP-5T1M-8H04-K33P
63PaPBtY5oU9fL6Bpw,1734419322,Cafe 128|2,5812,5812,-41500,-41500,980,0,311,97170,False,T936-9ATC-08BM-E80A
Y48UbzN8THC4Pw4Wxw,1734418676,Bolt,4121,4121,-13300,-13300,980,0,0,138670,False,TCXP-HP04-BKXM-K4A0
-qHxaj6BjzfSyommyQ,1734344748,RESTORAN LiPA,5814,5814,-8000,-8000,980,0,60,151970,False,C53M-15HK-HHMA-EC2B
qVJR3J8lmrkiXZtEoQ,1734341124,Ukrkhalial,5499,5499,-72817,-72817,980,0,546,159970,False,3XTC-H8C1-1H8A-648X
PQdkDAeGEACdCO5v-Q,1734340876,–°—ñ–ª—å–ø–æ,5411,5411,-32600,-32600,980,0,244,232787,False,EXMA-7PC2-753K-K11P
Fww8lczCGF7CiBxB2g,1734339210,Fitnes klub 2BFIT,7941,7941,-100000,-100000,980,0,0,265387,False,126X-144A-1B3B-T6E8
iPNU1YqEaWWz1sTfQA,1734334278,–ó –±—ñ–ª–æ—ó –∫–∞—Ä—Ç–∫–∏,4829,4829,300000,300000,980,0,0,365387,False
Hg-Ek5UsMi4ZetTMaA,1734277535,EasyPay,5411,5411,-320452,-320452,980,0,2403,65387,False,BA01-39EX-P7TP-PK30
TGsuSajS5VONtZ1HsQ,1734264376,MagazinkafeteriyKashtan,5499,5499,-6440,-6440,980,0,48,385839,False,HHA2-5P08-X054-6119
B9aUgxxapIs_R3OTmA,1734263108,Novus,5411,5411,-70397,-70397,980,0,527,392279,False,04K9-CBB2-4B1P-CX89
QaVqs0VBnegxDCCFqw,1734259849,Underwood Boutique,5921,5921,-45400,-45400,980,0,340,462676,False,AA29-X2B1-3BEP-P3EM
6JLfA5Bynj4VpJU3wQ,1734253750,Steam,5816,5816,-39000,-39000,980,0,0,508076,False,H45K-B236-3M18-9MHH
i76gBlEPm26G2z3ZzQ,1734192550,–°—ñ–ª—å–ø–æ,5411,5411,-137500,-137500,980,0,1031,547076,False,6494-7A51-9828-CKP1
-JvKPSGcC2bKntwYlQ,1734186095,Novapay,8999,8999,-6650,-6650,980,0,0,684576,False,KXC4-9XPC-H66E-6E54
oIfogyEyR8kApsm8TQ,1734185084,–û–ø–ª–∞—Ç–∞ —É —Å–ø–µ—Ü—ñ–∞–ª—ñ–∑–æ–≤–∞–Ω–∏—Ö –º–∞–≥–∞–∑–∏–Ω–∞—Ö wayforpay,5977,5977,-90000,-90000,980,0,0,691226,False,2CM8-8A1M-TKP5-60CB
DdNoIIxnhzIkEpkkmA,1734178448,–§–æ—Ä–∞,5411,5411,-16180,-16180,980,0,121,781226,False,X543-2807-CMBC-H2A3
ftktM5MNrJ6JQ359Jg,1734178013,Uklon,4121,4121,-16600,-16600,980,0,0,797406,False,34MB-P699-T5K9-KXME
5z30BP5n5DluwKGx3A,1734166362,Best Way To Cup,5814,5814,-38000,-38000,980,0,285,814006,False,3X5E-010P-9B75-BT42
VvOsmx382zqrrqxplA,1734107316,OK Wine,5411,5411,-59800,-59800,980,0,448,852006,False,B7A6-MCXB-EHEX-8CXB
vTO6d-R_SAM4HYBYZg,1734106426,–ê–ú bistro,5812,5812,-206400,-206400,980,0,1548,911806,False,0PHK-177H-4KBH-B2C1
qs29DuxwkfLmIE1z-A,1734089284,100 —Ä–æ–∫—ñ–≤ —Ç–æ–º—É –≤–ø–µ—Ä–µ–¥,5812,5812,-53400,-53400,980,0,400,1118206,False,5T95-60EC-050A-9E24
TXHaVLr2PGiNy4eIaA,1734084234,Fitnes klub 2BFIT,7941,7941,-100000,-100000,980,0,0,1171606,False,CKB9-60E9-4E81-2XCC
3-7ArIUZxSvfgyM-Ig,1734027136,TSUM,7523,7523,-30000,-30000,980,0,0,1271606,False,38HM-9C02-H8TE-274X
6AMAA2-P1WhNLclMfw,1734025964,Ponchyk Boy | –û–ª–µ—Å—è –ì–æ–Ω—á–∞—Ä–∞,5812,5812,-10500,-10500,980,0,78,1301606,False,5P04-P867-K3XP-9E65
YrcUBjIN4Zga8Todcg,1733990964,Novus,5411,5411,-58736,-58736,980,0,440,1312106,False,AB91-EB5X-71P2-XA7E
C1JbjLIIUgxyk-5umw,1733990194,Prostor,5977,5977,-23200,-23200,980,0,0,1370842,False,17TE-E7C3-9366-MCBC
90vUFo6MjBfSuFK5ew,1733931485,–ê–ù–¶,5912,5912,-5190,-5190,980,0,0,1394042,False,C7TP-CB77-2M75-A6X5
XqBOEZ34NPOFrMNXbw,1733931358,KAFE TITKA KLARA,5814,5814,-26500,-26500,980,0,198,1399232,False,PBX7-A149-193P-8687
iDdOU0f_LGmROVupLg,1733928705,–û—Ñ—ñ—Å-—á–∞–π,5812,5812,-32600,-32600,980,0,244,1425732,False,6E1T-63CP-27AE-7KX9
QEAm7ZiqLxjfN6kgGQ,1733925981,Wfp.aquamarket,5499,5499,-97910,-97910,980,0,734,1458332,False,0828-HPKE-14T4-96B7
fArqISush9qnppgpTg,1733922964,Novapay,8999,8999,-6649,-6649,980,0,0,1556242,False,X7CT-AC05-3E34-MA2M
AcSs7agKAb95G-adEA,1733910362,LIQPAY*Pethouse,5995,5995,-143900,-143900,980,0,0,1562891,False,2PB2-0298-7E6E-3KEE
Itc7FKLMp3PbCZD__A,1733908867,–ù–æ–≤–∞ –ø–æ—à—Ç–∞,7399,7399,-8800,-8800,980,0,0,1706791,False,AKT9-1BXC-7TP9-28AE
9g9pUyXf4mHG0HnBJA,1733907746,Fitnes klub 2BFIT,7941,7941,-100000,-100000,980,0,0,1715591,False,HTC6-C483-6C44-6KC8
S7TwL86PW_NXHjWkBg,1733906653,"Lifecell
+380731983817",4814,4814,-10000,-10000,980,0,0,1815591,False,4797-H1PK-9M36-2XAX
AapGVJv7Cbo47QKrtw,1733904143,–§–û–ü –§—ñ—Ç–æ—Ü–µ–Ω—Ç—Ä Foodok ( –ë–∞—à–∏–Ω—Å—å–∫–∞ –ê–Ω–∞—Å—Ç–∞—Å—ñ—è),4829,4829,-132294,-132294,980,2594,0,1825591,False,A4KE-795H-T675-XH6T
RqKmmvL5oSLyiX_eJA,1733903410,Fitnes klub 2BFIT,7941,7941,-139900,-139900,980,0,0,1957885,False,6TA0-1K86-PH0P-6525
BJ1wp5bpHBpQz1z0RQ,1733900905,Novapay,8999,8999,-8858,-8858,980,0,0,2097785,False,H6PC-TX9E-M443-2T8P
cAIM6kqLIqQaJT5gmw,1733835546,–°—ñ–ª—å–ø–æ,5411,5411,-23300,-23300,980,0,233,2106643,False,3P6P-165X-37MX-PEA9
zHDB37CZNGm36aaxRg,1733833536,Novus,5411,5411,-21647,-21647,980,0,216,2129943,False,5H49-T1X6-7TM5-A9H4
jGyxvULiPxVZoFr5DA,1733833182,magazin Biotus,5499,5499,-93100,-93100,980,0,931,2151590,False,3C56-E60H-166C-1CH8
9v_9pHLk_sFm8NOnkw,1733824890,WFP.ELECTRON,5732,5732,-171600,-171600,980,0,0,2244690,False,1HAT-C577-CTAB-K0AC
yXS8fd8xRczTouAEYA,1733820371,Best Way To Cup,5814,5814,-22000,-22000,980,0,440,2416290,False,0A8B-KETA-7110-MH75
7-HJOi_NaapSMXoHNw,1733817952,Best Way To Cup,5814,5814,-8500,-8500,980,0,170,2438290,False,KP2M-96H3-X592-71B5
vEV382i96fujPnSj0Id9KQ,1733794034,"LIQPAY*FOOD SPOT CORP.,BORISPIL,UA",5812,5812,-114905,-114905,980,0,2298,2446790,True
dTNhIBGapX0O3bXT3an42UJ_-e0,1733794034,–°–∫–∞—Å—É–≤–∞–Ω–Ω—è. LIQPAY*Food Spot Corp.,5812,5812,128205,128205,980,0,-2564,2561695,False
SGpE0cL9gI-FGJkoKg,1733766207,–ü–µ—Ä–µ–∫–∞–∑ –Ω–∞ –∫–∞—Ä—Ç–∫—É,4829,4829,-900000,-900000,980,0,0,2433490,False
qzQSfCGIfoR_rQWuAQ,1733743725,Parkomat,7523,7523,-16000,-16000,980,0,0,3333490,False,0800-9PT8-K935-06MM
M3p-BbHHy0ImDXA8lw,1733736524,OK Wine,5921,5921,-2550,-2550,980,0,25,3349490,False,0AE6-PK0M-2444-MTA1
Ghm-I3eZ7Md4DoOzew,1733736210,Novapay,8999,8999,-6000,-6000,980,0,0,3352040,False,B9H0-7CTA-146P-B6X1
YRaMQYu5pVT82T4hTA,1733736157,Novapay,8999,8999,-8440,-8440,980,0,0,3358040,False,AM69-PE48-3A95-1P42
o5ngB1lqMZ8VZx8uKQ,1733734642,Fitnes klub 2BFIT,7941,7941,-100000,-100000,980,0,0,3366480,False,K513-822E-P0B8-8X60
2uYDTgqO8CaPPICOsA,1733666863,WOG,5541,5541,-202965,-202965,980,0,6088,3466480,False,5579-3PE3-272M-5A37
RriIBsrEnl3BvSg80A,1733666174,Tkanini,5949,5949,-5900,-5900,980,0,0,3669445,False,H94K-E08M-H76B-5M96
-mgZgmH9IoZUuh2TVQ,1733664115,MegaMarket,5411,5411,-6300,-6300,980,0,63,3675345,False,64HM-EBEE-02BA-HPE9
sLwrQwSDbp-jF1n8oQ,1733658889,Octo,5812,5812,-48400,-48400,980,0,968,3681645,False,4406-22E6-K39C-7ACA
QlmKuzOn_6hyvcQIrw,1733655919,REMI,5812,5812,-87500,-87500,980,0,1750,3730045,False,344X-7C7B-42M1-X1B1
iGsfc8agHjQVDEoQtw,1733601810,Konteiner,5814,5814,-70500,-70500,980,0,1410,3817545,False,90PB-5HP0-TX2B-MCK2
I8yOZe0D045s4xKOPw,1733595904,LIQPAY*Food Spot Corp.,5812,5812,-128205,-128205,980,0,2564,3888045,False
hAntBQfCKBFYwNjglg,1733586358,KNYHARNIA SENS,5942,5942,-37500,-37500,980,0,0,4016250,False,E087-CXCM-T2HA-C6K5
-AGYiiM8TaXKIg0eBg,1733583885,Art knyharnia Misto,5942,5942,-34500,-34500,980,0,0,4053750,False,EXC0-9505-6M48-6X4C
2Kjh6mLt3RGBQ1j9jw,1733583766,Konteiner,5814,5814,-33000,-33000,980,0,660,4088250,False,81BE-2684-348T-PC91
-TKng2JStD6u_1OQbg,1733508282,Novapay,8999,8999,-100,-100,980,0,0,4121250,False,CH20-T9E0-B7EP-0KC1
Eql7m48-70M5YkwA5g,1733502148,PRTMN HOTELS W,7011,7011,-159000,-159000,980,0,0,4121350,False,H6E4-BHX7-63PM-E6A5
e-P2f7rlHJiI9VBtiQ,1733501878,–°—ñ–ª—å–ø–æ,5411,5411,-83600,-83600,980,0,836,4280350,False,42B5-M01H-PA08-AMB5
J_bFmz5YAqYvkkxjZA,1733474673,FOP Shevchenko,5499,5499,-10000,-10000,980,0,100,4363950,False,X0P0-55CA-1MAH-XPBE
uMHyDeadDWER7pf2Sw,1733472813,Best Way To Cup,5814,5814,-40000,-40000,980,0,800,4373950,False,KM6H-6CT5-H9C5-AMEX
ykf_XPhP2IHAbg2RbA,1733392692,Best Way To Cup,5814,5814,-10000,-10000,980,0,200,4413950,False,P36P-APTE-A3XE-605B
csYtv8dCF_awFefHOQ,1733388197,516936****5271,4829,4829,-37800,-37800,980,0,0,4423950,False,ET7C-8792-E495-1M3H
Ddi6IHh5G6Yx1apXpw,1733348738,Novapay,8999,8999,-100,-100,980,0,0,4461750,False,7H34-P4CE-2TXP-PBT3
27zyV-tN5mvtQKo8eA,1733336162,TUTMARKET,5499,5499,-9500,-9500,980,0,95,4461850,False,721C-E0X1-70HE-H831
KagsBnRJBVCUn1x8Qg,1733325198,PRODUKTI,5499,5499,-4142,-4142,980,0,41,4471350,False,TXP5-H85T-BB13-XTCM
A9BKD9WZ2qJZFjc-bA,1733319008,PUREJEWELRYSTUDIO,5944,5944,-350000,-350000,980,0,0,4475492,False,A619-02CA-EPKH-PT88
r3Ejk4U28XTMe9kz-A,1733318663,bibliotheque-de-parf1,5977,5977,-88000,-88000,980,0,0,4825492,False,B07T-60AM-T791-873X
SL8Fj79mUBMSPSAELg,1733318383,CRUMB.UKRAINE,5977,5977,-130000,-130000,980,0,0,4913492,False,B222-60TH-1CH0-6PM5
lb92m0N_bE_aLRAyew,1733317891,LIQPAY*VSL,5942,5942,-53100,-53100,980,0,0,5043492,False,9CT3-949A-574P-M488
QjT3h706OOeDBonVHQ,1733317746,Portmone,5942,5942,-35500,-35500,980,0,0,5096592,False,A481-4920-91TA-H3M6
NY6mB8MbM6OLcp9nYQ,1733317498,–íi–¥: –ü–†–ò–•–û–î–¨–ö–û –ï.–í. –§–û–ü,"–î–ª—è –ø–æ–ø–æ–≤–Ω–µ–Ω–Ω—è –∫–∞—Ä—Ç–∫–∏ 5375414101190360, –ü—Ä–∏—Ö–æ–¥—å–∫–æ –ï—Ä–Ω–µ—Å—Ç –íi–∫—Ç–æ—Ä–æ–≤–∏—á, 3487403339",4829,4829,5000000,5000000,980,0,0,5132092,False
ppi5YE_lkKdJJLPR7w,1733317477,Steam,5816,5816,-105796,-104900,980,0,0,132092,False,9M8H-XXX0-3XPP-42T9
7UzXQ1HDIgxHtB9OWw,1733312236,–ú—ñ—Å—å–∫–µ –∫–∞—Ñ–µ –•–∞—Ä–º—Å,5812,5812,-8000,-8000,980,0,60,237888,False,26HB-HAT3-6X3M-08X5
_8ugyPy0fFLJXERj3A,1733304650,Ukrkhalial,5499,5499,-37620,-37620,980,0,282,245888,False,9MB9-H9T0-HXM0-B003
IAPoOaNbrDH3yyySkQ,1733304350,Urbanisty cafe,5812,5812,-10500,-10500,980,0,78,283508,False,2C24-HC8E-TXMA-EK6A
X7LR_k-RSy-3D6EEZw,1733303343,Fitnes klub 2BFIT,7941,7941,-100000,-100000,980,0,0,294008,False,XMT9-5T57-764B-C5P7
__r-rMPWVxSWTBSQww,1733251654,–°—ñ–ª—å–ø–æ,5411,5411,-135100,-135100,980,0,1013,394008,False,TMP0-KPX6-CE39-3CB8
a3S_zMsouQJfYuBu9Q,1733251322,–°—ñ–ª—å–ø–æ,5411,5411,-188398,-188398,980,0,1412,529108,False,5C7K-T91E-8BXT-E3BE
a0m3p-KuGMz4b6OB9Q,1733248810,Underwood Boutique,5921,5921,-48600,-48600,980,0,364,717506,False,4X46-60X7-7X45-3H6P
1j7zVreLAVW2zpmUGA,1733248053,PapaFeta,5812,5812,-118600,-118600,980,0,889,766106,False,AXAX-PCXC-T484-5B4K
VboWj5c6wQVrPiWrDQ,1733245695,–°—ñ–ª—å–ø–æ,5411,5411,-9300,-9300,980,0,69,884706,False,EK2E-KH16-838E-M9A9
cNPKGeGMcHEhj94oGA,1733239048,Novapay,8999,8999,-8460,-8460,980,0,0,894006,False,EB1T-P882-MH1M-B547
VqJ-hVpzLwhPOFsQkQ,1733239043,Novapay,8999,8999,-95738,-95738,980,0,0,902466,False,BX9E-B768-TM81-B4EK
WzjEWLHV_wUta7mz6w,1733238997,Novapay,8999,8999,-11260,-11260,980,0,0,998204,False,919B-MAMT-52PB-MKX7
r2j6QhtRuS_F1wtCPw,1733237827,Novapay,8999,8999,-7000,-7000,980,0,0,1009464,False,9T71-AK69-A349-KMKB
6by9eJrp400L6pt6DA,1733231362,EasyPay,5411,5411,-407542,-407542,980,0,3056,1016464,False,C7MM-5591-HA8A-KB39
TCl9oAIpJaFqC01YpA,1733222530,BARMAGAZiN,5814,5814,-67000,-67000,980,0,502,1424006,False,M52P-6KPH-A1H4-690T
LkoKgdPi0AgEcS2GGA,1733220701,Best Way To Cup,5814,5814,-47600,-47600,980,0,357,1491006,False,HTPA-P585-CAE7-XTC4
z9xbaiRprcaOwMcqUA,1733220163,Bahetna maisternia,8999,8999,-33500,-33500,980,0,0,1538606,False,B5TM-174A-88P9-M6P8
uQAGIJ39PGsEuyUYPw,1733219028,–§–ö –ï–í–û,5399,5399,-144900,-144900,980,0,1086,1572106,False,0749-1M61-9P2M-9M5E
8pDL6X2u7YIfx_sxQg,1733218788,Vigotovlennyaklyuchiv,8999,8999,-15000,-15000,980,0,0,1717006,False,MH55-P28K-28H4-9KCX
RxbysCTGpSsF8UtPhg,1733212709,LIQPAY*FOP Chernishova,5719,5719,-129200,-129200,980,0,0,1732006,False,CMBC-0TA7-EHT3-17EP
FU5Ks_kYh9iJc4s8eQ,1733212610,LIQPAY*ESTELAJN TOV,5533,5533,-293650,-293650,980,0,0,1861206,False,H6HX-H8EA-BC0B-PAC1
FqxmPWRpc_Oe72Ka5Q,1733206641,–ü–µ—Ä–µ–∫–∞–∑ –Ω–∞ –∫–∞—Ä—Ç–∫—É,4829,4829,-900000,-900000,980,0,0,2154856,False
QngfiS8ohoEOH8hHCg,1733174982,–°–∫–∞—Å—É–≤–∞–Ω–Ω—è. FOP Ivanin Yu.L.,5621,5621,256000,256000,980,0,0,3054856,False
SA2Vgi707J6gN-dQxQ,1733172649,FOP Ivanin Yu.L.,5621,5621,-256000,-256000,980,0,0,2798856,False
QYpjsptYjKTdg6P9Ug,1733170083,LIQPAY*Pethouse,5995,5995,-182900,-182900,980,0,0,3054856,False,HT85-P404-E560-391T
CpgK3ciBmiOAWYGDiQ,1733168522,Wfp.aquamarket,5499,5499,-108110,-108110,980,0,1081,3237756,False,MCE5-CP04-3A9C-3CX4
jdsh9NC42B5g8FJglA,1733167225,AS PODIL,7523,7523,-5000,-5000,980,0,0,3345866,False,456C-9A41-X1BP-18CX
nQfjo7zhsT6oaVDqoQ,1733167000,Cafe 128|4,5812,5812,-97900,-97900,980,0,1958,3350866,False,98TM-EC74-40KA-0H5X
L13e-1WSRcd8_o-96g,1733164053,–°—ñ–ª—å–ø–æ,5411,5411,-109217,-109217,980,0,1092,3448766,False,2A92-BK3T-6CCB-XB26
fzT8WdNZKb2B0GSWqg,1733160276,Novapay,8999,8999,-9570,-9570,980,0,0,3557983,False,3P6M-4724-62X0-8EB3
oLc6dutgytBprkDa3w,1733157316,–ü–æ–ø–æ–≤–Ω–µ–Ω–Ω—è ¬´Autel EVO Max 4N –¥–ª—è 138 –±–∞—Ç–∞–ª—å–æ–π–æ–Ω—É –¢–†–û¬ª,8398,8398,-100000,-100000,980,0,0,3567553,False,0K9X-BEH5-013E-HH75
JA9KTWpfDiT6YfXPew,1733139473,PRTMN HOTELS W,7011,7011,-1135200,-1135200,980,0,0,3667553,False,9B2A-H99C-74EP-05C3
UrKKEU9uGfntHDl5dA,1733139374,–ü–æ–ø–æ–≤–Ω–µ–Ω–Ω—è ¬´–ü–¢–ê–•–û–ó–ë–Ü–† 2.0¬ª,–ü–æ–ø–æ–≤–Ω–µ–Ω–Ω—è —Ä–∞—Ö—É–Ω–∫—É –±–∞–Ω–∫–∏,4829,4829,-75000,-75000,980,0,0,4802753,False,0B86-3HMA-A875-B7T4
kU8sC43G1QviLl76yg,1733139352,–ü–æ–ø–æ–≤–Ω–µ–Ω–Ω—è ¬´puppy¬ª,–ü–æ–ø–æ–≤–Ω–µ–Ω–Ω—è —Ä–∞—Ö—É–Ω–∫—É –±–∞–Ω–∫–∏,4829,4829,-150000,-150000,980,0,0,4877753,False,0MC1-B877-7P3C-MB5P
gdsUaz0nGTV7tW9QHQ,1733135878,–íi–¥: –ü–†–ò–•–û–î–¨–ö–û –ï.–í. –§–û–ü,"–î–ª—è –ø–æ–ø–æ–≤–Ω–µ–Ω–Ω—è –∫–∞—Ä—Ç–∫–∏ 5375414101190360, –ü—Ä–∏—Ö–æ–¥—å–∫–æ –ï—Ä–Ω–µ—Å—Ç –íi–∫—Ç–æ—Ä–æ–≤–∏—á, 3487403339",4829,4829,5000000,5000000,980,0,0,5027753,False
EJ3g8EsTg8Do0NRJvQ,1733064319,FRUTTA,5499,5499,-55200,-55200,980,0,0,27753,False,XTAM-5147-PABA-0P53
ksU-dpxWovxzH4WyTQ,1733062823,–°—ñ–ª—å–ø–æ,5411,5411,-160200,-160200,980,0,0,82953,False,P0BE-9A13-0H9M-097H
0cvvAmTXfl9guHM4ag,1733062130,A2068,5912,5912,-3150,-3150,980,0,0,243153,False,4HP2-8788-5C0B-H3P7
iJJtCnRXcbomd2HFEA,1733061442,Simona,5812,5812,-134900,-134900,980,0,0,246303,False,9X21-C6M4-07X6-28H7
tsZYIBhNR44BVfS4mg,1733050194,Chizkeik Femel,5814,5814,-25500,-25500,980,0,0,381203,False,783H-X6CC-EH04-HE9X
jbnZoOIAj4-e7VKzkA,1733046120,Tkanini,5949,5949,-90000,-90000,980,0,0,406703,False,H8EC-6B52-9B17-1P6M
DnbgU9FsUZumM_Lglw,1733046030,Tkanini,5949,5949,-3800,-3800,980,0,0,496703,False,PTM9-83MM-HB50-4C1M
V6HRsVcOFFpX9lGVqw,1735442905,–†–µ–≥—É–ª—è—Ä–Ω–µ –ø–æ–ø–æ–≤–Ω–µ–Ω–Ω—è ¬´–§–æ–Ω–¥ –ü–æ–≤–µ—Ä–Ω–∏—Å—å –∂–∏–≤–∏–º¬ª,4829,4829,-25000,-25000,980,0,0,316877,False,3C9P-XX7M-BAPB-3370
swNCebQpkfkl4sScYA,1735372077,536354****2868,4829,4829,-1190000,-1190000,980,0,0,341877,False,0A17-67CB-A5TB-M47M
shdjR0GfEdJZLGtAPg,1735370217,–í—ñ–¥: –û–ª–µ—Å—è –°–∞—á–µ–Ω–∫–æ,4829,4829,500000,500000,980,0,0,1531877,False
8gL2z82tLkrFm7viZw,1735207222,–ü–æ–ø–æ–≤–Ω–µ–Ω–Ω—è ¬´puppy¬ª,–ü–æ–ø–æ–≤–Ω–µ–Ω–Ω—è —Ä–∞—Ö—É–Ω–∫—É –±–∞–Ω–∫–∏,4829,4829,-50000,-50000,980,0,0,1031877,False,P08K-75HH-0CKK-B1X6
WmensQJQ3f__XVdMPQ,1735207177,–ó —á–æ—Ä–Ω–æ—ó –∫–∞—Ä—Ç–∫–∏,4829,4829,800000,800000,980,0,0,1081877,False
RYRalocbbeQ1ENcTBA,1734880834,–í—ñ–¥: –û–ª–µ—Å—è –°–∞—á–µ–Ω–∫–æ,4829,4829,70000,70000,980,0,0,281877,False
OSb979hLJvDrP0fgvQ,1734838175,–†–µ–≥—É–ª—è—Ä–Ω–µ –ø–æ–ø–æ–≤–Ω–µ–Ω–Ω—è ¬´–§–æ–Ω–¥ –ü–æ–≤–µ—Ä–Ω–∏—Å—å –∂–∏–≤–∏–º¬ª,4829,4829,-25000,-25000,980,0,0,211877,False,B6K6-E432-P53X-5P8T
J_3CVYcPXoUBLHbHNA,1734696211,—è–π—Ü—è –º–µ–¥,4829,4829,-11111,-11111,980,0,0,236877,False,40H5-5K9H-0229-M92C
ZNsA_OHWspC7Or5UXQ,1734685264,–ü–µ—Ä–µ–∫–∞–∑ –Ω–∞ –∫–∞—Ä—Ç–∫—É,4829,4829,-100000,-100000,980,0,0,247988,False
VGCCdz-2pIlasLbztw,1734620612,–ü–µ—Ä–µ–∫–∞–∑ –Ω–∞ –∫–∞—Ä—Ç–∫—É,4829,4829,-400000,-400000,980,0,0,347988,False
DnNTkigavT7JyBmMgQ,1734423664,–ü–µ—Ä–µ–∫–∞–∑ –Ω–∞ –∫–∞—Ä—Ç–∫—É,4829,4829,-250000,-250000,980,0,0,747988,False
I--vTi6DkOuyKjHnNg,1734353284,–ü–æ–ø–æ–≤–Ω–µ–Ω–Ω—è ¬´–ù–∞ –ª—ñ–∫—É–≤–∞–Ω–Ω—è –î–æ—Ü—ñ ‚ù§Ô∏è‚Äçü©π¬ª,–ü–æ–ø–æ–≤–Ω–µ–Ω–Ω—è —Ä–∞—Ö—É–Ω–∫—É –±–∞–Ω–∫–∏,4829,4829,-50000,-50000,980,0,0,997988,False,P8M3-6TM5-MXB7-C106
_SIeTRcp4pdH3OCT4Q,1734334278,–ü–µ—Ä–µ–∫–∞–∑ –Ω–∞ –∫–∞—Ä—Ç–∫—É,4829,4829,-300000,-300000,980,0,0,1047988,False
9uGV9d5gJlF7NMSSuA,1734233587,–†–µ–≥—É–ª—è—Ä–Ω–µ –ø–æ–ø–æ–≤–Ω–µ–Ω–Ω—è ¬´–§–æ–Ω–¥ –ü–æ–≤–µ—Ä–Ω–∏—Å—å –∂–∏–≤–∏–º¬ª,4829,4829,-25000,-25000,980,0,0,1347988,False,T1KP-8T3B-633C-C667
R7a0FxvSdP0NT1rwAw,1734078784,—è–π—Ü—è –º–µ–¥,4829,4829,-11055,-11055,980,0,0,1372988,False,5C39-26B8-4MT8-617X
L1UyNc2PuHm6J5Niug,1734026896,–õ—ñ–ª—ñ—è –ö.,4829,4829,-115000,-115000,980,0,0,1384043,False,X2P0-E4H9-KXMM-H3C0
WVvAjFQk9dwEb_CL5g,1734004159,–ü–æ–ø–æ–≤–Ω–µ–Ω–Ω—è ¬´–î–Ω—é—Ö–∞ 24 –ü–æ–¥–∞—Ä—É–Ω–æ–∫:)¬ª,–ü–æ–ø–æ–≤–Ω–µ–Ω–Ω—è —Ä–∞—Ö—É–Ω–∫—É –±–∞–Ω–∫–∏,4829,4829,-200000,-200000,980,0,0,1499043,False,XTTP-18H2-87M8-HH87
QbVH1QPcKfsRjXRyQw,1733818610,431414****7562,4829,4829,-150000,-150000,980,0,0,1699043,False,XBK9-B7H1-AEM9-T69T
370bNFQY6Um3itiGOQ,1733766207,–ó —á–æ—Ä–Ω–æ—ó –∫–∞—Ä—Ç–∫–∏,4829,4829,900000,900000,980,0,0,1849043,False
FXHRDC2ldKQn6BdoeQ,1733766185,Ponchyk Boy | –û–ª–µ—Å—è –ì–æ–Ω—á–∞—Ä–∞,5812,5812,-27100,-27100,980,0,542,949043,False,TPCA-93XM-61BX-7233
b2VO7UiAIyjAhj0i4A,1733628678,–†–µ–≥—É–ª—è—Ä–Ω–µ –ø–æ–ø–æ–≤–Ω–µ–Ω–Ω—è ¬´–§–æ–Ω–¥ –ü–æ–≤–µ—Ä–Ω–∏—Å—å –∂–∏–≤–∏–º¬ª,4829,4829,-25000,-25000,980,0,0,976143,False,6CX1-2E31-7341-KBTT
tuqu7DqYb0SqIAukXg,1733474462,—è–π—Ü—è –º–µ–¥,4829,4829,-12000,-12000,980,0,0,1001143,False,294H-8A2H-P3X0-CEB0
R7gKeyJoyGZKyTFuhg,1733230804,–ü–æ–ø–æ–≤–Ω–µ–Ω–Ω—è ¬´–ù–∞ —Ç–µ–ø–ª–∏–π –¥—Ä–æ–Ω¬ª,–ü–æ–ø–æ–≤–Ω–µ–Ω–Ω—è —Ä–∞—Ö—É–Ω–∫—É –±–∞–Ω–∫–∏,4829,4829,-50000,-50000,980,0,0,1013143,False,B8HK-A0BX-8K63-8H72
tawRMG_euo6MVW6pFg,1733206641,–ó —á–æ—Ä–Ω–æ—ó –∫–∞—Ä—Ç–∫–∏,4829,4829,900000,900000,980,0,0,1063143,False
-RdyXkpvRUHngmG89A,1733048112,–í–∞–ª–µ–Ω—Ç–∏–Ω–∞ –ú.,4829,4829,-248000,-248000,980,0,0,163143,False,9661-9P61-T2X7-P127
wXAXLkVxlF3f3hAxUQ,1733024273,–†–µ–≥—É–ª—è—Ä–Ω–µ –ø–æ–ø–æ–≤–Ω–µ–Ω–Ω—è ¬´–§–æ–Ω–¥ –ü–æ–≤–µ—Ä–Ω–∏—Å—å –∂–∏–≤–∏–º¬ª,4829,4829,-25000,-25000,980,0,0,411143,False,9957-MP06-M9K2-1T63
livJWApsvUaW1sFZUg,1738259151,Bolt,4121,4121,-16400,-16400,980,0,0,2801096,False
9QthduOPmvYb_q0ksw,1738254760,StomatologiyaFdclinic,8021,8021,-148000,-148000,980,0,0,2817496,False,MP4M-0B46-BBBP-C4E0
qQn8670MOMu5PsZAzg,1738254746,StomatologiyaFdclinic,8021,8021,-400000,-400000,980,0,0,2965496,False,B1MT-856E-XXA9-MCKP
E4fwcFXnkSdOZff1tA,1738242104,–íi–¥: –ü–†–ò–•–û–î–¨–ö–û –ï.–í. –§–û–ü,"–î–ª—è –ø–æ–ø–æ–≤–Ω–µ–Ω–Ω—è –∫–∞—Ä—Ç–∫–∏ 5375414101190360, –ü—Ä–∏—Ö–æ–¥—å–∫–æ –ï—Ä–Ω–µ—Å—Ç –íi–∫—Ç–æ—Ä–æ–≤–∏—á, 3487403339",4829,4829,3200000,3200000,980,0,0,3365496,False
MUe3FzxAuX3qf-HqMQ,1738240763,RESTORAN SIMONA,5812,5812,-78300,-78300,980,0,0,165496,False,P9M0-7CPT-C3B0-9TT1
UPCPURDA3LGbzphkOg,1738237382,Restoran 88,5814,5814,-21600,-21600,980,0,0,243796,False,5TX1-K15T-H65P-MCC9
NXiJf9V5Ai25GIbgxA,1738232708,AVTOPARKOVKA,7523,7523,-3000,-3000,980,0,0,265396,False,A6E2-05M1-KX06-AXPT
98fVXmnvO-Kz0FRePA,1738225839,Steam,5816,5816,-50496,-50300,980,0,0,268396,False,535X-E2P4-KMB5-APPP
Q595cSLQEl3V9TiftQ,1738222514,–ü–ª–∞—Ç—ñ–∂ MOYO,4829,4829,-49983,-49983,980,0,0,318892,False
9tf0EGcc4ST9AXpEDGO7ZA,1738195876,"–°–∫–∞—Å—É–≤–∞–Ω–Ω—è. LIQPAY*FIZICHNA OSOBA,KREMENCHUK,UA",5621,5621,126000,126000,980,0,-945,368875,False
4P1MWZxBF3FX8my2MQ,1738182327,–ö–∏—ó–≤ –¶–∏—Ñ—Ä–æ–≤–∏–π,9222,9222,-36750,-36750,980,0,0,242875,False,73TC-H5BK-0E04-62B3
P7wl22wBoCwbB_RxeQ,1738169241,KNYHARNYA YE,5942,5942,-41900,-41900,980,0,0,279625,False,K150-45PE-XCXA-0EHT
Y50jks8gyu8ljr-D_A,1738168889,–ö–Ω–∏–≥–∞—Ä–Ω—è book.ua,5942,5942,-51400,-51400,980,0,0,321525,False,45XB-52M1-EH0H-0K3B
3RppGJYiRR4igdUcAg,1738152934,Steam,5816,5816,-47262,-46800,980,0,0,372925,False,7HC9-KX3P-PPX8-A44X
-ywQcBUBzUZ2Xf01OA,1738143074,–•–ª—ñ–±–Ω–∞ –ö–∞–≤–∞,5462,5462,-2200,-2200,980,0,16,420187,False,36A2-7M87-0PAH-A1CE
XNBZOJA0kd24nwxZ2w,1738141345,Fitness23,7997,7997,-100000,-100000,980,0,0,422387,False,X498-99HH-72E2-42PX
1Un83saGS0CE2_yBIQ,1738063965,–£–∫—Ä–ø–æ—à—Ç–∞,9402,9402,-5000,-5000,980,0,0,522387,False,0M17-X99B-480A-6AC9
0k5BhNBhO_5IM76K2w,1738054797,–ó–∞–≤–µ—Ä—Ç–∞–π–ª–æ –°–æ—Ñ—ñ—è ,5812,5812,-154000,-154000,980,0,0,527387,False,HHA0-4BB2-7X6E-E2EM
t77vxqjqbAj_rW8Cug,1738051987,–ö–£–ó–Ø,4900,4900,-45000,-45000,980,0,0,681387,False,E05X-8X0H-AC04-1ME8
42F1J_QwgtnZHqiSEA,1738050836,Steam,5816,5816,-27100,-27100,980,0,0,726387,False,EM25-2MM1-K10C-4CH8
MqNMSO62yWxAX5_lkw,1738046559,–ö–∏—ó–≤–ø–∞—Å—Ç—Ä–∞–Ω—Å,4111,4111,-800,-800,980,0,0,753487,False,CTAT-4E5A-EP7M-577T
XyYNIcVZ5qeqIVH1XA,1738002729,Novapay,8999,8999,-6000,-6000,980,0,0,754287,False,6684-4A66-M604-PXHP
uJS718GsgX4qTILF3Q,1738000223,–°—ñ–ª—å–ø–æ,5411,5411,-24900,-24900,980,0,186,760287,False,ET24-3479-262K-TE81
zhmBoxw3vzoOXQ6qrw,1737998463,–°—ñ–ª—å–ø–æ,5411,5411,-31500,-31500,980,0,236,785187,False,TE10-EP7E-HATX-786C
gB1i7gwbdiamxteWPw,1737969000,Fitness23,7997,7997,-100000,-100000,980,0,0,816687,False,48T6-3PTE-45PB-7848
HKPc2hC5mEbaD70EvQ,1737921702,LIQPAY*FOP Danilina An,7395,7395,-120000,-120000,980,0,0,916687,False,X9CP-XC9B-P8MK-M758
QDwbRgSYAYfrnHEXiw,1737905687,Wfp.aquamarket,5411,5411,-173310,-173310,980,0,1299,1036687,False,XMT0-X5XH-03XH-5EE7
MdHWrkLHmiNiKlyDDQ,1737903384,–°—ñ–ª—å–ø–æ,5411,5411,-189800,-189800,980,0,1423,1209997,False,KAPE-E63T-47EA-P1PP
3B16MDd-eMwP8_EeQQ,1737902791,SECHST,5912,5912,-15390,-15390,980,0,0,1399797,False,P2KH-E8AT-178P-636B
WBMHEjEWrc1s6ZyxuA,1737902764,SECHST,5912,5912,-13150,-13150,980,0,0,1415187,False,3CHT-8A7M-P28A-BX4B
T5kKmxQ6wkp8f_h6VQ,1737901441,A2068,5912,5912,-92574,-92574,980,0,0,1428337,False,E53K-ECP2-04PH-390E
yamDKGJy0GgmuePNyw,1737895052,LIQPAY*Pethouse,5995,5995,-150200,-150200,980,0,0,1520911,False,T4KP-89A8-XAKH-863H
Of4hXZeD8NFqiEo-MQ,1737883251,Best Way To Cup,5814,5814,-19500,-19500,980,0,0,1671111,False,580E-1803-5AM4-7H66
r-qLt5ddmz7TuAjuhg,1737824665,–ê–ø—Ç–µ–∫–∞ ¬´–ë–∞–∂–∞—î–º–æ –∑–¥–æ—Ä–æ–≤'—è¬ª,5912,5912,-9255,-9255,980,0,0,1690611,False,341T-2395-1TB0-66K0
nYqPBFV0N4UokNbUjg,1737824574,–ê–ø—Ç–µ–∫–∞ ¬´–ë–∞–∂–∞—î–º–æ –∑–¥–æ—Ä–æ–≤'—è¬ª,5912,5912,-102451,-102451,980,0,0,1699866,False,AP37-EE3A-KT02-3C84
PbAu9_8vTZNfnJQ6gA,1737823176,MINISTRY OF DESSERTS,5812,5812,-92000,-92000,980,0,0,1802317,False,KKEX-H19P-3P31-459P
Rsp5Endgq1GV73acrA,1737822867,SYHARNYI DIM FORTUNA,5993,5993,-75000,-75000,980,0,0,1894317,False,4BBX-2BXK-T9M7-ME57
PpN8elNz4uY3d7CEWw,1737821823,Novapay,8999,8999,-6383,-6383,980,0,0,1969317,False,MPKT-050P-TX95-84P9
Uyykf-ZWjoIMvemilg,1737821732,–ù–æ–≤–∞ –ø–æ—à—Ç–∞,7399,7399,-10100,-10100,980,0,0,1975700,False,P2P8-XA39-A703-3PE4
1LXIVydb_oISBNW-Yw,1737819157,produktoviymagazin,5499,5499,-5500,-5500,980,0,41,1985800,False,T1K6-98B8-P86C-P716
npl6ydZav4_wCb3cDw,1737819055,AMbistro,5814,5814,-23800,-23800,980,0,0,1991300,False,62MK-K47C-6MEP-52EK
rW4jQbnE61eYkJMGug,1737818202,KINOMARKET PLANETA KINO,5814,5814,-16000,-16000,980,0,0,2015100,False,3XH7-EH30-MPAH-7XTB
RU5CVH8pbXFyR0d0oQ,1737812616,FIRST POINT Espresso Bar,5812,5812,-22500,-22500,980,0,0,2031100,False,65PK-H05K-C280-9359
HAbPCe7OVNpogGJmBw,1737797968,SALON KRASY BACKSTAGE,7230,7230,-44000,-44000,980,0,0,2053600,False,KE0B-A6TM-M208-PET3
54RLtFQsPoV0iepdGg,1737792862,–ü–æ–ø–æ–≤–Ω–µ–Ω–Ω—è ¬´puppy¬ª,–ü–æ–ø–æ–≤–Ω–µ–Ω–Ω—è —Ä–∞—Ö—É–Ω–∫—É –±–∞–Ω–∫–∏,4829,4829,-200000,-200000,980,0,0,2097600,False,AK42-50MM-0300-EP0C
uJIkpJk9CrC_Z8nG_g,1737792804,–ü–µ—Ä–µ–∫–∞–∑ –Ω–∞ –∫–∞—Ä—Ç–∫—É,4829,4829,-700000,-700000,980,0,0,2297600,False
YhGVtkTLEHXSebjfuw,1737792795,Lesya,4829,4829,-600000,-600000,980,0,0,2997600,False,1KC7-822A-4639-875X
fCkniXvsUBnmMMqPUQ,1737740041,Steam,5816,5816,-29900,-29900,980,0,0,3597600,False,MAP6-KPPH-5AP7-0A9C
6Bh2oJmf2qdEL0dM8Q,1737739333,–í–µ—Ç–µ—Ä–∏–Ω–∞—Ä–Ω–∞—è –∞–ø—Ç–µ–∫–∞ –ë–µ—Å—Ç,742,742,-72000,-72000,980,0,0,3627500,False,9TBC-K4H3-67AX-AE9A
s-KtDR9WCYZSZSE-OA,1737736399,SALON KRASY BACKSTAGE,7230,7230,-1090000,-1090000,980,0,0,3699500,False,HC9H-MK7T-8EP8-M5B5
ywf3tR4SUq7JdiByDQ,1737726682,OK Wine,5411,5411,-39100,-39100,980,0,391,4789500,False,3CE2-XXC5-79M1-96A4
8ETr20hxyMGO4Th6lQ,1737726039,AMbistro,5814,5814,-47600,-47600,980,0,0,4828600,False,B728-HX6B-9AC1-2EXK
9lpCDR0ZRzrRHHO3Gw,1737725726,Ponchyk Boy | –û–ª–µ—Å—è –ì–æ–Ω—á–∞—Ä–∞,5812,5812,-26800,-26800,980,0,0,4876200,False,0850-6BKX-KTM2-EA57
YCt2kng3zuuqXV75gQ,1737723451,PershiyPoverh,5814,5814,-9500,-9500,980,0,0,4903000,False,B395-3T4B-PM9P-76X3
xPFnl-hOIbAZ0GKuZA,1737720162,–íi–¥: –ü–†–ò–•–û–î–¨–ö–û –ï.–í. –§–û–ü,"–î–ª—è –ø–æ–ø–æ–≤–Ω–µ–Ω–Ω—è –∫–∞—Ä—Ç–∫–∏ 5375414101190360, –ü—Ä–∏—Ö–æ–¥—å–∫–æ –ï—Ä–Ω–µ—Å—Ç –íi–∫—Ç–æ—Ä–æ–≤–∏—á, 3487403339",4829,4829,4000000,4000000,980,0,0,4912500,False
J0yS0C9ypz8oMKXOgg,1737710495,Mates,5812,5812,-9500,-9500,980,0,0,912500,False,MAE1-E5BM-005T-8978
0842I7YWg3GZVoa6HQ,1737710054,Fitness23,7997,7997,-70000,-70000,980,0,0,922000,False,76H3-1730-EX92-3KEC
i8zdmYHMOt48dVdZ9Q,1737671480,SP POPFLEX,5631,5631,-224326,-5295,840,0,1682,992000,False,4463-80ME-8AH5-CHAT
YhTXCgUMssO8VlMueA,1737653130,Novapay,8999,8999,-14716,-14716,980,0,0,1216326,False,555T-93XT-6BHP-0MEP
iY7SCWarlIJe4wxMeQ,1737629720,Best Way To Cup,5814,5814,-62100,-62100,980,0,0,1231042,False,8H50-P2C5-T120-2399
0s9euGOUeNZHhhB-Hg,1737629283,La Fabrique,5814,5814,-8000,-8000,980,0,0,1293142,False,B7A1-5XC6-MB43-C2MM
A6I31eWaQT6CcFi8YA,1737583168,LIQPAY*Fizichna osoba,5621,5621,-126000,-126000,980,0,945,1301142,False
xNX76AVwAsAdwvf1tQ,1737571652,Novapay,8999,8999,-6000,-6000,980,0,0,1427142,False,H9MP-P4M9-X0B7-96KC
FuQOxbc-BWnxtklPiQ,1737546621,Ukrkhalial,5499,5499,-21120,-21120,980,0,158,1433142,False,XX1H-K01C-37K3-5872
5l9hK4BLC4GQl26J6w,1737546332,–°—ñ–ª—å–ø–æ,5411,5411,-14800,-14800,980,0,111,1454262,False,X29B-M2A6-4C2B-P6XM
Fo9HHrTEUSRhL9tCqw,1737532550,Fitness23,7997,7997,-209900,-209900,980,0,0,1469062,False,X6BP-93K7-MMBE-6CKE
BZhk2Hx6gAIAXX5ipQ,1737477090,Right coffee bar,5814,5814,-10500,-10500,980,0,0,1678962,False,P45K-2H99-A0PP-CT9X
kORXO7mcE9SoMDg3cA,1737466052,KAFE TITKA KLARA,5814,5814,-28000,-28000,980,0,0,1689462,False,B34P-E156-69K3-5MCB
oq4yAQEItj9og5Mu_w,1737465142,–°—ñ–ª—å–ø–æ,5411,5411,-258735,-258735,980,0,1940,1717462,False,PC39-BKHX-370K-T204
l_hpwhSwOorA1-5C8Q,1737463949,Ukrkhalial,5499,5499,-65640,-65640,980,0,596,1976197,False,086K-EH1E-2H58-TX0H
XMBC0aKwfye64ELaVg,1737462157,–ü–µ—Ä–µ–∫–∞–∑ –Ω–∞ –∫–∞—Ä—Ç–∫—É,4829,4829,-600000,-600000,980,0,0,2041837,False
Rz159Z1bEsKaBrVJHg,1737462138,zakaz.ua,5411,5411,-300300,-300300,980,0,3003,2641837,False,X38E-8EB4-A1AB-28TT
eFvRJdyjzlszOgVqtg,1737458126,–°—ñ–ª—å–ø–æ,5411,5411,-88300,-88300,980,0,883,2942137,False,P22M-22HT-EBE1-3ET4
-MI3U4crGgRQAe2WMA,1737457787,LIQPAY*Pethouse,5995,5995,-36000,-36000,980,0,0,3030437,False,1HPK-EHHH-CB32-H54A
x8EplEYp1OIsvOMaSw,1737454691,–íi–¥: –ü–†–ò–•–û–î–¨–ö–û –ï.–í. –§–û–ü,"–î–ª—è –ø–æ–ø–æ–≤–Ω–µ–Ω–Ω—è –∫–∞—Ä—Ç–∫–∏ 5375414101190360, –ü—Ä–∏—Ö–æ–¥—å–∫–æ –ï—Ä–Ω–µ—Å—Ç –íi–∫—Ç–æ—Ä–æ–≤–∏—á, 3487403339",4829,4829,2800000,2800000,980,0,0,3066437,False
C7Jfb5PDPO1AUWgziA,1737389689,–°—ñ–ª—å–ø–æ,5411,5411,-88300,-88300,980,0,662,266437,False,949E-MP3T-A7P3-1EXC
hSkVWxlUxzrxemMChA,1737388200,–ó–æ–æ–º–∞–≥–∞–∑–∏–Ω,5995,5995,-3400,-3400,980,0,0,354737,False,MH04-PH4H-E58M-XCBC
8ygT4VYKcZOuh51www,1737377568,LIQPAY*Simona Ristoran,5812,5812,-63840,-63840,980,0,0,358137,False,M5A7-9P78-8K7K-2A8K
4egVI6DY5c2yOMfWBA,1737377360,PHotosalonMAN,7221,7221,-8000,-8000,980,0,0,421977,False,P5E9-93HB-5H0A-E530
Nrx9OBNGykqmY9m6WQ,1737302440,magazin 762597,5912,5912,-17381,-17381,980,0,0,429977,False,6CC5-6262-3566-9XXH
s-ZftFW0nRCU9zzfow,1737301070,PlanD,8999,8999,-74500,-74500,980,0,0,447358,False,7P9T-X1C6-P415-7EPC
AANZAH6dtWEnBTSAig,1737292957,–ó –±—ñ–ª–æ—ó –∫–∞—Ä—Ç–∫–∏,4829,4829,500000,500000,980,0,0,521858,False
M_gbSv8iv6Ic-3HD7w,1737288678,Kafe Kaviarnia humans,5814,5814,-19000,-19000,980,0,0,21858,False,7926-A0AB-M89K-272C
0G-PZmW26gg6szD5Rg,1737285372,LIQPAY*Pethouse,5995,5995,-154000,-154000,980,0,0,40858,False,ABKE-53PH-394P-HAP1
iZlJUoSoWRggiyrNwA,1737277066,–°—ñ–ª—å–ø–æ,5411,5411,-171445,-171445,980,0,1285,194858,False,7H9K-HCCX-5642-68KT
l1sObkglsdkXIkgW3g,1737277049,–ó –±—ñ–ª–æ—ó –∫–∞—Ä—Ç–∫–∏,4829,4829,200000,200000,980,0,0,366303,False
VnDeCNXbYaxdLgIMKg,1737210569,Novapay,8999,8999,-17049,-17049,980,0,0,166303,False,HKX8-MMAT-M86T-EE52
WTT_iYH_1EWwWXt3PQ,1737207926,Steam,5816,5816,-14600,-14600,980,0,0,183352,False,K1EX-52M4-T55X-BB10
W6twQdTUsNrv1puEog,1737205569,Konteiner,5814,5814,-36000,-36000,980,0,0,197952,False,8TBX-25MX-AEK0-E28A
Mud-FHmBPJJ44Vp9fw,1737204673,LIQPAY*Simona Ristoran,5812,5812,-91770,-91770,980,0,0,233952,False,P7HP-H1XA-EC0C-K1K1
bdUTcg8FmUQx1cKllA,1737130468,Bolt Food,5811,5811,-38800,-38800,980,0,0,325722,False,479T-XATT-6X30-9CH4
1cFqSQBe5A6leqI04w,1737114417,Uklon,4121,4121,-13800,-13800,980,0,0,364522,False,E4MP-10B8-EX0T-AAX8
MqJCdNfgeJ5l81FU4w,1737110387,Novus,5411,5411,-29692,-29692,980,0,222,378322,False,935T-B0KM-5X4K-C583
45NgDZXMwqG0m_rPZQ,1737109276,Fitness23,7997,7997,-20000,-20000,980,0,0,408014,False,TT1P-1AHH-7KX4-4XBH
-U7LJmjBHhjVSySaow,1737109259,Fitness23,7997,7997,-50000,-50000,980,0,0,428014,False,ATET-B549-HK1C-7MMA
SPgWBlImBBzAU6_S_w,1737102996,Novapay,8999,8999,-8420,-8420,980,0,0,478014,False,5EEM-T39A-24T9-M0AX
ETEw3T0Q2T-Ab-Dq6A,1737099977,Best Way To Cup,5814,5814,-19000,-19000,980,0,0,486434,False,AAX0-70BH-A58H-509H
90KiVfdmlYl0T8wpQA,1737056771,Novapay,8999,8999,-8000,-8000,980,0,0,505434,False,KB39-8KT8-4T87-9HXA
xzJAoOcNLJfZa6W9VQ,1737056733,Novapay,8999,8999,-6000,-6000,980,0,0,513434,False,K078-2870-4566-K3KH
2Kx2MyTFLnxc7lx69A,1737044508,Ponchyk Boy | –û–ª–µ—Å—è –ì–æ–Ω—á–∞—Ä–∞,5812,5812,-28600,-28600,980,0,0,519434,False,B593-79E3-BTH7-2EX9
Qrn06nhDRKLJH4GPgQ,1737043717,Kaviarnia KAShTAN,5812,5812,-6000,-6000,980,0,0,548034,False,8T1P-A032-65PB-1077
bqecGX26cGxRHAUwDg,1737042858,OG BURGER | –†–µ–π—Ç–∞—Ä—Å—å–∫–∞,5812,5812,-86900,-86900,980,0,0,554034,False,A5AC-X09K-6260-P55H
CDLSmCN-P_ijWGAxiQ,1736966872,wfp-usualclth,5651,5651,-84000,-84000,980,0,630,640934,False,87MB-T39M-253A-CCPK
Z81o9AJKszPpFfNAtw,1736951884,–ó –±—ñ–ª–æ—ó –∫–∞—Ä—Ç–∫–∏,4829,4829,500000,500000,980,0,0,724934,False
gynD3yeUH54n44iu9Q,1736951866,Wfp.aquamarket,5411,5411,-126380,-126380,980,0,947,224934,False,52B4-0AKH-0XM0-P08A
awpsOkOnOF4FJHFaYg,1736945590,Ninja Sushi,5814,5814,-93000,-93000,980,0,0,351314,False,XPTX-0736-HT7X-67C7
uhzQkFx2_wg4E8G-Uw,1736933422,MIKSMART,5499,5499,-5400,-5400,980,0,40,444314,False,7384-7064-4MKM-KCXK
sPc-Hjt1nvyAbQmRUQ,1736932889,Fitnes klub 2BFIT,7941,7941,-70000,-70000,980,0,0,449714,False,BB92-9040-HM8E-687P
8TGirnaQJBpc0ODW-A,1736927806,LIQPAY*Pethouse,5995,5995,-333700,-333700,980,0,0,519714,False,4CX3-8KA1-8TTC-M67A
2Tr4FXD_0T755MNBSA,1736841584,–ö–æ–ª–æ,5411,5499,-22500,-22500,980,0,168,853414,False,65P7-AK8X-E8M1-AC2P
gTb4j2vEGV73QTzV1g,1736841369,–ê–ø—Ç–µ–∫–∞ ¬´–ë–∞–∂–∞—î–º–æ –∑–¥–æ—Ä–æ–≤'—è¬ª,5912,5912,-7320,-7320,980,0,0,875914,False,X7CP-413T-795P-HBC2
zhTzBDpDWsiM2zVcVw,1736806629,Steam,5816,5816,-16900,-16900,980,0,0,883234,False,X502-9TKH-6EBH-6PE4
MKRj78lXv2cg7YqjLA,1736794421,Novapay,8999,8999,-12990,-12990,980,0,0,900134,False,14M0-T3K4-H8M4-56MX
DsW2v8_-m5PwRdJLIw,1736794398,Novapay,8999,8999,-6745,-6745,980,0,0,913124,False,C7H5-2B7H-0EM0-EK5X
0e4K6Wg_pL54VxrhYg,1736787197,LIQPAY*OG Burger Reyta,5812,5812,-118810,-118810,980,0,0,919869,False,H6EA-1CEX-55HB-BP1C
DKJCo2thRV5YN5sNSw,1736785196,Bolt Food,5811,5811,-76000,-76000,980,0,0,1038679,False,MCB9-4KBE-95B5-BKK0
_TA83pMnn7kCoaJsUA,1736760794,La Fabrique,5814,5814,-10500,-10500,980,0,0,1114679,False,ATH4-7X5C-6626-9CP0
1rucj2OJutmRpMcimw,1736760711,OK Wine,5921,5921,-10950,-10950,980,0,82,1125179,False,06XX-4383-0T36-M7HB
3A9hmjcWTY1NKDGU3Q,1736759881,Fitness23,7997,7997,-70000,-70000,980,0,0,1136129,False,CB7A-A1E4-EM7E-0TB0
2brqjb9OSMnvMaV5-Q,1736671018,Uklon,4121,4121,-13800,-13800,980,0,0,1206129,False,MA0E-B316-BHH3-KE32
xjeOAgBCq0XShu6x4w,1736670800,On The Square Lv,7011,7011,-10000,-10000,980,0,0,1219929,False,M20K-B3BT-A7TB-B2TP
uuAGP3ZoasKILs3iBg,1736669358,Best Way To Cup,5814,5814,-13500,-13500,980,0,0,1229929,False,XCK7-3AH1-X2X8-H4M5
hRqWDBPEJ1H5-RH06A,1736668791,Cheese Bakery | Galytska,5812,5812,-13200,-13200,980,0,0,1243429,False,1K2B-TE54-34XH-KET5
x0pkVfnTR50xoBMq5w,1736668502,Cheese Bakery | Galytska,5812,5812,-54500,-54500,980,0,0,1256629,False,E26K-A52M-9K0E-CPMA
ep5iet_FLgdbE1LfNA,1736622911,Rose Bar,5814,5814,-108000,-108000,980,0,0,1311129,False,2THH-7P1M-6039-9MPK
8J4KFaRv6QoNnnMtJA,1736617559,Podorozhnyk,5912,5912,-57999,-57999,980,0,0,1419129,False,XBH7-H18M-2X03-K3E1
Ngxt95qzGVEpr8Ivnw,1736616738,Shalom | Lviv,5812,5812,-82850,-82850,980,0,0,1477128,False,15C0-T2XA-X527-KAA7
-SQ2oY_UF7HqAkpTZA,1736597692,FayniLodi,5814,5814,-5500,-5500,980,0,0,1559978,False,7AXA-TXC5-3B4H-5756
V-0js7kE0qLPjN7RnQ,1736596459,FOPMarcivIV,5812,5812,-21000,-21000,980,0,0,1565478,False,6K3P-1X44-76HH-5XA8
xdycGiNG2poiP0NTvw,1736591536,CAFE PIZZA MO,5812,5812,-90600,-90600,980,0,0,1586478,False,8H4P-141A-TB9K-MEKA
9o69Z25hEMKnYWsliw,1736582854,Best Way To Cup,5814,5814,-7500,-7500,980,0,0,1677078,False,EA15-5PP4-0X27-CAK4
bwwT8znGiugNp6-kXg,1736582675,Novus,5411,5411,-6998,-6998,980,0,52,1684578,False,E9XA-B3PK-4924-866M
YYF1KQVWB6Sq0XsLAw,1736582395,–ù–æ–≤–∞ –ø–æ—à—Ç–∞,7399,7399,-38600,-38600,980,0,0,1691576,False,84EH-CM14-XPE1-EMCA
uJZRqJY942jVDS5MBQ,1736535154,Cukiernia,5814,5814,-27410,-27410,980,0,0,1730176,False,019H-154C-K5MX-3PKA
zDo37C4Ef0YVYgtc-w,1736533143,–Ü–Ω—à—ñ –ë–∞—Ä,5812,5812,-140300,-140300,980,0,0,1757586,False,PHP0-P246-29E4-TPC2
sJsgMoAEIVAehn2hfA,1736511024,FOPKregelLyubovYaroslaviv,7230,7230,-85000,-85000,980,0,0,1897886,False,K2M3-X72X-098B-6PCB
naRrhxs67IiHdgisLQ,1736504457,–°—ñ–ª—å–ø–æ,5411,5411,-61293,-61293,980,0,570,1982886,False,EK81-PAB0-H8E8-TC99
isrJ6MkQAL168r9ogQ,1736504204,Uklon,4121,4121,-2100,-2100,980,0,0,2044179,False,4135-3312-623K-4K11
aXUqR273KU1SQ3aG0Q,1736503679,Fitness23,7997,7997,-50000,-50000,980,0,0,2046279,False,EE22-3HCE-C1T8-0K28
3_fMDNMIj3RcKBAgJg,1736502845,Uklon,4121,4121,-7400,-7400,980,0,0,2096279,False,C7ME-CHK9-509A-BK68
2Vv1C-HuKDioqCbXNA,1736498055,POTIAH HRCS2-002,5814,5814,-24500,-24500,980,0,0,2103679,False,6E07-M84C-347B-BXXT
x-j9lRohbmrB3Dt-Ow,1736487154,LIQPAY*Pethouse,5995,5995,-65000,-65000,980,0,0,2128179,False,PE54-PB38-P032-KX7X
JzuVn06lCk3-udWtmg,1736483833,–°–∫–∞—Å—É–≤–∞–Ω–Ω—è. WOG,5541,5541,8661,8661,980,0,0,2193179,False
3HpN38ePBUFhoCpY2g,1736483718,WOG,5541,5541,-256158,-256158,980,0,0,2184518,False
W1HIXWlzhCiZZjX-WA,1736482106,KAVIARNI,5814,5814,-71200,-71200,980,0,0,2440676,False,CPXT-012K-6ETM-54AM
rCbblvVM1U93h6bRey0ZnA,1736469210,"–°–∫–∞—Å—É–≤–∞–Ω–Ω—è. WFP.AQUAMARKET,DNIPRO,UA",5411,5411,33600,33600,980,0,-335,2511876,False
17O_qSap3kXBKVnixw,1736421657,Fitness23,7997,7997,-70000,-70000,980,0,0,2478276,False,33P2-HHTX-PA03-K9MA
CJq-xlV0b0RWZuf4ug,1736412979,Novapay,8999,8999,-8966,-8966,980,0,0,2548276,False,4A1C-MBXB-6EK7-PB4M
Ej17sOSp4eIE79YfGw,1736359366,–°—ñ–ª—å–ø–æ,5411,5411,-52700,-52700,980,0,527,2557242,False,0XCT-P80H-K802-8MCX
hX79PsXlICONE4xiFA,1736349194,Novapay,8999,8999,-9000,-9000,980,0,0,2609942,False,9AA6-12A8-650E-X8X7
ERK4boGW08J1LhxqqQ,1736348778,–ü–µ—Ä–µ–∫–∞–∑ –Ω–∞ –∫–∞—Ä—Ç–∫—É,4829,4829,-500000,-500000,980,0,0,2618942,False
TUovn2ZqKsfCDQdgrQ,1736348672,–ü–µ—Ä–µ–∫–∞–∑ –Ω–∞ –∫–∞—Ä—Ç–∫—É,4829,4829,-1600000,-1600000,980,0,0,3118942,False
HRDZA4YevlpFbP4M5w,1736347226,CEH,7216,7216,-50000,-50000,980,0,0,4718942,False,732M-X7C6-9MHB-AP24
ekY4wKd7VGHv58y3Fg,1736328788,KHLIBNA KAVA,5462,5462,-2200,-2200,980,0,22,4768942,False,E409-A3A3-EB4T-M1HT
KpG1YIKN_wpiW5VS0g,1736328547,Fitness23,7997,7997,-70000,-70000,980,0,0,4771142,False,1X71-CX8K-KX83-T1M8
bvblnNbf_BmQJkuZ-A,1736261618,ULTRAMARKET,5411,5411,-21110,-21110,980,0,211,4841142,False,KBP2-26M8-4EB4-E132
xZ3p8uOStQTgR0rKhA,1736261283,MasterZoo,5995,5995,-18905,-18905,980,0,0,4862252,False,ATTA-T6CP-665P-H00A
RJNLgYvwQfNSScR7EA,1736260788,Novapay,8999,8999,-8000,-8000,980,0,0,4881157,False,4T17-B082-9353-184A
-yszaBj2hQNFZY3-0Q,1736259780,EasyPay,5411,5411,-379096,-379096,980,0,3790,4889157,False,T9PC-90K7-X5H8-T929
iSHnhlXPR50pzgzR2g,1736239371,–°—ñ–ª—å–ø–æ,5411,5411,-72300,-72300,980,0,723,5268253,False,479A-7290-CMEC-KPCE
mYWftJ-2v_0lun76qA,1736186544,LIQPAY*OG Burger Reyta,5812,5812,-90035,-90035,980,0,0,5340553,False,X67K-26A9-2A00-84TT
XBzYdxtN8lztreDugQ,1736178967,Novapay,8999,8999,-8755,-8755,980,0,0,5430588,False,7A3M-TE7H-9P8C-609M
W_917W5WyAhUKJzATw,1736159688,FOPKarasOksanaOlegivna,742,742,-218000,-218000,980,0,0,5439343,False,5XK3-ECX5-MB4T-48AE
fJZCZQFL5BeI6FtB9w,1736155199,Fitness23,7997,7997,-70000,-70000,980,0,0,5657343,False,9080-5B6K-C2B3-88HX
u1XnX7NB9A741M2iaA,1736087292,Wfp.aquamarket,5411,5411,-254180,-254180,980,0,2541,5727343,False
piqI7UOzah3fjlE4UA,1736080766,FOP IVANOVA YU.O.,5499,5499,-5000,-5000,980,0,50,5981523,False,P05C-614P-K7K0-AB99
kNI9HueBJyN8yTbRsA,1736080655,AMbistro,5814,5814,-35700,-35700,980,0,0,5986523,False,56P7-0K6E-E9AX-K8PC
9cuIL7PvR2sbpsyzhA,1736066652,Seizo,7230,7230,-45500,-45500,980,0,0,6022223,False,P4B8-1492-PCH2-6C97
b-PtHEZfhkJUXPkj_Q,1736066384,magazin Biotus,5499,5499,-187300,-187300,980,0,1873,6067723,False,84B6-6K5T-4C1C-9XPE
ql9HBl2FEXQQdLP1ag,1736064424,Best Way To Cup,5814,5814,-27500,-27500,980,0,0,6255023,False,46H5-3208-TPEE-BA03
LoJ0A2ByrmAySkWUew,1736011534,–°—ñ–ª—å–ø–æ,5411,5411,-127300,-127300,980,0,1273,6282523,False,A5CH-3364-XEM9-K19P
SthasWrkq02way9cSA,1736005219,Parasolya,8999,8999,-175000,-175000,980,0,0,6409823,False,19E0-C177-ABAB-977E
tzkFGx9IZ4VMkSJPSQ,1735993492,Konteiner,5814,5814,-34000,-34000,980,0,0,6584823,False,3X8T-1MP7-7THA-4TAB
RFTDbrxBRv9n-gEZ4Q,1735992549,LIQPAY*Simona Ristoran,5812,5812,-123375,-123375,980,0,0,6618823,False,31E1-9TC2-7X1E-PX58
TybWMAJIFej3ej1X1g,1735992334,La Fabrique,5814,5814,-10500,-10500,980,0,0,6742198,False,E6AX-K307-0105-P0X2
QzJopKRfs1aDBpPYyQ,1735989278,MYASTORIYA SHOP,5411,5411,-198210,-198210,980,0,1982,6752698,False,PKC5-T5MH-66T5-BTEX
jrJloSqefATt6lRrvg,1735989260,FOPSTULKOVSKAOS,5499,5499,-25000,-25000,980,0,250,6950908,False,53E3-A423-6CH7-0CKT
l7y4C6WQNMHFkC7PlQ,1735977961,–¢–µ–∞—Ç—Ä –õ–µ—Å—ñ –£–∫—Ä–∞—ó–Ω–∫–∏,7922,7922,-140000,-140000,980,0,0,6975908,False,X059-9TX2-8TB7-6M3K
T__WHyX98vy4921QUg,1735931560,Novapay,8999,8999,-17549,-17549,980,0,0,7115908,False,9353-3PC9-2A3E-MAH5
My_wbIGpXyM29Aq3Yw,1735931544,Novapay,8999,8999,-8000,-8000,980,0,0,7133457,False,TC57-HP9X-0XPC-6HE9
V0nHOmU9KmdlpM3anQ,1735890992,LIQPAY*Seizo,7230,7230,-20000,-20000,980,0,0,7141457,False,A9HP-P2BT-797A-6XE5
xPFnl-5GJ7Yf0GagZg,1735873097,LIQPAY*Pethouse,5995,5995,-92400,-92400,980,0,0,7161457,False,P579-7EP7-75T7-9XH0
JQ5BrIEC5zQvgJy6zA,1735824725,kaviarnia the coffee Lviv,5812,5812,-15900,-15900,980,0,0,7253857,False,83M2-A4A3-1KBT-3T92
sWWeTLYVUOugXONd_Q,1735814471,OK Wine,5411,5411,-189800,-189800,980,0,1898,7269757,False,TK99-8EC4-X913-442E
tMV_7lRZ5yd3FciLAg,1735814468,–ü–æ–ø–æ–≤–Ω–µ–Ω–Ω—è ¬´puppy¬ª,–ü–æ–ø–æ–≤–Ω–µ–Ω–Ω—è —Ä–∞—Ö—É–Ω–∫—É –±–∞–Ω–∫–∏,4829,4829,-200000,-200000,980,0,0,7459557,False,PHB4-431E-8823-19HC
dyBEkRGFnCtOM-_OTg,1735814151,–íi–¥: –ü–†–ò–•–û–î–¨–ö–û –ï.–í. –§–û–ü,"–î–ª—è –ø–æ–ø–æ–≤–Ω–µ–Ω–Ω—è –∫–∞—Ä—Ç–∫–∏ 5375414101190360, –ü—Ä–∏—Ö–æ–¥—å–∫–æ –ï—Ä–Ω–µ—Å—Ç –íi–∫—Ç–æ—Ä–æ–≤–∏—á, 3487403339",4829,4829,7500000,7500000,980,0,0,7659557,False
1msTVz6adk1NnDO28g,1735813924,Mahazyn Ukrkhalial,5499,5499,-22744,-22744,980,0,0,159557,False,62BA-4B16-9429-A9MX
0HWdwxpj6hFk6oK80Q,1735813599,–ó –±—ñ–ª–æ—ó –∫–∞—Ä—Ç–∫–∏,4829,4829,50000,50000,980,0,0,182301,False
QyRZgHE94dYiUCtK7A,1735813585,–°—ñ–ª—å–ø–æ,5411,5411,-7847,-7847,980,0,0,132301,False,T529-E7KT-BPXM-BB8M
g-BoBevL_btO4qrfag,1735808044,Fitness23,7997,7997,-139900,-139900,980,0,0,140148,False,3K96-5XPM-2AT0-T53P
gCPXZAOGWwayjJCq2g,1735807810,–ó –±—ñ–ª–æ—ó –∫–∞—Ä—Ç–∫–∏,4829,4829,200000,200000,980,0,0,280048,False
BKlMXCZnAyEPld0-Qg,1735736828,–°—ñ–ª—å–ø–æ,5411,5411,-89964,-89964,980,0,0,80048,False,P0TM-4P5A-TXTM-T1HB
oSDoxhOy5taGW8PtfA,1735735639,Best Way To Cup,5814,5814,-7000,-7000,980,0,0,170012,False,A430-18KB-K16X-8P92
i963oSYBCA9uvLsT_w,1735726298,–ö–æ–ª–æ,5411,5499,-19250,-19250,980,0,0,177012,False,KA5C-923X-9AB5-9E2C
2b0ReRfskTUAdAgmAg,1735723862,bolt.eu,5811,5811,-78500,-78500,980,0,0,196262,False,ACKT-3028-XBM4-1653
PVJf_lSbgMNrk8PT42Jmyw,1735688695,"–°–∫–∞—Å—É–≤–∞–Ω–Ω—è. LIQPAY*PETHOUSE,KIYIV,UA",5995,5995,28283,28283,980,0,0,274762,True
moO3FX-y2S6efQXvzg,1738227960,Lesya,4829,4829,-500000,-500000,980,0,0,411877,False,EAK6-MHT3-3072-KCE1
Rc6VX7zSP67PHC4PSA,1737862267,–†–µ–≥—É–ª—è—Ä–Ω–µ –ø–æ–ø–æ–≤–Ω–µ–Ω–Ω—è ¬´–§–æ–Ω–¥ –ü–æ–≤–µ—Ä–Ω–∏—Å—å –∂–∏–≤–∏–º¬ª,4829,4829,-25000,-25000,980,0,0,911877,False,ATKH-88HB-5184-PKTM
gNAIOcVLMZbetpwvFw,1737805183,–ü–æ–ø–æ–≤–Ω–µ–Ω–Ω—è ¬´¬´–•–∞—Ä—Ç—ñ—è¬ª –ü–∞—Ç—Ä–æ–Ω–∞—Ç–Ω–∞¬ª,–ü–æ–ø–æ–≤–Ω–µ–Ω–Ω—è —Ä–∞—Ö—É–Ω–∫—É –±–∞–Ω–∫–∏,4829,4829,-100000,-100000,980,0,0,936877,False,K8T5-A1B7-3T3T-1X2C
uRHZUKFvHregYMckPw,1737792804,–ó —á–æ—Ä–Ω–æ—ó –∫–∞—Ä—Ç–∫–∏,4829,4829,700000,700000,980,0,0,1036877,False
Bp2gDS4Obi4-JGvWIQ,1737562060,Lesya,4829,4829,-300000,-300000,980,0,0,336877,False,TEKT-KTH5-5961-H2E5
DAVxLk_Sn6REUWjB9w,1737462157,–ó —á–æ—Ä–Ω–æ—ó –∫–∞—Ä—Ç–∫–∏,4829,4829,600000,600000,980,0,0,636877,False
TE69pnjyiLXSe1-LSA,1737453341,–õ—ñ–ª—ñ—è –ö.,4829,4829,-280000,-280000,980,0,0,36877,False,PEMH-1153-A2PT-04B8
VECEr4hPpMdkfrK6FQ,1737292957,–ü–µ—Ä–µ–∫–∞–∑ –Ω–∞ –∫–∞—Ä—Ç–∫—É,4829,4829,-500000,-500000,980,0,0,316877,False
tc_yX7DwXEF7Xk8U-A,1737277049,–ü–µ—Ä–µ–∫–∞–∑ –Ω–∞ –∫–∞—Ä—Ç–∫—É,4829,4829,-200000,-200000,980,0,0,816877,False
8P4TYs-TlHvjXDjSTg,1737257495,–†–µ–≥—É–ª—è—Ä–Ω–µ –ø–æ–ø–æ–≤–Ω–µ–Ω–Ω—è ¬´–§–æ–Ω–¥ –ü–æ–≤–µ—Ä–Ω–∏—Å—å –∂–∏–≤–∏–º¬ª,4829,4829,-25000,-25000,980,0,0,1016877,False,TK61-PHH5-C13X-2X90
fymL0_1DSmPIh82poQ,1737132111,–ü–æ–ø–æ–≤–Ω–µ–Ω–Ω—è ¬´üíï–î—ñ–≤—á–∞—á–∏–π –î–≤—ñ–∂ üíÉ¬ª,–ü–æ–ø–æ–≤–Ω–µ–Ω–Ω—è —Ä–∞—Ö—É–Ω–∫—É –±–∞–Ω–∫–∏,4829,4829,-50000,-50000,980,0,0,1041877,False,5BPC-E224-93K7-E10P
57glc5fuA14-hp2bsw,1737041274,–ü–æ–ø–æ–≤–Ω–µ–Ω–Ω—è ¬´–†–ï–ë –¢–æ—Ä –¥–ª—è 138 –±–∞—Ç–∞–ª—å–π–æ–Ω—É –¢–†–û¬ª,8398,8398,-150000,-150000,980,0,0,1091877,False,6KPX-E5H4-5321-14TE
9Xn2hDd3uhU8O55qBw,1736951883,–ü–µ—Ä–µ–∫–∞–∑ –Ω–∞ –∫–∞—Ä—Ç–∫—É,4829,4829,-500000,-500000,980,0,0,1241877,False
_mRSXK5tNC9dqmfN7Q,1736869957,–ü–æ–ø–æ–≤–Ω–µ–Ω–Ω—è ¬´–†–ï–ë –¢–æ—Ä –¥–ª—è 138 –±–∞—Ç–∞–ª—å–π–æ–Ω—É –¢–†–û¬ª,8398,8398,-100000,-100000,980,0,0,1741877,False,3EEE-E8B9-TTAB-A9M9
gaIwV0zv2bBMp2uT0A,1736652691,–†–µ–≥—É–ª—è—Ä–Ω–µ –ø–æ–ø–æ–≤–Ω–µ–Ω–Ω—è ¬´–§–æ–Ω–¥ –ü–æ–≤–µ—Ä–Ω–∏—Å—å –∂–∏–≤–∏–º¬ª,4829,4829,-25000,-25000,980,0,0,1841877,False,H0KH-CK5X-KC25-EA9A
B8EKDh049ywk71JGMA,1736348779,–ó —á–æ—Ä–Ω–æ—ó –∫–∞—Ä—Ç–∫–∏,4829,4829,500000,500000,980,0,0,1866877,False
ONV70zXxQ75514sZ8w,1736348760,–ñ–∞–Ω–Ω–∞ –ñ.,4829,4829,-250000,-250000,980,0,0,1366877,False,HP23-07T6-4B0P-9EB7
fh3vR1uRZFpeJrMMsQ,1736348672,–ó —á–æ—Ä–Ω–æ—ó –∫–∞—Ä—Ç–∫–∏,4829,4829,1600000,1600000,980,0,0,1616877,False
gcZpS2XFFnslh_q_lw,1735813599,–ü–µ—Ä–µ–∫–∞–∑ –Ω–∞ –∫–∞—Ä—Ç–∫—É,4829,4829,-50000,-50000,980,0,0,16877,False
FRHnrqPAl4ewZ0Y-Sw,1735807809,–ü–µ—Ä–µ–∫–∞–∑ –Ω–∞ –∫–∞—Ä—Ç–∫—É,4829,4829,-200000,-200000,980,0,0,66877,False
38oFGVmtw4_8204z7g,1740678042,RPAY ROZETKA 20055,5399,5399,-42800,-42800,980,0,0,2131824,False,XKKX-XA04-T5XP-B1TM
hASTJnvphZT6vjxaJg,1740672025,–ù–æ–≤–∞ –ø–æ—à—Ç–∞,8999,8999,-6380,-6380,980,0,0,2174624,False,M020-63P4-B295-X035
TMJUrSa3QKcyb2rc-w,1740670948,–§–û–ü –ö—Ä–∞–º–∞—Ä–µ–Ω–∫–æ –í—ñ–∫—Ç–æ—Ä –ì—Ä–∏–≥–æ—Ä–æ–≤–∏—á,4829,4829,-161805,-161805,980,805,0,2181004,False,55CP-E48C-03CH-543E
cHq67-dikJJM2LIy_w,1740664110,–°—ñ–ª—å–ø–æ,5411,5411,-86900,-86900,980,0,0,2342809,False,82C7-HKA2-55HE-766P
kWetHFNkr0-F4LfyzQ,1740663388,Urbanistikafe,5812,5812,-6000,-6000,980,0,0,2429709,False,KEAC-KEME-4B8C-M39X
hEFtQI3aG6aH5aWgBg,1740663240,Ukrkhalial,5499,5499,-50282,-50282,980,0,0,2435709,False,0482-8B0K-X95T-CHB3
S33IdACeuQVfoxkEtA,1740660092,–ê–ú bistro,5812,5812,-23800,-23800,980,0,0,2485991,False,H95C-5CEX-350T-BTX9
VTHHF0fzTWbRUejFNg,1740654584,–ü–µ—Ä—à–∏–π –ü–æ–≤–µ—Ä—Ö,5812,5812,-11000,-11000,980,0,0,2509791,False,33PE-PM4P-C682-X5M9
vTO6duR7QQE9EoBQZg,1740650833,zakaz.ua,5411,5411,-371178,-371178,980,0,0,2520791,False,7K5C-XP8E-8X21-1P4E
cbs3yY6Qd6kXtVOsEQ,1740606002,ANA.FLORIST,5992,5992,-374500,-374500,980,0,0,2891969,False,38A4-C428-C7H1-T361
bQMzITxVGSWWp39GqQ,1740592862,KAFE TITKA KLARA,5814,5814,-16700,-16700,980,0,0,3266469,False,TT07-T774-T339-MCK8
RC_upPMD-5E6aF-m0g,1740574321,Rozetka,5921,5921,-433500,-433500,980,0,0,3283169,False,X93C-C707-HBK3-X5MK
Kfh1Oj6mWai0_v5O5Q,1740564575,MONO coffee,5812,5812,-7500,-7500,980,0,0,3716669,False,AT5E-K375-M1TC-AH4K
CSUrFmajCVPjaToBRw,1740561717,MasterZoo,5995,5995,-54471,-54471,980,0,0,3724169,False,07EA-BPE1-13XX-X274
XQST6BnqUAK1rjnZ9w,1740560818,Fitness23,7941,7941,-100000,-100000,980,0,0,3778640,False,MMMT-E77C-5K5K-96B1
vAYTd1qB6CO8U6aPWg,1740560385,Fitnes klub 2BFIT,7941,7941,-8000,-8000,980,0,0,3878640,False,H76M-C524-4T14-T4X2
ejzY8iDp7EjbJQpVSQ,1740503910,Bolt Food,5811,5811,-102600,-102600,980,0,0,3886640,False,3837-E39C-B9TX-A35P
Nw5boE07cBggqyHocA,1740495855,–ù–æ–≤–∞ –ø–æ—à—Ç–∞,8999,8999,-46609,-46609,980,0,0,3989240,False,K1MP-75KH-H3PH-A491
nup0g6bQYpkbVvDBtQ,1740481039,Best Way To Cup,5814,5814,-10000,-10000,980,0,0,4035849,False,0B4E-9E27-939B-2TBX
SMq-D5-G9ZHB9PGmCg,1740480660,PetStoriesZootovari,5995,5995,-239590,-239590,980,0,0,4045849,False,MHC7-3KX5-C67X-CAH4
XCRAeyAZnw8cbtMDCA,1740471572,–°—ñ–ª—å–ø–æ,5411,5411,-57500,-57500,980,0,0,4285439,False,X58K-8KT3-70PE-A0E4
Aj_q2b_yJt_kigScUg,1740470868,E-ZOO,5995,5995,-133900,-133900,980,0,0,4342939,False,AC1T-EE35-TTXX-40MM
ihqKoZk6gwRaPOiWrA,1740467197,Pethouse,5995,5995,-301400,-301400,980,0,0,4476839,False,32PA-HM7E-T9HA-2AP1
lZ8PA4VwA9FIZKW5LQ,1740431836,Steam,5816,5816,-6000,-6000,980,0,0,4778239,False,922T-K0A6-TKM7-MB3T
vii5FhIaaRgC5GzYmQ,1740422211,–ù–æ–≤–∞ –ø–æ—à—Ç–∞,8999,8999,-14300,-14300,980,0,0,4784239,False,3241-9C71-T129-H8H5
32zvrtJqgzSE5GpfrA,1740422193,–ù–æ–≤–∞ –ø–æ—à—Ç–∞,8999,8999,-6900,-6900,980,0,0,4798539,False,3C2B-K87T-C76M-PMK4
mnmP0P_XasQsEllGzg,1740422177,–ù–æ–≤–∞ –ø–æ—à—Ç–∞,8999,8999,-6000,-6000,980,0,0,4805439,False,KTTT-4XP2-3KB4-21PP
ITU3VqdAqIIV8eKbwg,1740422113,–ù–æ–≤–∞ –ø–æ—à—Ç–∞,8999,8999,-8775,-8775,980,0,0,4811439,False,MX56-8KBE-5P1M-XPB0
cP2V2AGQH6NxXlEOjA,1740420219,OkvajnSichovih,5921,5921,-20700,-20700,980,0,0,4820214,False,ABK1-M80M-HKEK-M915
Wyh2o7pIFJalE4T8lw,1740418140,LIQPAY*Food Spot Corp.,5812,5812,-129670,-129670,980,0,0,4840914,False,ME6M-1XM5-EC2H-2B62
94FCrY3fbwjNgq_3hg,1740413907,–ê–ø—Ç–µ–∫–∞ ¬´–ë–∞–∂–∞—î–º–æ –∑–¥–æ—Ä–æ–≤'—è¬ª,5912,5912,-19112,-19112,980,0,0,4970584,False,623A-EB7A-P195-HXMP
BGT54jZhdqXOIbWZyg,1740413060,IPAY.UA KyivTrans,4111,4111,-800,-800,980,0,0,4989696,False,HT23-AABX-5B41-35TH
8xGx5AYbJmhCBFQtvw,1740411318,APTEKA 13,5912,5912,-112892,-112892,980,0,0,4990496,False,8600-2XHP-6ME2-KEA1
GsjHM6iC8U-GqOv93A,1740406438,"–í–µ—Ç–ê–ø—Ç–µ–∫–∞ ""–í—ñ—Ä–Ω–∏–π –¥—Ä—É–≥""",742,742,-15000,-15000,980,0,0,5103388,False,4C0X-HM6A-0751-KTM0
nFCdSj268ltIUcDHmw,1740405740,"–í–µ—Ç–ê–ø—Ç–µ–∫–∞ ""–í—ñ—Ä–Ω–∏–π –¥—Ä—É–≥""",742,742,-427500,-427500,980,0,0,5118388,False,849B-K8XP-9K5A-EABB
GdTdnG_20IcgXMNSkA,1740405585,–¢—Ä–∏ –ú—ñ—Å—ñ—Å—ñ–ø–ø—ñ,5499,5499,-108500,-108500,980,0,0,5545888,False,66AX-1A5A-837B-1C69
HloaHkqiLszhAuiIAw,1740398476,–§–û–ü –ö–∞—á—É—Ä–æ–≤—Å—å–∫–∞ –ö–∞—Ä—ñ–Ω–∞ –í–æ–ª–æ–¥–∏–º–∏—Ä—ñ–≤–Ω–∞,4829,4829,-2311500,-2311500,980,11500,0,5654388,False,B2E5-CX4H-KHAC-6K03
EoOLznKJbsUrOmRwXw,1740398408,KAFE TITKA KLARA,5814,5814,-47000,-47000,980,0,0,7965888,False,EPAT-EEEM-CHA9-46TC
qnRPDOhbcbKyA_dC6w,1740394706,–ù–æ–≤–∞ –ø–æ—à—Ç–∞,8999,8999,-27136,-27136,980,0,0,8012888,False,7T4A-P8EC-BH5H-5PXK
Umfgr2bxxJ0XPtZqcQ,1740393717,–íi–¥: –ü–†–ò–•–û–î–¨–ö–û –ï.–í. –§–û–ü,"–î–ª—è –ø–æ–ø–æ–≤–Ω–µ–Ω–Ω—è –∫–∞—Ä—Ç–∫–∏ 5375414101190360, –ü—Ä–∏—Ö–æ–¥—å–∫–æ –ï—Ä–Ω–µ—Å—Ç –íi–∫—Ç–æ—Ä–æ–≤–∏—á, 3487403339",4829,4829,8000000,8000000,980,0,0,8040024,False
pVEsnK4Jo32On7QF7w,1740389155,–ú—ñ–∫—Å –ú–∞—Ä—Ç,5499,5499,-2700,-2700,980,0,0,40024,False,7791-P1HK-PEPC-MPH4
2bjjdv449dBDobT9Ww,1740383895,LIQPAY*Seizo,7230,7230,-20000,-20000,980,0,0,42724,False,67X1-699P-MM4E-4TT7
vaosmdNok_o2xwzHKQ,1740312991,Veterinarnaklinika,742,742,-33000,-33000,980,0,0,62724,False,2955-KHT0-7E7M-09CC
PWpUNP6dWuTIjt2_Yw,1740296772,PlanD,8999,8999,-189000,-189000,980,0,0,95724,False,99PC-725E-039E-31AX
hIdGOQlDQDOqnqzs1A,1740260308,Fonoteka,5735,5735,-229900,-229900,980,0,0,284724,False,A90B-2H4X-M31X-X3CH
qDSpZoL5Ee9Lr11rjw,1740260289,–ó –±—ñ–ª–æ—ó –∫–∞—Ä—Ç–∫–∏,4829,4829,300000,300000,980,0,0,514624,False
BjFCzkcEEhZzJvpHzw,1740239743,Best Way To Cup,5814,5814,-16000,-16000,980,0,0,214624,False,3KHB-8PB9-C673-8790
P3DbVQdpz96OyCNmoQ,1740237362,Veterinarnaklinika,742,742,-590400,-590400,980,0,0,230624,False,1708-7234-BBEA-B336
Rovqiv5qJZzza3UlgA,1740237291,–ó –±—ñ–ª–æ—ó –∫–∞—Ä—Ç–∫–∏,4829,4829,500000,500000,980,0,0,821024,False
PDQbw3ZCmrNGtEnGIw,1740235023,E-ZOO,5995,5995,-46300,-46300,980,0,0,321024,False,T752-BMAT-1HX6-C144
qSkjA7rHR5ZQBbGUdA,1740234050,produktoviymagazin,5499,5499,-4400,-4400,980,0,0,367324,False,568P-72E1-8E5X-007H
SthasWDvq0u-ZC5SSA,1740233865,–ê–ú bistro,5812,5812,-46700,-46700,980,0,0,371724,False,B13P-7CA5-MC9H-910C
iUthWPuSKOkLgj0-vA,1740233466,Fotovramci,5946,5946,-50000,-50000,980,0,0,418424,False,EAB7-M4B1-036P-89M1
jIXdua2ziAgBz1E0nA,1740165376,–°—ñ–ª—å–ø–æ,5411,5411,-94000,-94000,980,0,0,468424,False,M7PC-TCMT-2C42-77HP
9gorfPnx1npsRnGa5g,1740162914,GENESIS VETSHPYTAL,742,742,-305100,-305100,980,0,0,562424,False,9451-3393-T3H3-TAAK
lUDUJ-MoADum_1ecHQ,1740162846,–ó –±—ñ–ª–æ—ó –∫–∞—Ä—Ç–∫–∏,4829,4829,400000,400000,980,0,0,867524,False
zkVrU8Me98OvIzaCMg,1740154500,Novus,5411,5411,-17994,-17994,980,0,0,467524,False,38BM-4TT0-2XX0-E6PC
cg1LeDEz6y40n4nBJg,1740154145,–ö–£–ó–Ø,4900,4900,-45000,-45000,980,0,0,485518,False,C162-5HP1-3E47-0ABX
yA1U9xIfnhnqssU8xg,1740154108,Seizo,7230,7230,-75500,-75500,980,0,0,530518,False,A3BT-147H-C7P6-5E19
r3WB4hEmreQQMdK5Bw,1740145338,KAFE TITKA KLARA,5814,5814,-46100,-46100,980,0,0,606018,False,12EP-X06E-00KA-1025
LrlBEbnJA-iMteRFsA,1740136011,–°–∫–∞—Å—É–≤–∞–Ω–Ω—è. –ù–æ–≤–∞ –ø–æ—à—Ç–∞,8999,8999,6500,6500,980,0,0,652118,False
BhZOMf6Zy3uOJ-4GTw,1740135842,–ù–æ–≤–∞ –ø–æ—à—Ç–∞,8999,8999,-6500,-6500,980,0,0,645618,False,8A4T-KE27-90B3-PX1P
r0J_hE857AxOAC_BRg,1740135832,–ù–æ–≤–∞ –ø–æ—à—Ç–∞,8999,8999,-6500,-6500,980,0,0,652118,False
o1re0J9W1s8_-TXe0g,1740135562,Best Way To Cup,5814,5814,-11000,-11000,980,0,0,658618,False,9T2P-403B-875H-04H6
Fg31eBHZ2c7B5ykB-Q,1740135181,Prostor,5977,5977,-25500,-25500,980,0,0,669618,False,9KB4-M400-5EPC-HET4
q2rNDYxipWlHTPjbBg,1740133276,Fitness23,7941,7941,-70000,-70000,980,0,0,695118,False,8X1K-9EA6-H0KE-4P14
mZDcsKsc63CD1sNoAQ,1740073421,1007 m. Kyiv,5499,5499,-12099,-12099,980,0,0,765118,False,0E8B-3869-41E6-BC6A
YKz0WPJB_P5RJ6m8rw,1740072689,LIQPAY*Simona Ristoran,5812,5812,-60270,-60270,980,0,0,777217,False,B929-5X78-APX4-96E8
NugX0ehxZ_EbECIV_Q,1740065570,Freya,5992,5992,-30000,-30000,980,0,0,837487,False,1A64-948T-38E4-EPB3
DGTB2ByCFgYF46sAcw,1740065276,LIQPAY*Seizo,7230,7230,-20000,-20000,980,0,0,867487,False,6HKA-7M40-KK7M-P2BC
Hm--_7VBy8S_vuE_Pg,1740064545,Kafe Lagom coffee,5814,5814,-8500,-8500,980,0,0,887487,False,T9AM-304B-1MP8-3E81
VmjK5VEJvGeCK6XssQ,1740064182,Prostor,5977,5977,-22600,-22600,980,0,0,895987,False,B448-8A4T-930X-5538
igPR0NnB4INwQjvuSg,1740058754,–ó –±—ñ–ª–æ—ó –∫–∞—Ä—Ç–∫–∏,4829,4829,800000,800000,980,0,0,918587,False
11A1-44Lxkjsz3Z1zg,1740058717,MEAT BAR MIASTORIIA,5812,5812,-8500,-8500,980,0,0,118587,False,MB23-B75X-23MM-9PCA
q9VU5_vc9YG6lJ1z_g,1740058154,MEAT BAR MIASTORIIA,5812,5812,-59500,-59500,980,0,0,127087,False,14P0-T1CE-173E-MBA2
PkUHvQ_ye2iygH9mcg,1740053670,FOPMuzichukBogdanGennadiy,742,742,-1043100,-1043100,980,0,0,186587,False,EKTH-1C15-5713-028B
Leok3qUQeCcRfiVVHw,1740053148,WFP.AQUAMARKET,5411,5411,-185880,-185880,980,0,0,1229687,False,K487-6KCM-8BMP-57XT
oi09KgnD4uwk4Vh29Q,1740049415,StomatologiyaFdclinic,8021,8021,-1680000,-1680000,980,0,0,1415567,False,14H0-680A-B50K-747T
j7EEi0AneTpUwGWXug,1739994674,–°—ñ–ª—å–ø–æ,5411,5411,-104800,-104800,980,0,0,3095567,False,ATH8-KX91-AM6B-231H
_K9p9gJtf5k7xOgyuw,1739993124,GENESIS VETSHPYTAL,742,742,-460800,-460800,980,0,0,3200367,False,3AC1-T74C-5P30-258A
nvPSz21k0N7MlP7uDQ,1739981978,Rozetka,5399,5399,-22400,-22400,980,0,0,3661167,False,120T-B6E4-5E28-PBA4
M00EvL2irk-DFnXeHw,1739972232,KAFE TITKA KLARA,5814,5814,-50800,-50800,980,0,0,3683567,False,77HX-H1A5-775P-5961
arOLtp-2aCEv-_3Yig,1739971946,–ö–æ–ª–æ,5411,5499,-8300,-8300,980,0,0,3734367,False,THA8-0AEM-8C3A-P733
rvSzmgwqP9hnsxadCQ,1739961864,Fotovramci,5946,5946,-65000,-65000,980,0,0,3742667,False,P0T2-P101-7K65-4K7K
Dg1GrpswGklDnIo8JQ,1739960379,SALON KRASY BACKSTAGE,7230,7230,-55000,-55000,980,0,0,3807667,False,5C9B-2334-HXE5-9CH0
r6zm_Zx9XpcU_SJ6ZQ,1739951730,Best Way To Cup,5814,5814,-46000,-46000,980,0,0,3862667,False,E3PM-EMXP-99E2-XPE3
2MytOAM15oRrpcHa7g,1739878974,KAFE TITKA KLARA,5814,5814,-37500,-37500,980,0,0,3908667,False,0HEM-1743-8098-P911
TchKT6AA6K5osQDCtg,1739878585,–ö–æ–ª–æ,5411,5499,-5950,-5950,980,0,0,3946167,False,H6M3-E35X-84AA-0HB4
qXGPMumcOQ3J5IzgQA,1739870934,–°—ñ–ª—å–ø–æ,5411,5411,-500,-500,980,0,0,3952117,False,TP0P-87TC-6ECE-K544
ggMexFqvoT2Zp3ytvw,1739870901,–°—ñ–ª—å–ø–æ,5411,5411,-9500,-9500,980,0,0,3952617,False,PC58-X991-H977-KKC7
siUUYBGtTE3JBv-LLg,1739866371,CAFE VESNA,5812,5812,-30500,-30500,980,0,0,3962117,False,8085-P024-8M3T-EA1M
h9RL962eJdvTtG8U3g,1739866165,MEDYCHNYI TSENTR 22,8099,8099,-49000,-49000,980,0,0,3992617,False,EC23-BHE6-KA67-0P4X
WR0up5HW71w8dxdREA,1739861915,Lesya,4829,4829,-300000,-300000,980,0,0,4041617,False,HK63-4EX8-HKX0-365X
2FnEkBkmZi3QmIoLig,1739811372,LIQPAY*Dos Amigos na M,5812,5812,-58300,-58300,980,0,0,4341617,False,T76B-96HT-H3P4-0970
ByfW-56rJBjV363o_A,1739809136,Best Way To Cup,5814,5814,-18000,-18000,980,0,0,4399917,False,H9E4-M0M6-6MA1-8M2X
gXk2tSDLbZA0mwhVPg,1739807986,Best Way To Cup,5814,5814,-24000,-24000,980,0,0,4417917,False,HMM9-TXCK-1MEC-2979
L-b37n3cwllyE9RWxA,1739807927,Best Way To Cup,5814,5814,-9000,-9000,980,0,0,4441917,False,66PK-08XK-PBE2-HXK4
yxqVT1pNQWpN9kphXw,1739806469,–ù–æ–≤–∞ –ø–æ—à—Ç–∞,8999,8999,-6000,-6000,980,0,0,4450917,False,MM3B-971A-CB75-55H2
pCbqyJbrE6wtQTB1xg,1739806440,–ù–æ–≤–∞ –ø–æ—à—Ç–∞,8999,8999,-6000,-6000,980,0,0,4456917,False,M94C-2HXP-P3XB-4PX2
bX6Mx7p90feTUuVBFQ,1739803433,–í–µ—Ç–µ—Ä–∏–Ω–∞—Ä–Ω–∞—è –∞–ø—Ç–µ–∫–∞ –ë–µ—Å—Ç,742,742,-240000,-240000,980,0,0,4462917,False,H950-2T51-9090-PPE4
Z0j4-HPg8spp3R6Juw,1739793314,Uklon,4121,4121,-12600,-12600,980,0,0,4702917,False,777A-B876-2168-0504
yNBOfqqUR-9HYSlLAQ,1739788687,iPay.ua,7399,7399,-15900,-15900,980,0,0,4715517,False,7575-T6AP-8M48-KTXA
PH4az4Rc4Jnc_C8lNg,1739726530,Kafe Kaviarnia humans,5814,5814,-57500,-57500,980,0,0,4731417,False,B447-HB4M-ACBT-TBEM
2JguFjHlRmh0ZEM_ZQ,1739713276,KAFE TITKA KLARA,5814,5814,-18400,-18400,980,0,0,4788917,False,M28P-X2KA-3871-4XA3
10J4cq10Io4uPXYlHg,1739713043,Podorozhnyk,5912,5912,-42699,-42699,980,0,0,4807317,False,MT48-A240-7CB7-00M6
zAWMC3Q6kBGv0FpgYA,1739696896,CAFE VESNA,5812,5812,-5500,-5500,980,0,0,4850016,False,2C22-K04A-BT2C-EK7K
LlUC-T0Rrt2E3mbmqA,1739694304,CAFE VESNA,5812,5812,-45000,-45000,980,0,0,4855516,False,3ACK-CB6K-H700-XKP1
5wZbEiXQb8UchlzZ2g,1739694109,–ü–µ—Ä–µ–∫–∞–∑ –Ω–∞ –∫–∞—Ä—Ç–∫—É,4829,4829,-2100000,-2100000,980,0,0,4900516,False
qw6IXPKPynSzKO8IIQ,1739643369,CAFE VESNA,5812,5812,-1000,-1000,980,0,0,7000516,False,0C5T-AT22-8290-XM1E
Hf84rwZLhlvFCcM16w,1739643305,CAFE VESNA,5812,5812,-15000,-15000,980,0,0,7001516,False,TME3-KPKK-424E-XX8P
zoCAhhL6zLBwTwUC3w,1739632270,–°—ñ–ª—å–ø–æ,5411,5411,-52200,-52200,980,0,0,7016516,False,C6TT-B746-BAE9-89CB
s5UfdihWOCZMq8KlKA,1739621959,CAFE VESNA,5812,5812,-39900,-39900,980,0,0,7068716,False,81HA-133P-083A-XKXE
CNU1N5kMKMMTT3YiFQ,1739613690,E-ZOO,5995,5995,-65400,-65400,980,0,0,7108616,False,02KE-ME1A-2E4P-X6T3
vKJs6woUj9zms2VSTw,1739603927,CAFE VESNA,5812,5812,-46900,-46900,980,0,0,7174016,False,C09M-HMCK-1AB6-2005
O-l90fuppWRQ-zDjkQ,1739555565,–°–∫–∞—Å—É–≤–∞–Ω–Ω—è. CAFE VESNA,5812,5812,7100,7100,980,0,0,7220916,False
ckCribG3AmTRB135Dg,1739555512,CAFE VESNA,5812,5812,-15000,-15000,980,0,0,7213816,False
Ql9nTRQzFAsHe05eVw,1739533987,Best Way To Cup,5814,5814,-32000,-32000,980,0,0,7228816,False,X7E3-TAB9-K62P-P29K
FgGLKMQzoFhYyOkf2g,1739532262,SALON KRASY BACKSTAGE,7230,7230,-75000,-75000,980,0,0,7260816,False,85E7-BCE2-AMAC-90CA
4Y0_1W5nCxThcQPMZQ,1739527231,Fitness23,7941,7941,-70000,-70000,980,0,0,7335816,False,X4T5-5K72-B7X3-3813
zSzTwvnXpV-TlPnmcg,1739458028,Honey | –Ø—Ä–æ—Å–ª–∞–≤—ñ–≤ –≤–∞–ª,5812,5812,-32300,-32300,980,0,0,7405816,False,E25T-1TH5-5AT4-B396
HCmr2OSqqEs_sRcmYA,1739457275,"–ö–∞—Ñ–µ ""–ö–æ–º–µ—Ç–∞""",5812,5812,-102600,-102600,980,0,0,7438116,False,525B-73C2-8BK4-6THH
3Aue2BUhsI9zh3WgFg,1739452741,Steam,5816,5816,-24900,-24900,980,0,0,7540716,False,C3K7-1MT5-BT6M-2KBC
S79IxShfg0Ox-h7Myg,1739444200,Best Way To Cup,5814,5814,-8000,-8000,980,0,0,7565616,False,P243-P6A8-P452-AXK4
jfj2PViBALGPfZHZvg,1739443716,–ê–ù–¶,5912,5912,-15910,-15910,980,0,0,7573616,False,P4T5-2MA9-K83M-0B4M
RttAmYK8EYou8HRAiA,1739443326,La Fabrique,5814,5814,-7500,-7500,980,0,0,7589526,False,HC5P-BKXE-0P7M-66E2
7qlWymPkVvfmt2jHlQ,1739382875,–ù–æ–≤–∞ –ø–æ—à—Ç–∞,8999,8999,-6000,-6000,980,0,0,7597026,False,0T5E-A26A-A570-1999
G8i0nfIsmfW6iXGm_Q,1739381356,OG BURGER | –†–µ–π—Ç–∞—Ä—Å—å–∫–∞,5812,5812,-94000,-94000,980,0,0,7603026,False,2XP1-6EHE-X872-H35C
rTPGx13_BX1hM315vQ,1739377913,Parking,7523,7523,-40000,-40000,980,0,0,7697026,False,9801-6C9K-PAB5-CAA9
mqekOdZefFVt_J6LQg,1739377336,SPILKA,5812,5812,-15000,-15000,980,0,0,7737026,False,TCHM-9588-BB7H-0T72
_gWjbTra0lDMKSULZg,1739376587,StomatologiyaFdclinic,8021,8021,-33100,-33100,980,0,0,7752026,False,M085-M98C-M373-XKB8
tePosdBla7_ZVkMnxg,1739367315,Milk Bar Bakery & Breakfast,5812,5812,-29500,-29500,980,0,0,7785126,False,B4M0-59P4-BXT6-X91X
uc_7tKiXb3eA9QU2ZA,1739362200,Lesya,–ù–∞ —à—Ç—Ä–∞—Ñ,4829,4829,-120000,-120000,980,0,0,7814626,False,BX4M-T3H4-232C-5677
GmF4F3CcCA-t_YfIfg,1739351754,MIKSMART,5499,5499,-4400,-4400,980,0,0,7934626,False,0C93-C832-M19B-K8XT
T52GeYSTCLKIHfPbLQ,1739350014,Fitness23,7941,7941,-100000,-100000,980,0,0,7939026,False,4H4T-16H3-C8B2-EAK7
jB9t7_aGDXAY-z0MEA,1739297116,–°—ñ–ª—å–ø–æ,5411,5411,-90280,-90280,980,0,0,8039026,False,T68M-E5X2-92TP-8151
6x0Fyo5pecgeop-_7A,1739295999,–ù–æ–≤–∞ –ø–æ—à—Ç–∞,7399,7399,-8750,-8750,980,0,0,8129306,False,A6A4-5473-47CB-B001
Me9bcTU_9emznoCh0A,1739295984,Nova*Anastasiia Kasianova,4829,4829,-154898,-154898,980,0,0,8138056,False,T9P5-E7BM-K59E-XAK9
2-AMUWlJMPi6QpvCbg,1739270293,–íi–¥: –ü–†–ò–•–û–î–¨–ö–û –ï.–í. –§–û–ü,"–î–ª—è –ø–æ–ø–æ–≤–Ω–µ–Ω–Ω—è –∫–∞—Ä—Ç–∫–∏ 5375414101190360, –ü—Ä–∏—Ö–æ–¥—å–∫–æ –ï—Ä–Ω–µ—Å—Ç –íi–∫—Ç–æ—Ä–æ–≤–∏—á, 3487403339",4829,4829,7000000,7000000,980,0,0,8292954,False
Jmw8MCbeueNoLjnUpg,1739264237,ZOOLYUKS,5995,5995,-103050,-103050,980,0,0,1292954,False,676K-TH59-27TM-7CK1
-GP9Lr_uiBChUo96yQ,1739264197,ZOOLYUKS,5995,5995,-88740,-88740,980,0,0,1396004,False,6X51-APPP-5T6B-05B3
e4IQGwtcIpT_OIX_Hw,1739263865,Novus,5411,5411,-27858,-27858,980,0,0,1484744,False,APM5-8T6A-BXHT-A6TK
llBIRkD9DsPmT3Rt2A,1739260558,–ù–æ–≤–∞ –ø–æ—à—Ç–∞,8999,8999,-12975,-12975,980,0,0,1512602,False,5XK2-C021-H0HB-87M9
TWzZmkh7CxSJe061bg,1739260535,–ù–æ–≤–∞ –ø–æ—à—Ç–∞,8999,8999,-8625,-8625,980,0,0,1525577,False,T9K3-5MXM-P6E9-80C2
9E4H6cJwI8Z7V-Cvwg,1739258889,Best Way To Cup,5814,5814,-47500,-47500,980,0,0,1534202,False,PX90-BTT0-KC46-XMKT
moZrezLN6unDhUATQA,1739226587,Steam,5816,5816,-44559,-44200,980,0,0,1581702,False,84KB-1M35-C4B0-T6E2
Tjm5TOTDsM-57U12qQ,1739209889,–°—ñ–ª—å–ø–æ,5411,5411,-41008,-41008,980,0,0,1626261,False,1H1T-BAEM-10CC-46BK
sb6McIZgnI_0BdG_ug,1739209603,E-ZOO,5995,5995,-48100,-48100,980,0,125,1667269,False,9598-XKTX-MK4T-8BT6
yHXxiI-lQvNM07IyeQ,1739209319,–°—ñ–ª—å–ø–æ,5411,5411,-66300,-66300,980,0,0,1715369,False,M1C0-4080-727A-E6M5
ZCZuze_aUdaumo382A,1739208710,SECHST,5912,5912,-28153,-28153,980,0,0,1781669,False,PT1X-5E38-91T4-3C7P
w4kTPYIPMuI2Y1pydQ,1739207163,Ponchyk Boy | –û–ª–µ—Å—è –ì–æ–Ω—á–∞—Ä–∞,5812,5812,-32800,-32800,980,0,0,1809822,False,T5PB-9H9X-P7E6-784B
xAr37-lGvGsA2xQOfg,1739206162,GENESIS VETSHPYTAL,742,742,-50000,-50000,980,0,375,1842622,False,57XM-81E6-H6K4-0KHE
yktbM4ngQi--RiN4CA,1739206032,GENESIS VETSHPYTAL,742,742,-340000,-340000,980,0,24067,1892622,False,PXC6-P4PP-05XE-3481
xYaA9kTPj_VDoiW8OQ,1739199564,Sezane,5621,5621,-468730,-10800,978,0,0,2232622,False,6502-0HB9-K34P-P2BM
XQqqJuaeoFJzcOKizw,1739193232,536354****1184,4829,4829,-880000,-880000,980,0,0,2701352,False,MC5M-M7C5-575C-P7AP
uJ11bJukrl6njP7HqA,1739191675,Kafe Kharms,5814,5814,-7200,-7200,980,0,0,3581352,False,638X-TE74-TPP5-3B7C
xCcGRqinpJIx3z7d1g,1739178861,Fitness23,7941,7941,-100000,-100000,980,0,0,3588552,False,869X-1HBH-12B2-T023
fgp7iYygVfLxH4N29A,1739170944,LIQPAY*Pethouse,5995,5995,-155400,-155400,980,0,15540,3688552,False,M9B1-MP9A-M154-PA0C
T9KQqWkdk74INa8l7g,1739114545,Tovaridlyadomu,5399,5399,-30800,-30800,980,0,0,3843952,False,7B61-263T-4A13-9549
wRJ9Q9bsPPqFE87XUg,1739112669,Noodes,5812,5812,-93400,-93400,980,0,0,3874752,False,CPB4-KPT9-AHK2-T0C7
ax2LVrCffJt4Vi-fRA,1739104342,Uklon,4121,4121,-20000,-20000,980,0,0,3968152,False,C0B9-348A-30BE-9630
ifpX4XDMAoPUEgPIBA,1739094155,TSUM,7523,7523,-20000,-20000,980,0,0,3988152,False,22K5-39BC-X9B4-394M
uVJUs3BQ5yB4x03yPg,1739092693,Milk Bar | –¶–£–ú,5812,5812,-119900,-119900,980,0,0,4008152,False,MC5C-AC95-3K4X-EB8K
DgZMHbapzmXWWgmCxg,1739021897,"Lifecell
+380631692598",4814,4814,-30000,-30000,980,0,0,4128052,False,1XX8-X2HE-MC25-50B7
Yno1W_raqM0cWqtF1A,1739019629,–ù–æ–≤–∞ –ø–æ—à—Ç–∞,8999,8999,-6800,-6800,980,0,0,4158052,False,8TT2-T651-2T96-X7K9
vAE4eTo8oo_ZHoK_dg,1739016887,–ü–æ–ø–æ–≤–Ω–µ–Ω–Ω—è ¬´–ß–∞–π–æ–≤—ñ –∫–æ–º–∞–Ω–¥—ñ bwtc¬ª,–ü–æ–ø–æ–≤–Ω–µ–Ω–Ω—è —Ä–∞—Ö—É–Ω–∫—É –±–∞–Ω–∫–∏,4829,4829,-5000,-5000,980,0,0,4164852,False,35MM-E3AT-65T3-K7TB
3UnYVIXpiV0YnrH83A,1739016867,Best Way To Cup,5814,5814,-9000,-9000,980,0,0,4169852,False,4059-6M9A-9HXA-BMAP
2ITi90QuUSsGScOEdg,1739016419,Ponchyk Boy | –û–ª–µ—Å—è –ì–æ–Ω—á–∞—Ä–∞,5812,5812,-34800,-34800,980,0,0,4178852,False,K5H4-ACHM-H9E7-K7A1
bK3Vbf94bFsKQDhhcw,1739015515,Freya,5992,5992,-150000,-150000,980,0,7500,4213652,False,A9TX-P4EX-XKK2-K904
Wcy-4xpi6U0FWUlxTQ,1738934667,–ù–æ–≤–∞ –ø–æ—à—Ç–∞,7399,7399,-7000,-7000,980,0,0,4363652,False,TCP6-9MAA-2KK9-C4A3
o8G7bd7ywAcLh7sVAA,1738933117,–ö–Ω–∏–≥–∞—Ä–Ω—è ¬´–°–µ–Ω—Å¬ª,5942,5942,-14000,-14000,980,0,0,4370652,False,XK6P-AKBP-AC69-21K9
xB-OIgLfH4um6reTAA,1738928004,–°–µ–Ω—Å | –•—Ä–µ—â–∞—Ç–∏–∫,5812,5812,-13500,-13500,980,0,0,4384652,False,3EPH-H38A-E8C6-A0X8
J-cXEd7T3Qw3wxt8oA,1738918889,Fitness23,7941,7941,-100000,-100000,980,0,0,4398152,False,M204-871X-7H5M-2KTC
OYA5SMms-Sg3oJB_Zw,1738869319,Honey | –ù–∏–∂–Ω—ñ–π –í–∞–ª,5812,5812,-62200,-62200,980,0,0,4498152,False,B4H5-EBAT-AE5B-453P
EhO3Hsj4v-o5wvfqMg,1738868978,–ñ–∞–Ω–Ω–∞ –ñ.,4829,4829,-50000,-50000,980,0,0,4560352,False,3P61-E9P6-XPB5-C3BA
z3wPqHYFhiCxSHRU4Q,1738868832,–ñ–∞–Ω–Ω–∞ –ñ.,4829,4829,-250000,-250000,980,0,0,4610352,False,6C0H-TE34-68XH-8XE7
qKvqcP_392TctpIi9A,1738842952,–í—ñ–¥: –ë–æ–≥–¥–∞–Ω –ë—ñ–ª–æ—à–∏—Ü—å–∫–∏–π,4829,4829,300000,300000,980,0,0,4860352,False
xBIaK5nsoHm0scdfbQ,1738838607,Ukrkhalial,5499,5499,-54762,-54762,980,0,0,4560352,False,00E6-MB1X-384P-XAX7
-NUv0Ol-pKwSjSC5Og,1738838092,–°—ñ–ª—å–ø–æ,5411,5411,-18500,-18500,980,0,0,4615114,False,H03B-C898-22A8-X1MA
OC-rOE2wUNCmSzwaxg,1738825588,Right coffee bar,5814,5814,-20000,-20000,980,0,0,4633614,False,870M-9EK0-T31B-6HE1
E5EX_vz3kidE30-bYw,1738825172,KAFE TITKA KLARA,5814,5814,-16800,-16800,980,0,0,4653614,False,K4AX-30HM-5TPK-8E3H
AiDqKnuyQOZqqnHWVA,1738780982,TSUM,7523,7523,-30000,-30000,980,0,0,4670414,False,HMMH-E958-AHB2-52P5
TIovYzded03BVqNvTw,1738771556,–ü–æ–ø–æ–≤–Ω–µ–Ω–Ω—è ¬´–ó–±—ñ—Ä –Ω–∞ –∞–≤—Ç–æ¬ª,–ü–æ–ø–æ–≤–Ω–µ–Ω–Ω—è —Ä–∞—Ö—É–Ω–∫—É –±–∞–Ω–∫–∏,4829,4829,-100000,-100000,980,0,0,4700414,False,T6E7-46EE-EEE8-402T
HjhyhEwQtdYE6Ymt3w,1738764905,WFP.AQUAMARKET,5411,5411,-179610,-179610,980,0,0,4800414,False,0942-M87A-10M9-857P
boD-G28ZIs68lXAJgQ,1738763536,zakaz.ua,5411,5411,-274009,-274009,980,0,0,4980024,False,P7EC-3HMA-X1MC-5AP1
sQ3y3vPd5U7Z5xXVbg,1738758989,–°—ñ–ª—å–ø–æ,5411,5411,-122800,-122800,980,0,0,5254033,False,XP64-55K9-1X7T-85BK
RzXtgF12uN0KgfUEHg,1738758561,MERCI-MERCI.COM,5712,5712,-627055,-14300,978,0,0,5376833,False,777H-725H-HB91-HPH9
a26yUdIkFDE-qcW29g,1738758348,–íi–¥: –ü–†–ò–•–û–î–¨–ö–û –ï.–í. –§–û–ü,"–î–ª—è –ø–æ–ø–æ–≤–Ω–µ–Ω–Ω—è –∫–∞—Ä—Ç–∫–∏ 5375414101190360, –ü—Ä–∏—Ö–æ–¥—å–∫–æ –ï—Ä–Ω–µ—Å—Ç –íi–∫—Ç–æ—Ä–æ–≤–∏—á, 3487403339",4829,4829,5800000,5800000,980,0,0,6003888,False
JXyCCYunUVB8uoK2Zw,1738745711,Fitness23,7941,7941,-100000,-100000,980,0,0,203888,False,EAE6-32TX-7E1B-X223
-oObhQlpTMKkoyb2ow,1738697779,NovaPay,8999,8999,-6000,-6000,980,0,0,303888,False,B12H-H3EP-326A-4AM9
7z-ubQjWcuKFW7E_ug,1738688547,OK Wine,5921,5921,-66800,-66800,980,0,0,309888,False,8B7T-P395-5189-E9PM
IXamOODaQrWDdd3CNQ,1738688290,Novus,5411,5411,-200268,-200268,980,0,0,376688,False,AK00-1425-HM4P-743P
UjlKa6kofvaoCevOUw,1738677994,Best Way To Cup,5814,5814,-44000,-44000,980,0,0,576956,False,X88C-66MH-4CMK-48TH
1Wra-e69hejvMw_nGg,1738667393,LIQPAY*Pethouse,5995,5995,-112600,-112600,980,0,844,620956,False,H04A-M979-XB47-381B
um9-HxcxGu2CsRSYNQ,1738667372,LIQPAY*Pethouse,5995,5995,-206600,-206600,980,0,1549,733556,False,7EB1-B2B1-068X-X97C
PYV0oXcaX0SvTeelgg,1738663087,Zigzag,5814,5814,-32500,-32500,980,0,0,940156,False,AH48-4T89-K5B0-9EMT
D1IUaGWYPiLQfDSc_A,1738657659,–°–∫–∞—Å—É–≤–∞–Ω–Ω—è. LIQPAY*Pethouse,5995,5995,319300,319300,980,0,-2394,972656,False
bm4xI-fQ7dDOmSkYLw,1738652571,NovaPay,8999,8999,-6000,-6000,980,0,0,653356,False,6843-CE9T-AH51-A64M
McNy08I1L92VeUwNeA,1738652290,NovaPay,8999,8999,-6000,-6000,980,0,0,659356,False,PA51-6035-28B5-KC9C
99hIXNTql0nl6VX15g,1738618282,LIQPAY*Pethouse,5995,5995,-319300,-319300,980,0,2394,665356,False
8aBlbM7teFdP_skN5g,1738593872,UNIVERSUM CLINIC,8099,8099,-260000,-260000,980,0,0,984656,False,25HK-HB4B-3X4H-22X8
P-nMypt1UA4xoZJfVg,1738589849,OK Wine,5921,5921,-8300,-8300,980,0,0,1244656,False,AHC8-B19K-B0B7-X406
aqKbff_fFYim-iaWMw,1738589399,–ê–ú bistro,5812,5812,-78000,-78000,980,0,0,1252956,False,4ACH-7382-6E2A-CX5K
LDJoeee30r76OcyLHA,1738578538,Fdclinic,8021,8021,-60000,-60000,980,0,0,1330956,False,5XCC-72MP-P137-HX8M
z-ICBK62upj8g6jlsw,1738575397,*=34044,5912,5912,-12890,-12890,980,0,0,1390956,False,1A5B-7T13-0T91-393P
6P9gIThDAP6JpDiGIw,1738569494,Fitness23,7941,7941,-209900,-209900,980,0,0,1403846,False,24KT-168C-1279-0C1P
DC99j2aCtxszeqQfZA,1738501883,Ponchyk Boy | –û–ª–µ—Å—è –ì–æ–Ω—á–∞—Ä–∞,5812,5812,-33800,-33800,980,0,0,1613746,False,239T-CP1X-H125-MX25
cYcJpYGCkAgZzgQL2g,1738492890,ICE PHOTO,7395,7395,-60000,-60000,980,0,0,1647546,False,XB0P-P7KH-54H6-9A5M
RmlGs-yK7ymlQa4trA,1738489699,FOP Cherkas Dmitro 1,7999,7999,-27000,-27000,980,0,0,1707546,False,TBHX-AC22-9P0M-7AC6
VlpsJRBXkAhmIQBIbQ,1738489382,–û–ø–ª–∞—Ç–∞ —à—Ç—Ä–∞—Ñ—É,4900,4900,-17000,-17000,980,0,0,1734546,False,5E1E-C8B6-3130-A1M1
d2vUIP8sCvRw3OYfUg,1738489377,–û–ø–ª–∞—Ç–∞ —à—Ç—Ä–∞—Ñ—É,4900,4900,-17000,-17000,980,0,0,1751546,False,BK1M-79M4-KH18-B576
sh0n-RIEdUJob6wpEg,1738486505,FOP Cherkas Dmitro 5,7999,7999,-25000,-25000,980,0,0,1768546,False,33CE-K8TE-E0PX-A090
MG4OepJhVowgew46sg,1738486477,FOP Cherkas Dmitro 5,7999,7999,-80000,-80000,980,0,0,1793546,False,H89A-HM8A-XCB2-9512
Yv8QdCsw5Or7h2XPig,1738478735,WFP.CONSULT1,7277,7277,-25000,-25000,980,0,0,1873546,False,0E4H-K5T4-8B99-1EB5
eTMV-txDsCTAvvmqmQ,1738419651,PUMA,5655,5941,-158000,-158000,980,0,0,1898546,False,40AK-KXM3-XMHT-BC03
t6MF6wojhveXwuEikw,1738402171,–£–∫—Ä–Ω–∞—Ñ—Ç–∞,5541,5541,-166721,-166721,980,0,0,2056546,False,MAH0-PH29-X841-6XE7
GWTaUrwV88WERP0rmQ,1738399318,CAFE VESNA,5812,5812,-19500,-19500,980,0,0,2223267,False,24MC-530C-732X-2081
ePGLXgP1eZsMNkzUdg,1738399013,MEDYCHNYI TSENTR 22,8099,8099,-188000,-188000,980,0,0,2242767,False,KP4E-E51C-2M98-P9M2
Nil01YzZv33U8LjUow,1738398185,–ü–µ—Ç—Ä–æ –ú.,4829,4829,-85000,-85000,980,0,0,2430767,False,EH8E-8MK9-59P0-EAH7
0aErTbNAdoqDAnQIZQ,1738395025,–ê–ø—Ç–µ–∫–∞ ¬´–ë–∞–∂–∞—î–º–æ –∑–¥–æ—Ä–æ–≤'—è¬ª,5912,5912,-21930,-21930,980,0,0,2515767,False,C391-7C90-372C-2BMH
Kd9OFgeQB5Yd617_pw,1738393472,Best Way To Cup,5814,5814,-76600,-76600,980,0,0,2537697,False,HXHP-MXTB-8810-TAX7
xHdlcI2HZ2N0KpfyOEwd,1738369519,Bolt,4121,4121,-19400,-19400,980,0,0,2614297,True
Hr7u9YP5HVyNEICjpYMfVdc1kAI,1738369519,–°–∫–∞—Å—É–≤–∞–Ω–Ω—è. Bolt,4121,4121,16400,16400,980,0,0,2633697,False
vLUIJNUp8DOZ1wYhRw,1740495771,P24 *Prykhodko Oksana,6012,6012,200000,200000,980,0,0,214877,False
Wze6rlhyae3AbN-lAA,1740260289,–ü–µ—Ä–µ–∫–∞–∑ –Ω–∞ –∫–∞—Ä—Ç–∫—É,4829,4829,-300000,-300000,980,0,0,14877,False
hk8bEBNFVyty5fXUhw,1740237291,–ü–µ—Ä–µ–∫–∞–∑ –Ω–∞ –∫–∞—Ä—Ç–∫—É,4829,4829,-500000,-500000,980,0,0,314877,False
A7IhVIANwMZxhlpYQg,1740162846,–ü–µ—Ä–µ–∫–∞–∑ –Ω–∞ –∫–∞—Ä—Ç–∫—É,4829,4829,-400000,-400000,980,0,0,814877,False
tp6TSSL_Ya3azVGaHA,1740126787,—è–π—Ü—è –º–µ–¥,4829,4829,-12000,-12000,980,0,0,1214877,False,2400-TEXM-HP24-9A5K
Z3wiNU502zvYWv-HOQ,1740072014,–õ—ñ–ª—ñ—è –ö.,4829,4829,-90000,-90000,980,0,0,1226877,False,4HE5-4K1A-8XHX-6B9K
KcWUIC30_D87kd4tCg,1740058753,–ü–µ—Ä–µ–∫–∞–∑ –Ω–∞ –∫–∞—Ä—Ç–∫—É,4829,4829,-800000,-800000,980,0,0,1316877,False
4ZXhJlvjBYUXnmxsZQ,1739694110,–ó —á–æ—Ä–Ω–æ—ó –∫–∞—Ä—Ç–∫–∏,4829,4829,2100000,2100000,980,0,0,2116877,False
SYvkAG7OOrpRj2QzWA,1739676728,–†–µ–≥—É–ª—è—Ä–Ω–µ –ø–æ–ø–æ–≤–Ω–µ–Ω–Ω—è ¬´–§–æ–Ω–¥ –ü–æ–≤–µ—Ä–Ω–∏—Å—å –∂–∏–≤–∏–º¬ª,4829,4829,-25000,-25000,980,0,0,16877,False,740K-EC0P-T371-2TP7
Dqm-l2l3Qs5XPl61tw,1739071934,–†–µ–≥—É–ª—è—Ä–Ω–µ –ø–æ–ø–æ–≤–Ω–µ–Ω–Ω—è ¬´–§–æ–Ω–¥ –ü–æ–≤–µ—Ä–Ω–∏—Å—å –∂–∏–≤–∏–º¬ª,4829,4829,-25000,-25000,980,0,0,41877,False,7XA0-89P2-TP29-BM7X
pFfbq-AQ-YEwxcGhpw,1738583457,–ê–Ω—Ç–æ–Ω –Ø.,4829,4829,-20000,-20000,980,0,0,66877,False,P9M8-9T8T-8PHB-69B1
fRQMaXn4fAiULkrs5A,1738467167,–†–µ–≥—É–ª—è—Ä–Ω–µ –ø–æ–ø–æ–≤–Ω–µ–Ω–Ω—è ¬´–§–æ–Ω–¥ –ü–æ–≤–µ—Ä–Ω–∏—Å—å –∂–∏–≤–∏–º¬ª,4829,4829,-25000,-25000,980,0,0,86877,False,0AM6-33MX-5A78-7TPM
H7OLRrnWIMY5NH9q9Q,1743335558,–ü–µ—Ä—à–∏–π –ü–æ–≤–µ—Ä—Ö,5812,5812,-18200,-18200,980,0,0,6277,False,316E-X79X-T7KX-X215
53mfiCIxz-AbPyU-3g,1743334958,Fotovramci,5946,5946,-90000,-90000,980,0,0,24477,False,E468-C0P3-6M6X-5PA0
z9u58r__wJ74YkWzIg,1743318769,Novus,5411,5411,-73295,-73295,980,0,0,114477,False,3213-CT6B-HM6B-BPTT
vGst3uikPZyIWEZxPg,1743316271,–ù–æ–≤–∞ –ø–æ—à—Ç–∞,8999,8999,-6350,-6350,980,0,0,187772,False,XXMC-0TXC-CCCX-8864
DaWx5mB0M3lzjWwlew,1743315348,–ü–ª–∞—Ç—ñ–∂ MOYO,4829,4829,-49983,-49983,980,0,0,194122,False
P8MnnKTb76wYOWld_A,1743259721,–ö–ò–á–í–ì–ê–ó,5812,5812,-44500,-44500,980,0,0,244105,False,40EE-E7CE-12H1-H68T
l613QXnpesH8dPh10Q,1743257332,–û–ö–ö–û,5541,5541,-61990,-61990,980,0,0,288605,False,E2PA-TBC4-PPAM-2M9P
W2twBEIhscmCDxt15g,1743244265,Best Way To Cup,5814,5814,-22000,-22000,980,0,0,350595,False,44EC-T7PK-8250-HBME
UQUF1M71zwxqOEu-Wg,1743243079,Best Way To Cup,5814,5814,-69500,-69500,980,0,0,372595,False,8938-8332-8XMX-T6K9
pLirJHPzDZlsD8Oejg,1743240253,–®—Ç—Ä—É–¥–µ–ª—å–û–∫,5499,5499,-3000,-3000,980,0,0,442095,False,8261-K37M-T8X0-BC34
P_vVG8w3T1Yk5sBw3w,1743225385,–ù–æ–≤–∞ –ø–æ—à—Ç–∞,8999,8999,-9000,-9000,980,0,0,445095,False,06CK-31T3-4TMA-5EXH
eMivPak58GNpOLojjg,1743176402,–°—ñ–ª—å–ø–æ,5411,5411,-9900,-9900,980,0,0,454095,False,PX8B-748B-03A1-X9B0
FYkSJTI5ugQ2cEFjrw,1743174065,–û—Ñ—ñ—Å-—á–∞–π,5812,5812,-12700,-12700,980,0,0,463995,False,B51A-B801-HC4A-K28A
B50U3Sd3AS_9VxmznA,1743172409,Sprut salon,7230,7230,-80000,-80000,980,0,0,476695,False,H06K-889M-68PT-H287
YMKxkzhKiZ3xpSqylw,1743157817,–ú—ñ–∫—Å –ú–∞—Ä—Ç,5411,5411,-4200,-4200,980,0,0,556695,False,B79H-1CB1-63T7-30MP
4rvk_F8OEM7Dc0En8Q,1743157202,Fitnes klub 2BFIT,7941,7941,-80000,-80000,980,0,0,560895,False,43K5-AK75-7B92-HM0M
n9ImVijfoWFSt4wYdQ,1743152968,Rozetka,5399,5399,-16200,-16200,980,0,0,640895,False,96T4-5C88-EC45-439A
Uq0p986zrxzvWxW6Gw,1743152938,Rozetka,5399,5399,-22100,-22100,980,0,0,657095,False,TCT3-70P0-CXHM-7CAE
e4FmteBr8VBVtiWRnA,1743151411,E-ZOO,5995,5995,-86900,-86900,980,0,4345,679195,False,P6P4-243K-EE6H-TEEB
5uqD8SwAjVR9H1pw5Q,1743151149,–°—ñ–ª—å–ø–æ,5411,5411,-20400,-20400,980,0,0,766095,False,8A8C-E9TA-4163-9EH0
w_kQm0G4A9OjWyCgqg,1743150903,–°—ñ–ª—å–ø–æ,5411,5411,-20898,-20898,980,0,0,786495,False,68XX-B613-CC9P-PBMH
eQKY_uUALrl9kCGPVQ,1743148360,FK KONTRAKTOVYI DIM,7538,7538,-184200,-184200,980,0,0,807393,False,M3PM-0A39-46HC-5B5B
Y50jk80tyOEkib6J9Q,1743143627,Best Way To Cup,5814,5814,-41700,-41700,980,0,0,991593,False,K6H6-0B6M-K66A-9T3M
7kqCggxx-13cmwE7wA,1743143436,FOP Shevchenko,5499,5499,-9000,-9000,980,0,0,1033293,False,XPP1-M3EH-7999-XC77
8ZRl_WNZsQW5Z-Ov2Q,1743102430,Uklon,4121,4121,-2600,-2600,980,0,0,1042293,False,733K-7TEB-86M2-23PM
kzeQqhVln5_UW8Rv5g,1743099742,Uklon,4121,4121,-43100,-43100,980,0,0,1044893,False,1HKH-2PHE-A3P0-96MA
6yUNa1zy-qJasW-fGg,1743098009,Best Way To Cup,5814,5814,-8000,-8000,980,0,0,1087993,False,C0KA-2B2H-C354-C991
j-xctkwu9YqpuTADrQ,1743088772,Magazin,5499,5499,-1898,-1898,980,0,0,1095993,False,878M-3T92-X88P-TPT5
4untLZMtMuQCVLuEdQ,1743088541,WFP.GROCERY1,5499,5499,-40494,-40494,980,0,0,1097891,False,32M5-M0H5-70E7-0PTC
JK2DVLFbNE_p3gu0Vw,1743087694,APTEKA 25,5912,5912,-5321,-5321,980,0,0,1138385,False,P6A9-E0EB-KBT5-XT0K
DLLRgb5ChHrucNVIiA,1743080548,Kaviarnia KAShTAN,5812,5812,-10000,-10000,980,0,0,1143706,False,A4TC-1367-XB4M-7K21
_9Ra26xREZlwVX4h7A,1743073748,Kafe Kaviarnia humans,5814,5814,-12000,-12000,980,0,0,1153706,False,69A2-3K1X-2441-HMAM
fAxZViEQWgmqWRwfpw,1743062283,–ù–æ–≤–∞ –ø–æ—à—Ç–∞,8999,8999,-8000,-8000,980,0,0,1165706,False,48AK-20XA-EE78-TBT8
ZBiF-3MT0LkVFkxS7g,1743061858,Uklon,4121,4121,-8500,-8500,980,0,0,1173706,False,M11X-9B36-K1AK-8XT3
dw4k_XnictNkefQqUA,1743058636,–§–æ—Ä–∞,5411,5411,-3770,-3770,980,0,0,1182206,False,KMBB-EC27-4K27-MM55
lH9gBl-ZeHMfzrpSTg,1743013537,–ù–æ–≤–∞ –ø–æ—à—Ç–∞,8999,8999,-25748,-25748,980,0,0,1185976,False,6TE9-PA68-KBA2-XKXC
yGlB9BC0CH7wZ87xvg,1743005112,–°—ñ–ª—å–ø–æ,5411,5411,-116800,-116800,980,0,0,1211724,False,MTMT-TXAX-M48P-0E3C
cS5W-bRRhX6WqZYCCg,1743002931,Fitnes klub 2BFIT,7941,7941,-80000,-80000,980,0,0,1328524,False,EP30-B74M-M134-TCCC
3BhO5Q-Z393EzeJPcA,1742997443,Best Way To Cup,5814,5814,-8500,-8500,980,0,0,1408524,False,B4XK-1HP1-49A0-C3A1
XdqUupmkmnAdbAOAcw,1742980457,Vitach,5462,5462,-5500,-5500,980,0,0,1417024,False,0E40-HX23-H3E9-0A95
5ScYyJCVkAsbKB_J6w,1742979982,Vitach,5462,5462,-127000,-127000,980,0,0,1422524,False,C5C0-4HE6-69AE-064B
BZnkwoGifYGwVaEBeg,1742977598,Vitach,5462,5462,-121500,-121500,980,0,0,1549524,False,6E1X-5P1X-8BA2-XHTH
LjETg3hgTuW26ALlbg,1742973272,Vitach,5462,5462,-11000,-11000,980,0,0,1671024,False,M181-675K-120E-84KT
xC6gLpvTfwy_CskH-Q,1742929585,OkvajnSichovih,5921,5921,-85500,-85500,980,0,0,1682024,False,24A3-2CXH-57BP-C4CA
d16EvZoExwaUiaCGBA,1742928918,LIQPAY*Simona Ristoran,5812,5812,-18375,-18375,980,0,0,1767524,False,0XE3-HC7M-T34A-TM33
_J6OdWUCBj6Jgy-sVw,1742913234,Best Way To Cup,5814,5814,-11000,-11000,980,0,0,1785899,False,X2A8-3BPK-KH11-7M21
ga3_nwE2dEs0ZXn7Rw,1742897844,THE VARENIK,5814,5814,-6500,-6500,980,0,0,1796899,False,E833-KX8M-EPCK-P17C
6-o9yxsh02YtPbteOA,1742897759,–ü–µ—á–µ–Ω–∞ –∫–∞—Ä—Ç–æ–ø–ª—è,5814,5814,-27500,-27500,980,0,0,1803399,False,KAKP-9EXB-98P2-MK3P
gZn_ynZCH-9-ADICNA,1742895071,FEEL FINE,5977,5977,-18400,-18400,980,0,0,1830899,False,PA9M-8XM6-HH0T-PTK5
2Q53qQCwklCznbkWVw,1742837216,–ù–æ–≤–∞ –ø–æ—à—Ç–∞,8999,8999,-8000,-8000,980,0,0,1849299,False,7H04-5B4C-T9K0-2K6X
psfYLPETzUZsU6_CvA,1742819846,–ö–∏—Ü—É–Ω—è,5812,5812,-69500,-69500,980,0,0,1857299,False,M071-XK97-8CC5-5MKA
b_eif1OZb3Ky9fRHMA,1742808919,–•–ª—ñ–±–Ω–∞ –ö–∞–≤–∞,5462,5462,-2400,-2400,980,0,0,1926799,False,7408-H686-E36X-57E0
o4-gt1WTHuZVpvKaxw,1742808657,Fitnes klub 2BFIT,7941,7941,-70000,-70000,980,0,0,1929199,False,P3X0-2B49-1P5M-33B0
agOaJcLCdvK42_0Ojw,1742798391,Best Way To Cup,5814,5814,-22500,-22500,980,0,0,1999199,False,E5TT-531B-PEH0-95MT
9tbHIF9CB7CMgS8XAw,1742733550,–¢–†–¶ Respublika Park,5511,5511,-8000,-8000,980,0,0,2021699,False,6E96-HAKC-7518-C8KP
zMMWWb6Aw8OLyKGwuQ,1742721954,Best Way To Cup,5814,5814,-11000,-11000,980,0,0,2029699,False,C628-MMT0-TH6E-70AM
0xaFsWFQ7aGYHXHuOA,1742719110,MasterZoo,5995,5995,-38790,-38790,980,0,0,2040699,False,53P5-5PAA-8B29-7286
ZdsoTgh9MrFwl80Jiw,1742718769,SALON KRASY BACKSTAGE,7230,7230,-36000,-36000,980,0,0,2079489,False,PB51-MKM5-5136-T5M6
djnFFL3HFkBY_w9Lmw,1742678623,–ù–æ–≤–∞ –ø–æ—à—Ç–∞,8999,8999,-9391,-9391,980,0,0,2115489,False,588E-K12C-PH1H-MK32
vV5_brt5DtY0EgPwgQ,1742670304,Mias-Mias,5995,5995,-48500,-48500,980,0,0,2124880,False,MM23-318M-X5XM-H290
ToGRsum-R-kJEclSpw,1742663071,–ü–µ—Ä–µ–∫–∞–∑ –Ω–∞ –∫–∞—Ä—Ç–∫—É,4829,4829,-400000,-400000,980,0,0,2173380,False
LAB2zWADhzxK2iGW6w,1742663059,431414****1502,4829,4829,-200000,-200000,980,0,0,2573380,False,8AXB-C500-X8T3-1MB2
eY3V6pUOMsewGR1chw,1742655946,PINA,5812,5812,-46000,-46000,980,0,0,2773380,False,EET5-5CAB-8290-4BEC
cCAL3CxmpiltJFdeiw,1742652333,–ö–æ–ª–æ,5411,5499,-2950,-2950,980,0,0,2819380,False,1B57-T8XK-59H0-03CP
hGMmnVjcpm6U_-f2ow,1742652092,–¢—ñ—Ç–∫–∞ –ö–ª–∞—Ä–∞,5814,5814,-13100,-13100,980,0,0,2822330,False,1B34-B9TP-87EK-3B84
L1QYGVxt7N8tzP5hig,1742643634,MasterZoo,5995,5995,-70122,-70122,980,0,0,2835430,False,MPEM-7ET6-64A9-BX27
rnqkptvX3elitE7gCg,1742636493,–û–ö–ö–û,5541,5541,-16900,-16900,980,0,0,2905552,False,0KXC-7P7P-MBM1-5X9T
W-psON2zv3sSxumRDA,1742624213,–°—ñ–ª—å–ø–æ,5411,5411,-168929,-168929,980,0,0,2922452,False,H773-4T3X-097H-52TE
cp7jMA-Ac35pkN7y-w,1742580221,Food Spot,5812,5812,-125300,-125300,980,0,0,3091381,False,K4E5-328T-C782-1M7X
SL1wpalekaScJEnKZA,1742578157,–ê–ø—Ç–µ–∫–∞ –æ–ø—Ç–æ–≤–∏—Ö —Ü—ñ–Ω,5912,5912,-31030,-31030,980,0,0,3216681,False,7A40-0B5H-7X02-4MEB
cG2rDdITo_PYJQ3xzA,1742566355,PetStoriesZootovari,5995,5995,-29640,-29640,980,0,0,3247711,False,M5MX-3A58-CH47-E697
7oqTFGmuyoXSApTlJg,1742565556,t.c.pizza,5812,5812,-55500,-55500,980,0,0,3277351,False,XK3T-63H5-K664-566X
PQnkAOVQVgpU3KusmQ,1742551991,Fitnes klub 2BFIT,7941,7941,-73000,-73000,980,0,0,3332851,False,B3HC-K4C1-8XTT-KBB1
AtfP8ynQRDGLbIHp3A,1742544462,–íi–¥: –ü–†–ò–•–û–î–¨–ö–û –ï.–í. –§–û–ü,"–î–ª—è –ø–æ–ø–æ–≤–Ω–µ–Ω–Ω—è –∫–∞—Ä—Ç–∫–∏ 5375414101190360, –ü—Ä–∏—Ö–æ–¥—å–∫–æ –ï—Ä–Ω–µ—Å—Ç –íi–∫—Ç–æ—Ä–æ–≤–∏—á, 3487403339",4829,4829,3000000,3000000,980,0,0,3405851,False
deYinaGOcc1TcwsplQ,1742544315,FOP Shevchenko,5499,5499,-10000,-10000,980,0,0,405851,False,87C7-TX0K-BB87-4MMP
p0dZuCK4q85PAyPoxA,1742541226,Steam,5816,5816,-90068,-89900,980,0,0,415851,False,3CC4-B438-M4B5-201K
eHIJ8YpgBBVBxJSZgA,1742540373,Best Way To Cup,5814,5814,-17000,-17000,980,0,0,505919,False,2032-9MM9-X186-CK57
FLEqrCR2FjPH4jzsRg,1742537492,Best Way To Cup,5814,5814,-8000,-8000,980,0,0,522919,False,KPEK-8026-3665-C80P
AgJdqQHDzQKvlisnUw,1742537195,Best Way To Cup,5814,5814,-22000,-22000,980,0,0,530919,False,24H3-P60A-THE8-9AT7
tcc4v703T0MFuxETbw,1742536395,"Vodafone
+380978495150",4814,4814,-20800,-20800,980,0,0,552919,False,B3E3-03P9-625A-8HP6
Ar_LgbqUriJsf8SflA,1742506212,–ó –±—ñ–ª–æ—ó –∫–∞—Ä—Ç–∫–∏,4829,4829,500000,500000,980,0,0,573719,False
BXYvcEmvW07qY3APLw,1742494547,OK Wine,5411,5411,-24750,-24750,980,0,0,73719,False,630E-994H-AX12-PB4C
SGipSYqeOuacv5FV_Q,1742493369,LIQPAY*KIYiVGAZ oplata,5812,5812,-75075,-75075,980,0,0,98469,False,E9MA-P377-6845-7TC7
vyRCNDpLGbkqZCc5-g,1742489638,StomatologiyaFdclinic,8021,8021,-1780000,-1780000,980,0,0,173544,False,E34K-37K4-1C40-5MT0
EbtyuT0laalTyqZmFg,1742470672,–ö–∏—ó–≤—Å—å–∫–µ –º–µ—Ç—Ä–æ,4111,4111,-800,-800,980,0,0,1953544,False,1580-ECM8-MKT6-01A8
xTntzsEqQJ-0XOs4uQ,1742470350,ElitZoo,5995,5995,-9825,-9825,980,0,0,1954344,False,3E34-2C4H-MEAC-C490
mTdoEHRYjsH2Us8I2g,1742466787,THE VARENIK,5814,5814,-6500,-6500,980,0,0,1964169,False,P6C6-E8C2-K124-79M6
zQW0kxH78K8jQo4x1w,1742466658,–ü–µ—á–µ–Ω–∞ –∫–∞—Ä—Ç–æ–ø–ª—è,5814,5814,-25500,-25500,980,0,0,1970669,False,X895-P533-ET2M-75TX
fgp7iIemUPr2G49w-g,1742465031,–ö–∏—ó–≤—Å—å–∫–µ –º–µ—Ç—Ä–æ,4111,4111,-800,-800,980,0,0,1996169,False,45C5-HK5H-47BE-38A4
_ZESOkcU2oGR_5-qwQ,1742462536,–ó –±—ñ–ª–æ—ó –∫–∞—Ä—Ç–∫–∏,4829,4829,1000000,1000000,980,0,0,1996969,False
qmbHTUuGMLDAPwoFOA,1742452510,Novus,5411,5411,-7299,-7299,980,0,0,996969,False,BT2T-P47P-0XCE-EX23
2i5j5O5aAoV4rO8-Ow,1742452055,Best Way To Cup,5814,5814,-27000,-27000,980,0,0,1004268,False,CK99-HMMA-86K5-MT96
5AS83Z3oktEPjVyW9A,1742451153,–ù–æ–≤–∞ –ø–æ—à—Ç–∞,8999,8999,-8000,-8000,980,0,0,1031268,False,6X1B-H873-C523-KAAM
yqmSFJLLFNh0GlzBFg,1742416653,–ù–æ–≤–∞ –ø–æ—à—Ç–∞,8999,8999,-6000,-6000,980,0,0,1039268,False,725B-MMB7-358C-E486
LE9GfuEFNiIDSxlyJw,1742416627,–ù–æ–≤–∞ –ø–æ—à—Ç–∞,8999,8999,-8000,-8000,980,0,0,1045268,False,2872-AH9X-K8BB-5MXH
Rl_mJwAwHGBu2-aJ9w,1742397747,OK Wine,5411,5411,-66800,-66800,980,0,0,1053268,False,C3P0-0HEP-64AE-C71X
snds0ZXHIwLvMAS34w,1742388300,Prod Yaroslaviv,5499,5499,-23540,-23540,980,0,0,1120068,False,06B4-B90M-9B3P-EPP2
BMTZ-8KKEWNPM52elg,1742382391,Best Way To Cup,5814,5814,-24500,-24500,980,0,0,1143608,False,06C6-625M-9B0T-MT39
q5k6Dtue8Mtq9U9Epg,1742374890,Fitnes klub 2BFIT,7941,7941,-100000,-100000,980,0,0,1168108,False,6869-3X1H-A6T3-CK3X
MtOemwW6qraOJGuezA,1742299383,Best Way To Cup,5814,5814,-8000,-8000,980,0,0,1268108,False,H269-51AX-EB25-9EK5
Auo55HuAkOWquZqz8w,1742299285,Best Way To Cup,5814,5814,-8500,-8500,980,0,0,1276108,False,PC6A-9CT7-8BC9-TTPC
A3hGKWT9S6V2uYjgLg,1742299097,La Fabrique,5814,5814,-18000,-18000,980,0,0,1284608,False,XB6B-6479-EHBX-CAMH
A6wKgbjxiwfeEdz5Dw,1742291739,Simona,5812,5812,-28600,-28600,980,0,0,1302608,False,911T-K7HP-7AEP-430H
GGlmmUASgYCwtBhPzA,1742283647,Uklon,4121,4121,-12800,-12800,980,0,0,1331208,False,K22M-MM4H-CPC7-C3H2
kKC6O6RajTworPFW6g,1742279580,Best Way To Cup,5814,5814,-9000,-9000,980,0,0,1344008,False,2EE5-49TE-4E28-248H
ZDqyOxBx_5WG6_9Z7g,1742232055,Rozetka,5399,5399,-45800,-45800,980,0,0,1353008,False,9AK3-20CB-ECTB-7A6K
WC2LPydo0AJw2FUoDA,1742232037,Rozetka,5399,5399,-30900,-30900,980,0,0,1398808,False,C6H9-2E9T-0T0C-3565
8uOvmGfLjnJcNYQBfQ,1742231983,Rozetka,5399,5399,-11500,-11500,980,0,0,1429708,False,9AP2-8BBE-8BK0-CMAX
fGfOPtFDWxGko3vstg,1742231938,Rozetka,5399,5399,-36700,-36700,980,0,0,1441208,False,81HK-B60K-7938-1A28
DTqXCUJzbDg5TBXgxw,1742231687,Novus,5411,5411,-12040,-12040,980,0,0,1477908,False,M3XX-7CK2-MAKC-931X
LzRrZXmnthVas3gqqg,1742231446,EVA,5977,5977,-15900,-15900,980,0,0,1489948,False,E4CT-0175-EAK4-5280
erL5sP48bu7Ns8kT8g,1742231119,–ê–ø—Ç–µ–∫–∞ ¬´–ü–æ–¥–æ—Ä–æ–∂–Ω–∏–∫¬ª,5912,5912,-95060,-95060,980,0,0,1505848,False,79CC-98HX-ETAM-0B26
tBlHaw1EutIIZB0oEA,1742231060,–ê–ø—Ç–µ–∫–∞ ¬´–ü–æ–¥–æ—Ä–æ–∂–Ω–∏–∫¬ª,5912,5912,-252410,-252410,980,0,0,1600908,False,CPCP-3A3H-BE5X-59H2
ZO-y_ivBveRoWZKrsw,1742230831,APTEKA 13,5912,5912,-8460,-8460,980,0,0,1853318,False,91B3-E6BC-B15X-AT8B
3fF8vdhAFN_DwuvaDg,1742230774,APTEKA 13,5912,5912,-2643,-2643,980,0,0,1861778,False,9ECC-142H-0429-0027
mLvCh3DSMGWYVJhtLw,1742220005,–ù–æ–≤–∞ –ø–æ—à—Ç–∞,8999,8999,-9250,-9250,980,0,0,1864421,False,0TM7-1H9M-T5CE-5B2C
XgGNUsFgjAIUPfLqBQ,1742214104,AVTOBLYKS-FORMULA,7538,7538,-25000,-25000,980,0,0,1873671,False,68B2-8E2X-CM25-879X
gtZM14huoxj7woHhMA,1742210141,FOPMuzichukBogdanGennadiy,742,742,-260000,-260000,980,0,0,1898671,False,18PT-TXCX-64C0-K119
n-7-ZWWwZJV5eyR9Rg,1742203674,–ú—ñ–∫—Å –ú–∞—Ä—Ç,5499,5499,-5400,-5400,980,0,0,2158671,False,P62K-74TX-1A49-E2MB
7OvxWw1JXt9HMdct4w,1742202223,Fitnes klub 2BFIT,7941,7941,-100000,-100000,980,0,0,2164071,False,8MK8-EEH5-EE21-95E3
O0h1Cyi2SR13roBagA,1742159906,EPS*AQUAMARKET,5399,5399,-138510,-138510,980,0,0,2264071,False,58C3-BH9B-030C-K907
bBvReVkTxIMfH6OqFw,1742150360,–ù–æ–≤–∞ –ø–æ—à—Ç–∞,8999,8999,-8000,-8000,980,0,0,2402581,False,1P21-TTCB-442K-32BA
8B1JSdEbeAc3qe5V6A,1742130398,–°—ñ–ª—å–ø–æ,5411,5411,-49373,-49373,980,0,0,2410581,False,38K3-07C5-TM6X-8K8K
ZVm-b50fy51BQZBZYw,1742128020,–ù–æ–≤–∞ –ø–æ—à—Ç–∞,7399,7399,-6000,-6000,980,0,0,2459954,False,BH78-B443-03CM-C724
JQ5BrYED4z4sgJm4yg,1742115274,OLIVERA RESTAURANT,5812,5812,-145000,-145000,980,0,0,2465954,False,3A6P-98K1-61H7-7PBP
UnsARplA7_3Q9tKd2Q,1742066451,–°—ñ–ª—å–ø–æ,5411,5411,-13700,-13700,980,0,0,2610954,False,7XPE-9939-91CP-EE3B
mRvk8DBhy6KKFmPwkA,1742065934,–ö–æ–ª–æ,5411,5499,-5350,-5350,980,0,0,2624654,False,HBB5-XE51-P9C9-H905
3PTi896B-ufbu3BCtA,1742062135,–°–∫–∞—Å—É–≤–∞–Ω–Ω—è. Steam,5816,5816,50280,49900,980,0,0,2630004,False
HTdAK0YszdI_VcWC3Q,1742046774,–ü–µ—Ä–µ–∫–∞–∑ –Ω–∞ –∫–∞—Ä—Ç–∫—É,4829,4829,-2500000,-2500000,980,0,0,2579724,False
IhaICxpDIsH4ot-Fbg,1742046762,Lesya,4829,4829,-700000,-700000,980,0,0,5079724,False,2659-MT0C-BT3P-A7PH
-mT_ZMg8VRfob5MXwg,1742046439,Steam,5816,5816,-50280,-49900,980,0,0,5779724,False
SXl07Hj_16Zze8wipQ,1742043952,–§–û–ü –•–æ–º–µ–Ω–∫–æ –í.–í.,5621,5621,-170000,-170000,980,0,0,5830004,False,EM14-BTP8-P906-479H
b84cxFDUE2tSu1iJMA,1742035328,Best Way To Cup,5814,5814,-8500,-8500,980,0,0,6000004,False,KXPE-6BB5-BP10-7156
b91Lo5SMJjG7OGrkdw,1742032040,Novus,5411,5411,-17649,-17649,980,0,0,6008504,False,77M5-P7PM-K420-380B
x7qDOWJsZDDuPzJb-Q,1742024058,Best Way To Cup,5814,5814,-42500,-42500,980,0,0,6026153,False,526A-37X1-E6H9-CP06
BHUyKqTNQHolEeP6ug,1742022471,Ukrkhalial,5499,5499,-12000,-12000,980,0,0,6068653,False,T1B7-1A9M-4KTX-9E8B
E4BA9csYOMfn4ZtF-w,1742022428,Ukrkhalial,5499,5499,-54461,-54461,980,0,0,6080653,False,54E4-3HP8-X602-M4B8
_yHh2Iq_RhYfEDp5OQ,1741981301,–ù–æ–≤–∞ –ø–æ—à—Ç–∞,8999,8999,-9391,-9391,980,0,0,6135114,False,1M4E-12ET-A9T7-6P28
G9eTySTCxaLTnebYjQ,1741981272,–ù–æ–≤–∞ –ø–æ—à—Ç–∞,8999,8999,-6520,-6520,980,0,0,6144505,False,K07P-1K42-44MB-027H
Uw2GZB-d5KRiU08TLg,1741974285,–°—ñ–ª—å–ø–æ,5411,5411,-37039,-37039,980,0,0,6151025,False,P028-864A-B982-535B
HIUcpUe2XauP4spR9Q,1741971172,Steam,5816,5816,-239647,-237800,980,0,0,6188064,False,A9B9-2E25-7MPK-0K20
AUnAakz-9JcAuPM8tg,1741965460,–°—ñ–ª—å–ø–æ,5411,5411,-39800,-39800,980,0,0,6427711,False,PTHA-CB4T-C45C-B0B1
zFFRN9GqD2wyAFEXXQ,1741961372,–¢—ñ—Ç–∫–∞ –ö–ª–∞—Ä–∞,5814,5814,-24900,-24900,980,0,0,6467511,False,EP13-K1PB-THE8-1CHH
qFAJfzHeyo0OLvf-Tw,1741951486,Rozetka,5399,5399,-32600,-32600,980,0,0,6492411,False,3C83-133E-XM5X-P8P3
qmvSvAtfVBV-HPH6XA,1741950797,Best Way To Cup,5814,5814,-10000,-10000,980,0,0,6525011,False,MEMA-T21C-P946-143M
iUYvhjMGOI2EzKFTLA,1741949386,Best Way To Cup,5814,5814,-17500,-17500,980,0,0,6535011,False,06B4-499P-XAXT-6X2K
lQCoZB2vecZTGcUb4g,1741948506,zakaz.ua,5411,5411,-308935,-308935,980,0,0,6552511,False,TT6X-73TE-0PM3-K58E
2vkj9oeCekrU1ySy0w,1741946812,Fitnes klub 2BFIT,7941,7941,-100000,-100000,980,0,0,6861446,False,46K7-A0EK-196H-3H49
33daUJZebrAdFDcEcg,1741936515,FOP Shevchenko,5499,5499,-17000,-17000,980,0,0,6961446,False,T82C-2K88-BT2K-KKMH
reR2d3Sl3mjkj32-vQ,1741933943,Best Way To Cup,5814,5814,-49000,-49000,980,0,0,6978446,False,824X-3E75-A49C-4P86
dfuqkc5RPnacw0K3Ng,1741893974,AS PODIL,7523,7523,-5000,-5000,980,0,0,7027446,False,7736-2T67-A29H-89MC
WN2mlF-J9NLzX_c5Sw,1741893635,–ê–≤—Ç–æ—Å—Ç–∞–Ω—Ü—ñ—è,5812,5812,-125400,-125400,980,0,0,7032446,False,P379-665K-6HP3-KTM5
7GSsbjRudHI0XlkKfA,1741886241,Pethouse,5995,5995,-211700,-211700,980,0,0,7157846,False,9P7A-TTBB-9MC8-CHAC
3KGQFWN_Io3Wam5SQg,1741879722,–ù–æ–º–µ—Ä –î–æ–º—É ,5499,5499,-104000,-104000,980,0,0,7369546,False,A6ME-690T-2712-84HB
ca6vlw8WWRcn_xh8rQ,1741877846,"Lifecell
+380731983817",4814,4814,-15000,-15000,980,0,0,7473546,False,PKHP-KB61-9E71-259P
iicvuuRJCpnDezx9UQ,1741867825,–¢—ñ—Ç–∫–∞ –ö–ª–∞—Ä–∞,5814,5814,-15800,-15800,980,0,0,7488546,False,712H-KB0A-51X6-807T
3r5gXAThIRZhkw-OWw,1741866448,–¢—ñ—Ç–∫–∞ –ö–ª–∞—Ä–∞,5814,5814,-8400,-8400,980,0,0,7504346,False,0PK4-7B36-PC4P-TB5P
PFlSUAtvES_uJE24Gw,1741866112,Yaroslaviv Val 37-1,5921,5921,-37400,-37400,980,0,0,7512746,False,A04E-0H3B-63HE-73KT
pOkKXlme1yzUXChusA,1741864659,–ö–∏—ó–≤—Å—å–∫–µ –º–µ—Ç—Ä–æ,4111,4111,-800,-800,980,0,0,7550146,False,6HM5-C3BB-XC8X-EBEE
KLBOAQMZrhOzpp-V5A,1741864152,Aksesuari,5399,5399,-4000,-4000,980,0,0,7550946,False,485B-0EA6-0KXM-ABX3
_4FxrmFa5St3qie6ww,1741863868,MasterZoo,5995,5995,-133862,-133862,980,0,0,7554946,False,5BXX-949B-C0K9-7K08
CcO-lj2Z8Xg5Hd_1ig,1741860527,THE VARENIK,5814,5814,-34676,-34676,980,0,0,7688808,False,B6MT-HE2K-9T7B-TEP4
6kJC6_pQDfkUVh1HHg,1741859258,–ö–∏—ó–≤—Å—å–∫–µ –º–µ—Ç—Ä–æ,4111,4111,-800,-800,980,0,0,7723484,False,89E4-AB44-C5M4-9260
4zfaXuTsWAnBGMvWag,1741857467,–ö–Ω–∏–≥–∞—Ä–Ω—è book.ua,5942,5942,-20500,-20500,980,0,0,7724284,False,4A75-3M50-0H69-1533
eDBiV3qOHrU7bPADwQ,1741857370,KavyarnyaCafebookua,5814,5814,-11000,-11000,980,0,0,7744784,False,EC76-K6M3-CXHX-B234
tpkckZ5QEM7YXlxQaA,1741856204,PetStoriesZootovari,5995,5995,-29900,-29900,980,0,0,7755784,False,A3TC-P13T-A7AK-4K6B
FU1FNyZMc8QAZCSr0A,1741848133,Best Way To Cup,5814,5814,-8000,-8000,980,0,0,7785684,False,9642-BBE1-1751-3224
GV2AiA3s2PA_ZO1VUA,1741847691,Best Way To Cup,5814,5814,-47500,-47500,980,0,0,7793684,False,28C2-10E0-0T2A-5XM7
ocUyrF1GViz1CUqYxg,1741801435,Honey | –Ø—Ä–æ—Å–ª–∞–≤—ñ–≤ –≤–∞–ª,5812,5812,-52000,-52000,980,0,0,7841184,False,MEXT-5PM5-BX87-3PXH
wh-CIqAcvW930FZyRQ,1741800993,Yaroslaviv Val 37-1,5921,5921,-32900,-32900,980,0,0,7893184,False,XHP5-58MX-AT70-M25X
s6Di-PzwZIIs1XVSGA,1741800950,Yaroslaviv Val 37-1,5921,5921,-150100,-150100,980,0,0,7926084,False,A8AP-H223-AX58-HC1B
flY3InMifKhHFF9t-A,1741784217,Best Way To Cup,5814,5814,-19000,-19000,980,0,0,8076184,False,48KE-147A-XHM4-M4H5
tzjstz0xjvHInYNPow,1741783136,–ú—ñ—Å—å–∫–∞ –á–¥–∞–ª—å–Ω—è,5814,5814,-57000,-57000,980,0,0,8095184,False,41P0-43H5-0T1K-866B
TYq54vsarInOWJ-_8w,1741769564,Fitnes klub 2BFIT,7941,7941,-73000,-73000,980,0,0,8152184,False,9157-88PE-4BH5-BX5T
0-BNBHfwv7G9akHkAQ,1741719177,–ö–æ–ª–æ,5411,5499,-5450,-5450,980,0,0,8225184,False,78BM-E54B-2876-5A13
4oli-2pp4AncZX99Xw,1741718835,–ö–ò–á–í–ì–ê–ó,5812,5812,-112000,-112000,980,0,0,8230634,False,EAXT-PXM9-XB7M-BP3A
VKb-GjDdGZkLXM6uqQ,1741701898,Kafe Kharms,5814,5814,-16400,-16400,980,0,0,8342634,False,906K-B041-MT89-92P6
j7XHKMmHXty5OrJLCA,1741696481,STEAKHOUSE02,5812,5812,-16000,-16000,980,0,0,8359034,False,6MM2-HCCH-CHH2-MM0C
LW6gT3IwPWJCif0J3A,1741696432,–ú—ñ—Å—å–∫–µ –∫–∞—Ñ–µ –•–∞—Ä–º—Å,5812,5812,-8100,-8100,980,0,0,8375034,False,12KT-CH21-04T0-331C
KidvmaRy-aBiG8ay-Q,1741696032,STEAKHOUSE02,5812,5812,-51000,-51000,980,0,0,8383134,False,792X-276P-H159-3HP2
kBQztVvxbjqMuou0gg,1741692129,–§–æ—Ä–∞,5411,5411,-24240,-24240,980,0,0,8434134,False,46CX-36AB-AACM-BPCC
DSoYxZsf7dj9lOQp5A,1741685251,–íi–¥: –ü–†–ò–•–û–î–¨–ö–û –ï.–í. –§–û–ü,"–î–ª—è –ø–æ–ø–æ–≤–Ω–µ–Ω–Ω—è –∫–∞—Ä—Ç–∫–∏ 5375414101190360, –ü—Ä–∏—Ö–æ–¥—å–∫–æ –ï—Ä–Ω–µ—Å—Ç –íi–∫—Ç–æ—Ä–æ–≤–∏—á, 3487403339",4829,4829,8100000,8100000,980,0,0,8458374,False
KdD-0qQtI8LaoclOUg,1741673032,Best Way To Cup,5814,5814,-19000,-19000,980,0,0,358374,False,T4H3-KX9B-MP25-PXP2
yvNkaOJ6wUrJp249Tw,1741615377,–ó –±—ñ–ª–æ—ó –∫–∞—Ä—Ç–∫–∏,4829,4829,200000,200000,980,0,0,377374,False
ZvjA5nfD2HIEtOnHEA,1741605175,Right coffee bar,5814,5814,-6500,-6500,980,0,0,177374,False,7P6A-0X6H-AX2E-9M2P
oUrCfAZSLlZITKFvwA,1741605047,PHotosalonMAN,7221,7221,-5000,-5000,980,0,0,183874,False,4E62-31K4-8P66-EPBT
ugh8bI1r9fSSZsHyig,1741596870,Fitnes klub 2BFIT,7941,7941,-100000,-100000,980,0,0,188874,False,E887-A700-E2X3-7EHX
Zn4JLDXEWr_XYIcdeA,1741587019,Best Way To Cup,5814,5814,-11500,-11500,980,0,0,288874,False,TH83-4E80-8A08-EEAK
vj4kUPsodjg2jf6MWg,1741545462,DNH*GODADDY.COM UAH,4816,4816,-4811,-4811,980,0,0,300374,False,3753-4990-CKT1-T06X
IAAO4yf7ePHqZw9NEw,1741532153,magazin Biotus,5499,5499,-92900,-92900,980,0,0,305185,False,PA21-H668-XHA5-B483
3VXdaiANenVhvKiQjw,1741531028,Best Way To Cup,5814,5814,-19000,-19000,980,0,0,398085,False,KK52-TCMX-TM1M-7PCK
EGZBFzDAG30Lr98GmQ,1741522326,Simona,5812,5812,-364500,-364500,980,0,0,417085,False,77X0-5MH6-EP0X-MXEE
Kqf8PkGqXjUQbtzy5g,1741519981,–ù–æ–≤–∞ –ø–æ—à—Ç–∞,8999,8999,-8000,-8000,980,0,0,781585,False,AXCP-1T9B-6MP1-P3T6
ZV0QqlrqGQBv7GE_8A,1741513853,Mates,5812,5812,-17400,-17400,980,0,0,789585,False,C141-5HH0-1E47-CCA4
Jr8tRDYkGoKTg7VV2A,1741508439,–ó –±—ñ–ª–æ—ó –∫–∞—Ä—Ç–∫–∏,4829,4829,800000,800000,980,0,0,806985,False
NFz7wddgT_1KHMvPBw,1741507480,Apteka,5912,5912,-10810,-10810,980,0,0,6985,False,4A6B-1X98-7AH7-HB61
OIwcPclJowO5EpszKw,1741507328,MasterZoo,5995,5995,-109275,-109275,980,0,0,17795,False,PC6H-EME3-54TC-9H1B
EhxPvDk6m5eyhfR38Q,1741454330,–°—ñ–ª—å–ø–æ,5411,5411,-75196,-75196,980,0,0,127070,False,PAH1-AXX0-3KBK-EHC4
pG2cWam5goTkW9rzDw,1741445824,Bolt,4121,4121,-18900,-18900,980,0,0,202266,False,B7PC-HM2X-42XM-78T1
nA7XguRV_oDpacLJvw,1741440212,Best Way To Cup,5814,5814,-13000,-13000,980,0,0,221166,False,8HET-3AB4-K024-5048
bJPei7Wz1_F0pZBfLg,1741434100,WINETIME,5921,5921,-60200,-60200,980,0,0,234166,False,ET34-A2X8-M5C3-PKKK
y5kMKUHxReP_2HCClg,1741425545,–°—ñ–ª—å–ø–æ,5411,5411,-65300,-65300,980,0,0,294366,False,EC71-93TC-62P2-H91M
5Jz_w83jKAYdEsp8ZQ,1741424899,–ê–ø—Ç–µ–∫–∞ –æ–ø—Ç–æ–≤–∏—Ö —Ü—ñ–Ω,5912,5912,-82190,-82190,980,0,0,359666,False,5K50-KM22-04BT-7PM3
cSIDIj8_gLBkLgtBgw,1741424132,GENESIS VETSHPYTAL,742,742,-270000,-270000,980,0,0,441856,False,X12E-46P5-61M1-3460
O07Zsuc4QHD_sxswmA,1741418129,–ê–ø—Ç–µ–∫–∞ ¬´–ë–∞–∂–∞—î–º–æ –∑–¥–æ—Ä–æ–≤‚Äô—è¬ª,5399,5912,-62426,-62426,980,0,0,711856,False,B1BM-0M1B-31CA-HMH3
3xIP_0eT_fjBpF8X6w,1741418051,–ê–ø—Ç–µ–∫–∞ ¬´–ë–∞–∂–∞—î–º–æ –∑–¥–æ—Ä–æ–≤‚Äô—è¬ª,5399,5912,-23839,-23839,980,0,0,774282,False,C6HA-4TA9-3K9P-ACKT
g8ihCguvZKSSFpsegw,1741417979,–ö–æ–ª–æ,5411,5499,-11950,-11950,980,0,0,798121,False,858P-E7B2-0CAX-HPEB
wgF0QmAAzV1IpFt09A,1741372128,Yaroslaviv Val 37-1,5921,5921,-28700,-28700,980,0,0,810071,False,7A2M-PCP8-AX01-BK9T
RbRpR4s6NzWfaLBVng,1741371463,OG BURGER | –†–µ–π—Ç–∞—Ä—Å—å–∫–∞,5812,5812,-78100,-78100,980,0,0,838771,False,8299-ABE4-92T5-AMH3
ztys2Q6IC5zyy_VMLg,1741366348,Freya,5992,5992,-125000,-125000,980,0,0,916871,False,A073-8X31-HXT6-51AP
2qyA0tXH3BBvrEOljQ,1741361656,EPS*AQUAMARKET,5399,5399,-233310,-233310,980,0,0,1041871,False,EM30-HKBP-0MP1-9X50
xMmg95V6AsVhlB7efQ,1741358019,Best Way To Cup,5814,5814,-31000,-31000,980,0,0,1275181,False,4T6E-APHB-72TP-4777
kuqhLz6AG7hNoxMfDA,1741356788,Kafe Kharms,5814,5814,-8000,-8000,980,0,0,1306181,False,8X11-796M-EBK6-2AKB
5OcR4OVqOSvdjvX5Qw,1741343662,–ú—ñ–∫—Å –ú–∞—Ä—Ç,5499,5499,-18300,-18300,980,0,0,1314181,False,E00M-6C09-7EAE-4K5K
qoYeXEhigPokCzTO_A,1741342123,Fitnes klub 2BFIT,7941,7941,-100000,-100000,980,0,0,1332481,False,K3E7-03A2-4204-3K3E
a5F_RVhiOvb6SOUosg,1741334682,"Lifecell
+380631692598",4814,4814,-29000,-29000,980,0,0,1432481,False,323H-CE1T-8E95-TBC9
KPdvqhI3VYIvitH8Og,1741327465,Best Way To Cup,5814,5814,-15500,-15500,980,0,0,1461481,False,1EC6-B29X-C0CT-A1TA
VnG5EG-ev8ITU6z2iA,1741287847,–ï–ø—ñ—Ü–µ–Ω—Ç—Ä,5200,5200,-95900,-95900,980,0,0,1476981,False,89A3-MTE7-TMET-96CX
BiU-UKHoNbNlXdCrCw,1741287774,–ï–ø—ñ—Ü–µ–Ω—Ç—Ä,5200,5200,-181972,-181972,980,0,0,1572881,False,15EK-9HKB-2M20-8TXH
mwkRFXw0QxwQXRjNig,1741271012,Noodes,5812,5812,-101100,-101100,980,0,0,1754853,False,7EHT-6T91-2P27-HET8
dgM3LCK5nC4r_pOvcQ,1741263445,Best Way To Cup,5814,5814,-9000,-9000,980,0,0,1855953,False,148E-T84M-E08H-AB8C
6HGo674JPIQXiPxskQ,1741261044,Fotovramci,5946,5946,-90000,-90000,980,0,0,1864953,False,X68A-P33T-53TE-M94E
XRAxfk1W5Qx2E0LFXg,1741187138,Steam,5816,5816,-31300,-31300,980,0,0,1954953,False,BB43-33K1-EPE7-AM66
plC734-TyIxKxyfqFw,1741186408,–ù–æ–≤–∞ –ø–æ—à—Ç–∞,8999,8999,-8000,-8000,980,0,0,1986253,False,86CK-AP04-CAT9-69A8
pjvHE4Haa3_7x6gSaA,1741181366,Best Way To Cup,5814,5814,-18000,-18000,980,0,0,1994253,False,8A6T-XE04-KTX5-EKA4
q2_Zk2zNP41a1kHyIA,1741178939,GENESIS VETCLINIC,742,742,-465000,-465000,980,0,0,2012253,False,5282-AMPM-0180-MC1M
skrwR23CrZu_mSplPw,1741170602,–ü–µ—Ä–µ–∫–∞–∑ –Ω–∞ –∫–∞—Ä—Ç–∫—É,4829,4829,-1200000,-1200000,980,0,0,2477253,False
1tAPNvePv5gHSkqUxg,1741158499,Best Way To Cup,5814,5814,-19000,-19000,980,0,0,3677253,False,XXPC-KMCP-X5AT-TX9T
BcxBir4hEPLYnUHC4w,1741121110,AVANGARDEN,5812,5812,-750000,-750000,980,0,11346,3696253,False,66H5-072X-6H3H-8H1T
-E4CJb-l2aOL4vRA9g,1741119388,AVANGARDEN,5814,5814,-1555500,-1555500,980,0,31110,4446253,False,T5XX-AT31-BEE1-TAHP
s8HMK893c0vfGFowZw,1741094971,Simona,5812,5812,-254800,-254800,980,0,5096,6001753,False,80KE-CT59-CA4K-H1MX
O4IHYgrdXx_pilG3wQ,1741090428,BrewBlissBar,5812,5812,-8000,-8000,980,0,160,6256553,False,19XM-B7A9-EB77-XP80
6UDbXefOKO_LYZ1JWg,1741079016,–Æ–ª—ñ—è –õ.,4829,4829,-15000,-15000,980,0,0,6264553,False,XAC0-1H61-HKB1-MKAK
--0Ejk7Vzz8kc8Ld9A,1741078347,–ö–∞—Ñ–µ –ú–∞—Ä—ñ—è,5812,5812,-114400,-114400,980,0,2288,6279553,False,BBP8-57E5-58K8-XPA0
O35Pohfd_uV_p0xAkw,1741068249,–ü–æ–ø–æ–≤–Ω–µ–Ω–Ω—è ¬´–ù–∞ –ø–æ—Ç—Ä–µ–±–∏ ¬´–ö–†–ê–ö–ï–ù–ê¬ª¬ª,–ü–æ–ø–æ–≤–Ω–µ–Ω–Ω—è —Ä–∞—Ö—É–Ω–∫—É –±–∞–Ω–∫–∏,4829,4829,-100,-100,980,0,0,6393953,False,85AA-E6M0-2C70-132C
InrW7LtmFkrpVnSpXg,1741028927,–ù–æ–≤–∞ –ø–æ—à—Ç–∞,8999,8999,-6581,-6581,980,0,0,6394053,False,P741-PXEA-7C2H-HAK1
f2aS8ZcCSPlg5JU2Fg,1741023005,–°—ñ–ª—å–ø–æ,5411,5411,-91300,-91300,980,0,0,6400634,False,72H5-409B-P8P1-PPBB
GZB_TcuxBG6_3uOc5w,1741016539,ANA.FLORIST,5992,5992,-467900,-467900,980,0,0,6491934,False,CET9-HPHA-K948-AACK
RUt6bnWLNK2TwHUFAg,1741015390,–ü–æ–ø–æ–≤–Ω–µ–Ω–Ω—è ¬´puppy¬ª,–ü–æ–ø–æ–≤–Ω–µ–Ω–Ω—è —Ä–∞—Ö—É–Ω–∫—É –±–∞–Ω–∫–∏,4829,4829,-160000,-160000,980,0,0,6959834,False,658B-EH6H-13X3-3XCT
8xfGEzkXArsILJaL7Q,1740999192,–íi–¥: –ü–†–ò–•–û–î–¨–ö–û –ï.–í. –§–û–ü,"–î–ª—è –ø–æ–ø–æ–≤–Ω–µ–Ω–Ω—è –∫–∞—Ä—Ç–∫–∏ 5375414101190360, –ü—Ä–∏—Ö–æ–¥—å–∫–æ –ï—Ä–Ω–µ—Å—Ç –íi–∫—Ç–æ—Ä–æ–≤–∏—á, 3487403339",4829,4829,7000000,7000000,980,0,0,7119834,False
PWxUzcqMHwCvfVRXhw,1740996732,MasterZoo,5995,5995,-52731,-52731,980,0,0,119834,False,085H-5T03-7H7K-CAK5
ho4pz_7aFnGEiNRbUw,1740993982,WINETIME,5921,5921,-24600,-24600,980,0,0,172565,False,B50M-393M-69M8-T3B0
tRDXAwNK1eDWuMCMMQ,1740992331,Fitnes klub 2BFIT,7941,7941,-100000,-100000,980,0,0,197165,False,HT18-5AA2-EAHX-546X
H190fVm_WvVLnEzouA,1740946381,EPS*AQUAMARKET,5399,5399,-219270,-219270,980,0,0,297165,False,TXTB-4K48-14X9-4A96
6aLCZ4G534s1w6TWww,1740931505,–°—ñ–ª—å–ø–æ,5411,5411,-52400,-52400,980,0,0,516435,False,B3K0-B8A8-8M82-K683
vRB2nf-bZXk-HOIbzA,1740930715,E-ZOO,5995,5995,-58300,-58300,980,0,0,568835,False,886X-2M7H-0659-07BM
UAA0vndVJBmt7dEiQg,1740924858,Best Way To Cup,5814,5814,-16500,-16500,980,0,0,627135,False,3KT6-TBE4-8H19-EETB
3fbbD9piJvjh8r8Xeg,1740918437,–ù–æ–≤–∞ –ø–æ—à—Ç–∞,8999,8999,-7453,-7453,980,0,0,643635,False,M310-374B-6563-C08A
QH7XQUY16yTmAX9esA,1740908968,StudiyazasmagihiLightr,7298,7298,-100000,-100000,980,0,0,651088,False,XTXC-48B3-K7AM-M440
jGNLeNCJ-kMiq30q3Q,1740905816,OYSHO RIVER MALL,5651,5651,-159900,-159900,980,0,0,751088,False,A95A-C158-XKBA-7CC8
j39G7-ueedkLgB590g,1740899077,Novus,5411,5411,-19343,-19343,980,0,0,910988,False,918K-HPA2-515E-MK4K
Z7ET9hBeYStR28Jq3w,1740898983,Best Way To Cup,5814,5814,-7000,-7000,980,0,0,930331,False,PAKB-T1HM-103C-7EBK
jOIg75_2PeL4Lb1hWw,1740850006,–ê–ø—Ç–µ–∫–∞ ¬´–ë–∞–∂–∞—î–º–æ –∑–¥–æ—Ä–æ–≤'—è¬ª,5912,5912,-57725,-57725,980,0,0,937331,False,E9BX-XBE0-3K1M-9MCE
Dmh_84qctP4Hwwz9Pw,1740849561,–ê–ø—Ç–µ–∫–∞ –î–æ–±—Ä–æ–≥–æ –î–Ω—è,5912,5912,-49430,-49430,980,0,0,995056,False,E1AM-H3MC-34HB-232M
LRppyyidcaAyf5JKrQ,1740849520,–ê–ø—Ç–µ–∫–∞ –î–æ–±—Ä–æ–≥–æ –î–Ω—è,5912,5912,-27000,-27000,980,0,0,1044486,False,KPB2-07T8-1A0E-X9B7
XMxCxoRhX6wVxihHFw,1740848317,magazin 762597,5912,5912,-39565,-39565,980,0,0,1071486,False,TK9E-PKX5-6B32-97TE
x2vfSUBL7MaEO97mdQ,1740848140,Novus,5411,5411,-23192,-23192,980,0,0,1111051,False,7X72-69CM-6338-883M
cCtOeRBt2wG95VI3dw,1740847634,Seizo,7230,7230,-60000,-60000,980,0,0,1134243,False,8BH9-BAA5-4HM0-CA1P
CAmQ9aZr1EH7QwHrRA,1740841894,TTS ?NOVUS?,5499,5499,-7900,-7900,980,0,0,1194243,False,21KK-258X-43M2-C46P
n5YOj4w2Sn_mLOjX9w,1740841824,Novus,5411,5411,-37098,-37098,980,0,0,1202143,False,7AXE-3P2X-1783-1T32
ckXIzNcA8CPYcuP59A,1740834667,Parking,7523,7523,-8000,-8000,980,0,0,1239241,False,892C-TA5A-2CK7-1CT5
83kuJN6f4XsU0geTWQ,1740834217,Gavryk,5995,5995,-176500,-176500,980,0,0,1247241,False,EHX1-5646-XX87-1C4E
vH3h0JgT7NhkNN_29w,1740827146,PetStoriesZootovari,5995,5995,-78800,-78800,980,0,0,1423741,False,XAH6-X8X2-CE9A-2AT8
vA0bjg9ztoVKzggR3A,1740825959,Zoomagazin,5995,5995,-121000,-121000,980,0,0,1502541,False,3X50-M2C3-8KXP-EAM3
sLtqbOJ4IMiKn_JHkQ,1740825750,Veterinarnaklinika,742,742,-260000,-260000,980,0,0,1623541,False,5K9T-24EH-8PB1-XT5T
zwYkboss6Ov37-nfJA,1740824074,–ù–æ–≤–∞ –ø–æ—à—Ç–∞,8999,8999,-8300,-8300,980,0,0,1883541,False,1E2C-ET09-C8K2-H0E2
Ys2Ai_QUPw6s7efwNQ,1740822859,Barbershop,7230,7230,-85000,-85000,980,0,0,1891841,False,644T-90KX-346A-1KC7
Ri0hQVRt0y3bwlMQQQ,1743301967,–†–µ–≥—É–ª—è—Ä–Ω–µ –ø–æ–ø–æ–≤–Ω–µ–Ω–Ω—è ¬´–§–æ–Ω–¥ –ü–æ–≤–µ—Ä–Ω–∏—Å—å –∂–∏–≤–∏–º¬ª,4829,4829,-25000,-25000,980,0,0,242427,False,8B43-337H-EM2H-13C8
GaNgBgaHs-HrkcSkAQ,1743243474,–ü–æ–ø–æ–≤–Ω–µ–Ω–Ω—è ¬´–ß–∞–π–æ–≤—ñ –∫–æ–º–∞–Ω–¥—ñ bwtc¬ª,–ì–∞–≤ –≥–∞–≤ ü¶ù,4829,4829,-8000,-8000,980,0,0,267427,False,42TT-62CA-AMK3-5K60
wSWPAmEQbEpOjLozFg,1743193756,–ö–æ–ª—è –û–≥–æ–π–∫–æ,4829,4829,-38850,-38850,980,0,0,275427,False,TC4M-8099-XPT0-AK1P
bi6dc_rt0efa6uvnOg,1743146018,Lesya,4829,4829,-500000,-500000,980,0,0,314277,False,3856-X9E5-P2X3-XMKC
QP3q4xw_0dsLvmgM8w,1742833879,–§–û–ü –Ü–ª—å—ó–Ω–∞ –û–ª–µ–Ω–∞ –û–ª–µ–∫—Å—ñ—ó–≤–Ω–∞,4829,4829,-88300,-88300,980,0,0,814277,False,A21B-7C7E-5T6P-7K40
vMPbcM0RvGe3m8sqTw,1742700740,–†–µ–≥—É–ª—è—Ä–Ω–µ –ø–æ–ø–æ–≤–Ω–µ–Ω–Ω—è ¬´–§–æ–Ω–¥ –ü–æ–≤–µ—Ä–Ω–∏—Å—å –∂–∏–≤–∏–º¬ª,4829,4829,-25000,-25000,980,0,0,902577,False,5CHP-8C2K-4K2C-PCTP
35PSgAMKEL3nwnAlag,1742663071,–ó —á–æ—Ä–Ω–æ—ó –∫–∞—Ä—Ç–∫–∏,4829,4829,400000,400000,980,0,0,927577,False
-XOx4q_Pzr7WYcZ9Og,1742540901,Lesya,4829,4829,-100000,-100000,980,0,0,527577,False,EHTC-3E53-B7E7-450E
RtAJyE4Mj4CiUMipog,1742539973,–ü–æ–ø–æ–≤–Ω–µ–Ω–Ω—è ¬´–ß–∞–π–æ–≤—ñ –∫–æ–º–∞–Ω–¥—ñ bwtc¬ª,–ü—Ä–∏–≤—ñ—Ç –≤—ñ–¥ –ø–æ,4829,4829,-5000,-5000,980,0,0,627577,False,7PC6-T6KK-5BT0-41T7
9eI2bJsQPV2VGOHlFQ,1742537938,–ü–æ–ø–æ–≤–Ω–µ–Ω–Ω—è ¬´puppy¬ª,–ü–æ–ø–æ–≤–Ω–µ–Ω–Ω—è —Ä–∞—Ö—É–Ω–∫—É –±–∞–Ω–∫–∏,4829,4829,-50000,-50000,980,0,0,632577,False,M408-669X-73BT-5H84
U_xAH-g76gA0bhvDtg,1742506211,–ü–µ—Ä–µ–∫–∞–∑ –Ω–∞ –∫–∞—Ä—Ç–∫—É,4829,4829,-500000,-500000,980,0,0,682577,False
D9L6zntg9SjehilR9w,1742462535,–ü–µ—Ä–µ–∫–∞–∑ –Ω–∞ –∫–∞—Ä—Ç–∫—É,4829,4829,-1000000,-1000000,980,0,0,1182577,False
3jHNxOAbpjWmR4_W8g,1742214482,–§–û–ü –ë—ñ–ª–∏–∫ –ë–æ–≥–¥–∞–Ω –ü–∞–≤–ª–æ–≤–∏—á,4829,4829,-135000,-135000,980,0,0,2182577,False,795C-4HP2-08PB-53ET
MwxMwcQ_xogxj_CQtQ,1742098412,–†–µ–≥—É–ª—è—Ä–Ω–µ –ø–æ–ø–æ–≤–Ω–µ–Ω–Ω—è ¬´–§–æ–Ω–¥ –ü–æ–≤–µ—Ä–Ω–∏—Å—å –∂–∏–≤–∏–º¬ª,4829,4829,-25000,-25000,980,0,0,2317577,False,5MB3-C2CK-PAT9-E9P6
lbBpVvlAssTeLJeD4A,1742054255,–ñ–∞–Ω–Ω–∞ –ü–æ–º,4829,4829,-300000,-300000,980,0,0,2342577,False,A5C4-36CM-2C94-1170
LqOLt-i5D2A1wTP_LQ,1742046775,–ó —á–æ—Ä–Ω–æ—ó –∫–∞—Ä—Ç–∫–∏,4829,4829,2500000,2500000,980,0,0,2642577,False
VFbKxC5I5BQXv8r4Tw,1741956631,–§–û–ü –ö–æ–ª–∏—à–∫—ñ–Ω–∞ –í–∞–ª–µ—Ä—ñ—è –í–æ–ª–æ–¥–∏–º–∏—Ä—ñ–≤–Ω–∞,4829,4829,-22000,-22000,980,0,0,142577,False,128X-X5H0-3PK1-A50T
q3EPb7P12OQMYOaE6Q,1741615377,–ü–µ—Ä–µ–∫–∞–∑ –Ω–∞ –∫–∞—Ä—Ç–∫—É,4829,4829,-200000,-200000,980,0,0,164577,False
L5fD6UV2YjnrgjFjRw,1741615266,–ê–ú bistro,5812,5812,-80300,-80300,980,0,0,364577,False,82M8-8181-ET9A-BTMK
icq0UgLzKUPNFsvNRg,1741607835,–ü–æ–ø–æ–≤–Ω–µ–Ω–Ω—è ¬´–ù–∞ –≥–µ–Ω–µ—Ä–∞—Ç–æ—Ä —Ç–∞ —ñ–Ω—à–µ¬ª,–ü–æ–ø–æ–≤–Ω–µ–Ω–Ω—è —Ä–∞—Ö—É–Ω–∫—É –±–∞–Ω–∫–∏,4829,4829,-100000,-100000,980,0,0,444877,False,MA4C-P526-33M3-M33E
Da7JVftXcoolvqxhxw,1741586999,–ü–æ–ø–æ–≤–Ω–µ–Ω–Ω—è ¬´–ù–∞–ü–æ—Ç—Ä–µ–±–∏ CHUPACABRA¬ª,–ü–æ–ø–æ–≤–Ω–µ–Ω–Ω—è —Ä–∞—Ö—É–Ω–∫—É –±–∞–Ω–∫–∏,4829,4829,-20000,-20000,980,0,0,544877,False,242E-A259-2ECE-8E9A
4m29oFQWwWy5KXOhHQ,1741508438,–ü–µ—Ä–µ–∫–∞–∑ –Ω–∞ –∫–∞—Ä—Ç–∫—É,4829,4829,-800000,-800000,980,0,0,564877,False
N-UkjHAHjHqMPb9HSQ,1741491120,–†–µ–≥—É–ª—è—Ä–Ω–µ –ø–æ–ø–æ–≤–Ω–µ–Ω–Ω—è ¬´–§–æ–Ω–¥ –ü–æ–≤–µ—Ä–Ω–∏—Å—å –∂–∏–≤–∏–º¬ª,4829,4829,-25000,-25000,980,0,0,1364877,False,B234-P43E-200M-M4XP
c_jn-qveWNeRi7rktA,1741170602,–ó —á–æ—Ä–Ω–æ—ó –∫–∞—Ä—Ç–∫–∏,4829,4829,1200000,1200000,980,0,0,1389877,False
BRoC3Dnoxv3j_TmOYw,1740886440,–†–µ–≥—É–ª—è—Ä–Ω–µ –ø–æ–ø–æ–≤–Ω–µ–Ω–Ω—è ¬´–§–æ–Ω–¥ –ü–æ–≤–µ—Ä–Ω–∏—Å—å –∂–∏–≤–∏–º¬ª,4829,4829,-25000,-25000,980,0,0,189877,False,2026-2EAM-6BEC-A3TM
